"qname"	"qlen"	"qstart"	"qend"	"strand"	"tname"	"tlen"	"tstart"	"tend"	"nmatch"	"alen"	"mapq"	"tp"	"cm"	"s1"	"s2"	"dv"	"rl"	"contig"	"name2"	"name"	"sample_id"	"hap_struc"	"hap_struc_d"	"hap_block_start"	"chrom"	"start"	"end"
"ENST00000370083.9"	1785	2	1784	"+"	"AV_HG00673#haplotype1#0000019:16627360-17129375"	502015	199633	208426	1769	8793	0	"P"	557	1686	1686	1e-04	0	"AV_HG00673#haplotype1#0000019:16627360-17129375"	"AMY1A-201"	"1"	"AV_HG00673"	"0-3-7-9-4-6-8-5-2-4-9-7-2-5-2-4-9-7-2-5-2-1"	"0.0-3.0-7.0-9.0-4.0-6.0-8.0-5.0-2.0-4.1-9.1-7.1-2.1-5.0-2.0-4.1-9.1-7.1-2.1-5.0-2.0-1.0"	100	"AV_HG00673#haplotype1#0000019:16627360-17129375"	199633	208426
"ENST00000370083.9"	1785	2	1784	"+"	"AV_HG00673#haplotype1#0000019:16627360-17129375"	502015	293787	302579	1769	8792	0	"S"	557	1686	NA	1e-04	0	"AV_HG00673#haplotype1#0000019:16627360-17129375"	"AMY1A-201"	"1"	"AV_HG00673"	"0-3-7-9-4-6-8-5-2-4-9-7-2-5-2-4-9-7-2-5-2-1"	"0.0-3.0-7.0-9.0-4.0-6.0-8.0-5.0-2.0-4.1-9.1-7.1-2.1-5.0-2.0-4.1-9.1-7.1-2.1-5.0-2.0-1.0"	100	"AV_HG00673#haplotype1#0000019:16627360-17129375"	293787	302579
"ENST00000370083.9"	1785	2	1784	"-"	"AV_HG00673#haplotype1#0000019:16627360-17129375"	502015	325444	334235	1769	8791	0	"S"	557	1686	NA	1e-04	0	"AV_HG00673#haplotype1#0000019:16627360-17129375"	"AMY1A-201"	"1"	"AV_HG00673"	"0-3-7-9-4-6-8-5-2-4-9-7-2-5-2-4-9-7-2-5-2-1"	"0.0-3.0-7.0-9.0-4.0-6.0-8.0-5.0-2.0-4.1-9.1-7.1-2.1-5.0-2.0-4.1-9.1-7.1-2.1-5.0-2.0-1.0"	100	"AV_HG00673#haplotype1#0000019:16627360-17129375"	325444	334235
"ENST00000370083.9"	1785	2	1784	"+"	"AV_HG00673#haplotype1#0000019:16627360-17129375"	502015	387926	396718	1769	8792	0	"S"	557	1686	NA	1e-04	0	"AV_HG00673#haplotype1#0000019:16627360-17129375"	"AMY1A-201"	"1"	"AV_HG00673"	"0-3-7-9-4-6-8-5-2-4-9-7-2-5-2-4-9-7-2-5-2-1"	"0.0-3.0-7.0-9.0-4.0-6.0-8.0-5.0-2.0-4.1-9.1-7.1-2.1-5.0-2.0-4.1-9.1-7.1-2.1-5.0-2.0-1.0"	100	"AV_HG00673#haplotype1#0000019:16627360-17129375"	387926	396718
"ENST00000370083.9"	1785	2	1784	"-"	"AV_HG00673#haplotype1#0000019:16627360-17129375"	502015	231290	240083	1769	8793	0	"S"	557	1686	NA	1e-04	0	"AV_HG00673#haplotype1#0000019:16627360-17129375"	"AMY1A-201"	"1"	"AV_HG00673"	"0-3-7-9-4-6-8-5-2-4-9-7-2-5-2-4-9-7-2-5-2-1"	"0.0-3.0-7.0-9.0-4.0-6.0-8.0-5.0-2.0-4.1-9.1-7.1-2.1-5.0-2.0-4.1-9.1-7.1-2.1-5.0-2.0-1.0"	100	"AV_HG00673#haplotype1#0000019:16627360-17129375"	231290	240083
"ENST00000414303.7"	1584	4	1583	"+"	"AV_HG00673#haplotype1#0000019:16627360-17129375"	502015	161379	169649	1574	8270	16	"P"	491	1499	1417	1e-04	0	"AV_HG00673#haplotype1#0000019:16627360-17129375"	"AMY2A-201"	"2A"	"AV_HG00673"	"0-3-7-9-4-6-8-5-2-4-9-7-2-5-2-4-9-7-2-5-2-1"	"0.0-3.0-7.0-9.0-4.0-6.0-8.0-5.0-2.0-4.1-9.1-7.1-2.1-5.0-2.0-4.1-9.1-7.1-2.1-5.0-2.0-1.0"	100	"AV_HG00673#haplotype1#0000019:16627360-17129375"	161379	169649
"ENST00000610648.1"	1736	4	1733	"+"	"AV_HG00673#haplotype1#0000019:16627360-17129375"	502015	115052	123476	1720	8424	48	"P"	531	1638	1371	1e-04	0	"AV_HG00673#haplotype1#0000019:16627360-17129375"	"AMY2B-208"	"2B"	"AV_HG00673"	"0-3-7-9-4-6-8-5-2-4-9-7-2-5-2-4-9-7-2-5-2-1"	"0.0-3.0-7.0-9.0-4.0-6.0-8.0-5.0-2.0-4.1-9.1-7.1-2.1-5.0-2.0-4.1-9.1-7.1-2.1-5.0-2.0-1.0"	100	"AV_HG00673#haplotype1#0000019:16627360-17129375"	115052	123476
"ENST00000370083.9"	1785	2	1784	"+"	"AV_HG00673#haplotype2#0001165:24014011-24421797"	407786	199649	208440	1769	8791	0	"P"	557	1686	1686	1e-04	0	"AV_HG00673#haplotype2#0001165:24014011-24421797"	"AMY1A-201"	"1"	"AV_HG00673"	"0-3-7-4-6-8-5-2-7-4-2-5-2-1"	"0.0-3.0-7.0-4.0-6.0-8.0-5.0-2.0-7.0-4.0-2.1-5.1-2.0-1.0"	99	"AV_HG00673#haplotype2#0001165:24014011-24421797"	199649	208440
"ENST00000370083.9"	1785	2	1784	"-"	"AV_HG00673#haplotype2#0001165:24014011-24421797"	407786	231299	240090	1769	8791	0	"S"	557	1686	NA	1e-04	0	"AV_HG00673#haplotype2#0001165:24014011-24421797"	"AMY1A-201"	"1"	"AV_HG00673"	"0-3-7-4-6-8-5-2-7-4-2-5-2-1"	"0.0-3.0-7.0-4.0-6.0-8.0-5.0-2.0-7.0-4.0-2.1-5.1-2.0-1.0"	99	"AV_HG00673#haplotype2#0001165:24014011-24421797"	231299	240090
"ENST00000370083.9"	1785	2	1784	"+"	"AV_HG00673#haplotype2#0001165:24014011-24421797"	407786	293755	302546	1769	8791	0	"S"	557	1686	NA	1e-04	0	"AV_HG00673#haplotype2#0001165:24014011-24421797"	"AMY1A-201"	"1"	"AV_HG00673"	"0-3-7-4-6-8-5-2-7-4-2-5-2-1"	"0.0-3.0-7.0-4.0-6.0-8.0-5.0-2.0-7.0-4.0-2.1-5.1-2.0-1.0"	99	"AV_HG00673#haplotype2#0001165:24014011-24421797"	293755	302546
"ENST00000414303.7"	1584	4	1579	"+"	"AV_HG00673#haplotype2#0001165:24014011-24421797"	407786	161400	169666	1563	8266	28	"P"	484	1488	1342	0.001	0	"AV_HG00673#haplotype2#0001165:24014011-24421797"	"AMY2A-201"	"2A"	"AV_HG00673"	"0-3-7-4-6-8-5-2-7-4-2-5-2-1"	"0.0-3.0-7.0-4.0-6.0-8.0-5.0-2.0-7.0-4.0-2.1-5.1-2.0-1.0"	99	"AV_HG00673#haplotype2#0001165:24014011-24421797"	161400	169666
"ENST00000610648.1"	1736	4	1733	"+"	"AV_HG00673#haplotype2#0001165:24014011-24421797"	407786	115083	123505	1720	8422	48	"P"	531	1638	1371	1e-04	0	"AV_HG00673#haplotype2#0001165:24014011-24421797"	"AMY2B-208"	"2B"	"AV_HG00673"	"0-3-7-4-6-8-5-2-7-4-2-5-2-1"	"0.0-3.0-7.0-4.0-6.0-8.0-5.0-2.0-7.0-4.0-2.1-5.1-2.0-1.0"	99	"AV_HG00673#haplotype2#0001165:24014011-24421797"	115083	123505
"ENST00000370083.9"	1785	2	1784	"+"	"AV_HG01106#haplotype1#0000048:16666181-17262214"	596033	481973	490765	1769	8792	0	"P"	557	1686	1686	1e-04	0	"AV_HG01106#haplotype1#0000048:16666181-17262214"	"AMY1A-201"	"1"	"AV_HG01106"	"0-3-7-9-4-6-8-5-2-4-9-7-2-5-2-4-9-7-2-5-2-4-9-7-2-5-2-1"	"0.0-3.0-7.0-9.0-4.0-6.0-8.0-5.0-2.0-4.1-9.1-7.1-2.1-5.1-2.0-4.1-9.1-7.1-2.1-5.0-2.0-4.1-9.1-7.1-2.1-5.0-2.0-1.0"	100	"AV_HG01106#haplotype1#0000048:16666181-17262214"	481973	490765
"ENST00000370083.9"	1785	2	1784	"+"	"AV_HG01106#haplotype1#0000048:16666181-17262214"	596033	199598	208391	1769	8793	0	"S"	557	1686	NA	1e-04	0	"AV_HG01106#haplotype1#0000048:16666181-17262214"	"AMY1A-201"	"1"	"AV_HG01106"	"0-3-7-9-4-6-8-5-2-4-9-7-2-5-2-4-9-7-2-5-2-4-9-7-2-5-2-1"	"0.0-3.0-7.0-9.0-4.0-6.0-8.0-5.0-2.0-4.1-9.1-7.1-2.1-5.1-2.0-4.1-9.1-7.1-2.1-5.0-2.0-4.1-9.1-7.1-2.1-5.0-2.0-1.0"	100	"AV_HG01106#haplotype1#0000048:16666181-17262214"	199598	208391
"ENST00000370083.9"	1785	2	1784	"-"	"AV_HG01106#haplotype1#0000048:16666181-17262214"	596033	419502	428293	1769	8791	0	"S"	557	1686	NA	1e-04	0	"AV_HG01106#haplotype1#0000048:16666181-17262214"	"AMY1A-201"	"1"	"AV_HG01106"	"0-3-7-9-4-6-8-5-2-4-9-7-2-5-2-4-9-7-2-5-2-4-9-7-2-5-2-1"	"0.0-3.0-7.0-9.0-4.0-6.0-8.0-5.0-2.0-4.1-9.1-7.1-2.1-5.1-2.0-4.1-9.1-7.1-2.1-5.0-2.0-4.1-9.1-7.1-2.1-5.0-2.0-1.0"	100	"AV_HG01106#haplotype1#0000048:16666181-17262214"	419502	428293
"ENST00000370083.9"	1785	2	1784	"-"	"AV_HG01106#haplotype1#0000048:16666181-17262214"	596033	231251	240044	1769	8793	0	"S"	557	1686	NA	1e-04	0	"AV_HG01106#haplotype1#0000048:16666181-17262214"	"AMY1A-201"	"1"	"AV_HG01106"	"0-3-7-9-4-6-8-5-2-4-9-7-2-5-2-4-9-7-2-5-2-4-9-7-2-5-2-1"	"0.0-3.0-7.0-9.0-4.0-6.0-8.0-5.0-2.0-4.1-9.1-7.1-2.1-5.1-2.0-4.1-9.1-7.1-2.1-5.0-2.0-4.1-9.1-7.1-2.1-5.0-2.0-1.0"	100	"AV_HG01106#haplotype1#0000048:16666181-17262214"	231251	240044
"ENST00000370083.9"	1785	2	1784	"+"	"AV_HG01106#haplotype1#0000048:16666181-17262214"	596033	387844	396635	1769	8791	0	"S"	557	1686	NA	1e-04	0	"AV_HG01106#haplotype1#0000048:16666181-17262214"	"AMY1A-201"	"1"	"AV_HG01106"	"0-3-7-9-4-6-8-5-2-4-9-7-2-5-2-4-9-7-2-5-2-4-9-7-2-5-2-1"	"0.0-3.0-7.0-9.0-4.0-6.0-8.0-5.0-2.0-4.1-9.1-7.1-2.1-5.1-2.0-4.1-9.1-7.1-2.1-5.0-2.0-4.1-9.1-7.1-2.1-5.0-2.0-1.0"	100	"AV_HG01106#haplotype1#0000048:16666181-17262214"	387844	396635
"ENST00000370083.9"	1785	2	1784	"+"	"AV_HG01106#haplotype1#0000048:16666181-17262214"	596033	293722	302513	1769	8791	0	"S"	557	1686	NA	1e-04	0	"AV_HG01106#haplotype1#0000048:16666181-17262214"	"AMY1A-201"	"1"	"AV_HG01106"	"0-3-7-9-4-6-8-5-2-4-9-7-2-5-2-4-9-7-2-5-2-4-9-7-2-5-2-1"	"0.0-3.0-7.0-9.0-4.0-6.0-8.0-5.0-2.0-4.1-9.1-7.1-2.1-5.1-2.0-4.1-9.1-7.1-2.1-5.0-2.0-4.1-9.1-7.1-2.1-5.0-2.0-1.0"	100	"AV_HG01106#haplotype1#0000048:16666181-17262214"	293722	302513
"ENST00000370083.9"	1785	2	1784	"-"	"AV_HG01106#haplotype1#0000048:16666181-17262214"	596033	325379	334170	1769	8791	0	"S"	557	1686	NA	1e-04	0	"AV_HG01106#haplotype1#0000048:16666181-17262214"	"AMY1A-201"	"1"	"AV_HG01106"	"0-3-7-9-4-6-8-5-2-4-9-7-2-5-2-4-9-7-2-5-2-4-9-7-2-5-2-1"	"0.0-3.0-7.0-9.0-4.0-6.0-8.0-5.0-2.0-4.1-9.1-7.1-2.1-5.1-2.0-4.1-9.1-7.1-2.1-5.0-2.0-4.1-9.1-7.1-2.1-5.0-2.0-1.0"	100	"AV_HG01106#haplotype1#0000048:16666181-17262214"	325379	334170
"ENST00000414303.7"	1584	4	1583	"+"	"AV_HG01106#haplotype1#0000048:16666181-17262214"	596033	161348	169618	1574	8270	15	"P"	491	1499	1420	1e-04	0	"AV_HG01106#haplotype1#0000048:16666181-17262214"	"AMY2A-201"	"2A"	"AV_HG01106"	"0-3-7-9-4-6-8-5-2-4-9-7-2-5-2-4-9-7-2-5-2-4-9-7-2-5-2-1"	"0.0-3.0-7.0-9.0-4.0-6.0-8.0-5.0-2.0-4.1-9.1-7.1-2.1-5.1-2.0-4.1-9.1-7.1-2.1-5.0-2.0-4.1-9.1-7.1-2.1-5.0-2.0-1.0"	100	"AV_HG01106#haplotype1#0000048:16666181-17262214"	161348	169618
"ENST00000610648.1"	1736	4	1733	"+"	"AV_HG01106#haplotype1#0000048:16666181-17262214"	596033	115017	123441	1720	8424	44	"P"	531	1638	1394	1e-04	0	"AV_HG01106#haplotype1#0000048:16666181-17262214"	"AMY2B-208"	"2B"	"AV_HG01106"	"0-3-7-9-4-6-8-5-2-4-9-7-2-5-2-4-9-7-2-5-2-4-9-7-2-5-2-1"	"0.0-3.0-7.0-9.0-4.0-6.0-8.0-5.0-2.0-4.1-9.1-7.1-2.1-5.1-2.0-4.1-9.1-7.1-2.1-5.0-2.0-4.1-9.1-7.1-2.1-5.0-2.0-1.0"	100	"AV_HG01106#haplotype1#0000048:16666181-17262214"	115017	123441
"ENST00000370083.9"	1785	2	1784	"-"	"AV_HG01106#haplotype2#0000932:16673968-17175925"	501957	325399	334191	1769	8792	0	"P"	557	1686	1686	1e-04	0	"AV_HG01106#haplotype2#0000932:16673968-17175925"	"AMY1A-201"	"1"	"AV_HG01106"	"0-3-7-9-4-6-8-5-2-7-9-4-2-5-2-4-9-7-2-5-2-1"	"0.0-3.0-7.0-9.0-4.0-6.0-8.0-5.0-2.0-7.0-9.0-4.0-2.1-5.1-2.0-4.1-9.1-7.1-2.1-5.0-2.0-1.0"	100	"AV_HG01106#haplotype2#0000932:16673968-17175925"	325399	334191
"ENST00000370083.9"	1785	2	1784	"+"	"AV_HG01106#haplotype2#0000932:16673968-17175925"	501957	293744	302536	1769	8792	0	"S"	557	1686	NA	1e-04	0	"AV_HG01106#haplotype2#0000932:16673968-17175925"	"AMY1A-201"	"1"	"AV_HG01106"	"0-3-7-9-4-6-8-5-2-7-9-4-2-5-2-4-9-7-2-5-2-1"	"0.0-3.0-7.0-9.0-4.0-6.0-8.0-5.0-2.0-7.0-9.0-4.0-2.1-5.1-2.0-4.1-9.1-7.1-2.1-5.0-2.0-1.0"	100	"AV_HG01106#haplotype2#0000932:16673968-17175925"	293744	302536
"ENST00000370083.9"	1785	2	1784	"-"	"AV_HG01106#haplotype2#0000932:16673968-17175925"	501957	231277	240069	1769	8792	0	"S"	557	1686	NA	1e-04	0	"AV_HG01106#haplotype2#0000932:16673968-17175925"	"AMY1A-201"	"1"	"AV_HG01106"	"0-3-7-9-4-6-8-5-2-7-9-4-2-5-2-4-9-7-2-5-2-1"	"0.0-3.0-7.0-9.0-4.0-6.0-8.0-5.0-2.0-7.0-9.0-4.0-2.1-5.1-2.0-4.1-9.1-7.1-2.1-5.0-2.0-1.0"	100	"AV_HG01106#haplotype2#0000932:16673968-17175925"	231277	240069
"ENST00000370083.9"	1785	2	1784	"+"	"AV_HG01106#haplotype2#0000932:16673968-17175925"	501957	387861	396653	1769	8792	0	"S"	557	1686	NA	1e-04	0	"AV_HG01106#haplotype2#0000932:16673968-17175925"	"AMY1A-201"	"1"	"AV_HG01106"	"0-3-7-9-4-6-8-5-2-7-9-4-2-5-2-4-9-7-2-5-2-1"	"0.0-3.0-7.0-9.0-4.0-6.0-8.0-5.0-2.0-7.0-9.0-4.0-2.1-5.1-2.0-4.1-9.1-7.1-2.1-5.0-2.0-1.0"	100	"AV_HG01106#haplotype2#0000932:16673968-17175925"	387861	396653
"ENST00000370083.9"	1785	2	1784	"+"	"AV_HG01106#haplotype2#0000932:16673968-17175925"	501957	199620	208413	1769	8793	0	"S"	557	1686	NA	1e-04	0	"AV_HG01106#haplotype2#0000932:16673968-17175925"	"AMY1A-201"	"1"	"AV_HG01106"	"0-3-7-9-4-6-8-5-2-7-9-4-2-5-2-4-9-7-2-5-2-1"	"0.0-3.0-7.0-9.0-4.0-6.0-8.0-5.0-2.0-7.0-9.0-4.0-2.1-5.1-2.0-4.1-9.1-7.1-2.1-5.0-2.0-1.0"	100	"AV_HG01106#haplotype2#0000932:16673968-17175925"	199620	208413
"ENST00000414303.7"	1584	4	1583	"+"	"AV_HG01106#haplotype2#0000932:16673968-17175925"	501957	161361	169631	1574	8270	15	"P"	491	1499	1420	1e-04	0	"AV_HG01106#haplotype2#0000932:16673968-17175925"	"AMY2A-201"	"2A"	"AV_HG01106"	"0-3-7-9-4-6-8-5-2-7-9-4-2-5-2-4-9-7-2-5-2-1"	"0.0-3.0-7.0-9.0-4.0-6.0-8.0-5.0-2.0-7.0-9.0-4.0-2.1-5.1-2.0-4.1-9.1-7.1-2.1-5.0-2.0-1.0"	100	"AV_HG01106#haplotype2#0000932:16673968-17175925"	161361	169631
"ENST00000610648.1"	1736	4	1733	"+"	"AV_HG01106#haplotype2#0000932:16673968-17175925"	501957	115036	123458	1720	8422	48	"P"	531	1638	1371	1e-04	0	"AV_HG01106#haplotype2#0000932:16673968-17175925"	"AMY2B-208"	"2B"	"AV_HG01106"	"0-3-7-9-4-6-8-5-2-7-9-4-2-5-2-4-9-7-2-5-2-1"	"0.0-3.0-7.0-9.0-4.0-6.0-8.0-5.0-2.0-7.0-9.0-4.0-2.1-5.1-2.0-4.1-9.1-7.1-2.1-5.0-2.0-1.0"	100	"AV_HG01106#haplotype2#0000932:16673968-17175925"	115036	123458
"ENST00000370083.9"	1785	2	1784	"+"	"AV_HG01175#haplotype1#0000070:46006269-46414083"	407814	293713	302505	1769	8792	0	"P"	557	1686	1686	1e-04	0	"AV_HG01175#haplotype1#0000070:46006269-46414083"	"AMY1A-201"	"1"	"AV_HG01175"	"0-3-7-9-4-6-8-5-2-4-9-7-2-5-2-1"	"0.0-3.0-7.0-9.0-4.0-6.0-8.0-5.0-2.0-4.1-9.1-7.1-2.1-5.0-2.0-1.0"	100	"AV_HG01175#haplotype1#0000070:46006269-46414083"	293713	302505
"ENST00000370083.9"	1785	2	1784	"-"	"AV_HG01175#haplotype1#0000070:46006269-46414083"	407814	231241	240034	1769	8793	0	"S"	557	1686	NA	1e-04	0	"AV_HG01175#haplotype1#0000070:46006269-46414083"	"AMY1A-201"	"1"	"AV_HG01175"	"0-3-7-9-4-6-8-5-2-4-9-7-2-5-2-1"	"0.0-3.0-7.0-9.0-4.0-6.0-8.0-5.0-2.0-4.1-9.1-7.1-2.1-5.0-2.0-1.0"	100	"AV_HG01175#haplotype1#0000070:46006269-46414083"	231241	240034
"ENST00000370083.9"	1785	2	1784	"+"	"AV_HG01175#haplotype1#0000070:46006269-46414083"	407814	199585	208377	1769	8792	0	"S"	557	1686	NA	1e-04	0	"AV_HG01175#haplotype1#0000070:46006269-46414083"	"AMY1A-201"	"1"	"AV_HG01175"	"0-3-7-9-4-6-8-5-2-4-9-7-2-5-2-1"	"0.0-3.0-7.0-9.0-4.0-6.0-8.0-5.0-2.0-4.1-9.1-7.1-2.1-5.0-2.0-1.0"	100	"AV_HG01175#haplotype1#0000070:46006269-46414083"	199585	208377
"ENST00000414303.7"	1584	4	1583	"+"	"AV_HG01175#haplotype1#0000070:46006269-46414083"	407814	161333	169603	1574	8270	30	"P"	491	1499	1342	1e-04	0	"AV_HG01175#haplotype1#0000070:46006269-46414083"	"AMY2A-201"	"2A"	"AV_HG01175"	"0-3-7-9-4-6-8-5-2-4-9-7-2-5-2-1"	"0.0-3.0-7.0-9.0-4.0-6.0-8.0-5.0-2.0-4.1-9.1-7.1-2.1-5.0-2.0-1.0"	100	"AV_HG01175#haplotype1#0000070:46006269-46414083"	161333	169603
"ENST00000610648.1"	1736	4	1733	"+"	"AV_HG01175#haplotype1#0000070:46006269-46414083"	407814	115004	123428	1720	8424	48	"P"	531	1638	1371	1e-04	0	"AV_HG01175#haplotype1#0000070:46006269-46414083"	"AMY2B-208"	"2B"	"AV_HG01175"	"0-3-7-9-4-6-8-5-2-4-9-7-2-5-2-1"	"0.0-3.0-7.0-9.0-4.0-6.0-8.0-5.0-2.0-4.1-9.1-7.1-2.1-5.0-2.0-1.0"	100	"AV_HG01175#haplotype1#0000070:46006269-46414083"	115004	123428
"ENST00000370083.9"	1785	2	1784	"+"	"AV_HG01361#haplotype1#0000023:101593539-102001341"	407802	199643	208434	1769	8791	0	"P"	557	1686	1686	1e-04	0	"AV_HG01361#haplotype1#0000023:101593539-102001341"	"AMY1A-201"	"1"	"AV_HG01361"	"0-3-7-9-4-6-8-5-2-4-9-7-2-5-2-1"	"0.0-3.0-7.0-9.0-4.0-6.0-8.0-5.0-2.0-4.1-9.1-7.1-2.1-5.1-2.0-1.0"	99	"AV_HG01361#haplotype1#0000023:101593539-102001341"	199643	208434
"ENST00000370083.9"	1785	2	1784	"+"	"AV_HG01361#haplotype1#0000023:101593539-102001341"	407802	293750	302541	1769	8791	0	"S"	557	1686	NA	1e-04	0	"AV_HG01361#haplotype1#0000023:101593539-102001341"	"AMY1A-201"	"1"	"AV_HG01361"	"0-3-7-9-4-6-8-5-2-4-9-7-2-5-2-1"	"0.0-3.0-7.0-9.0-4.0-6.0-8.0-5.0-2.0-4.1-9.1-7.1-2.1-5.1-2.0-1.0"	99	"AV_HG01361#haplotype1#0000023:101593539-102001341"	293750	302541
"ENST00000370083.9"	1785	2	1784	"-"	"AV_HG01361#haplotype1#0000023:101593539-102001341"	407802	231294	240085	1769	8791	0	"S"	557	1686	NA	1e-04	0	"AV_HG01361#haplotype1#0000023:101593539-102001341"	"AMY1A-201"	"1"	"AV_HG01361"	"0-3-7-9-4-6-8-5-2-4-9-7-2-5-2-1"	"0.0-3.0-7.0-9.0-4.0-6.0-8.0-5.0-2.0-4.1-9.1-7.1-2.1-5.1-2.0-1.0"	99	"AV_HG01361#haplotype1#0000023:101593539-102001341"	231294	240085
"ENST00000414303.7"	1584	4	1579	"+"	"AV_HG01361#haplotype1#0000023:101593539-102001341"	407802	161390	169656	1559	8266	27	"P"	483	1484	1342	0.0011	0	"AV_HG01361#haplotype1#0000023:101593539-102001341"	"AMY2A-201"	"2A"	"AV_HG01361"	"0-3-7-9-4-6-8-5-2-4-9-7-2-5-2-1"	"0.0-3.0-7.0-9.0-4.0-6.0-8.0-5.0-2.0-4.1-9.1-7.1-2.1-5.1-2.0-1.0"	99	"AV_HG01361#haplotype1#0000023:101593539-102001341"	161390	169656
"ENST00000610648.1"	1736	4	1733	"+"	"AV_HG01361#haplotype1#0000023:101593539-102001341"	407802	115070	123492	1720	8422	48	"P"	531	1638	1371	1e-04	0	"AV_HG01361#haplotype1#0000023:101593539-102001341"	"AMY2B-208"	"2B"	"AV_HG01361"	"0-3-7-9-4-6-8-5-2-4-9-7-2-5-2-1"	"0.0-3.0-7.0-9.0-4.0-6.0-8.0-5.0-2.0-4.1-9.1-7.1-2.1-5.1-2.0-1.0"	99	"AV_HG01361#haplotype1#0000023:101593539-102001341"	115070	123492
"ENST00000370083.9"	1785	2	1784	"+"	"AV_HG01361#haplotype2#0001322:101872897-102186552"	313655	199626	208417	1769	8791	50	"P"	557	1686	1397	1e-04	0	"AV_HG01361#haplotype2#0001322:101872897-102186552"	"AMY1A-201"	"1"	"AV_HG01361"	"0-3-7-9-4-6-8-5-2-1"	"0.0-3.0-7.0-9.0-4.0-6.0-8.0-5.0-2.0-1.0"	99	"AV_HG01361#haplotype2#0001322:101872897-102186552"	199626	208417
"ENST00000414303.7"	1584	4	1579	"+"	"AV_HG01361#haplotype2#0001322:101872897-102186552"	313655	161367	169633	1563	8266	28	"P"	484	1488	1342	0.001	0	"AV_HG01361#haplotype2#0001322:101872897-102186552"	"AMY2A-201"	"2A"	"AV_HG01361"	"0-3-7-9-4-6-8-5-2-1"	"0.0-3.0-7.0-9.0-4.0-6.0-8.0-5.0-2.0-1.0"	99	"AV_HG01361#haplotype2#0001322:101872897-102186552"	161367	169633
"ENST00000610648.1"	1736	4	1733	"+"	"AV_HG01361#haplotype2#0001322:101872897-102186552"	313655	115042	123464	1720	8422	51	"P"	531	1638	1351	1e-04	0	"AV_HG01361#haplotype2#0001322:101872897-102186552"	"AMY2B-208"	"2B"	"AV_HG01361"	"0-3-7-9-4-6-8-5-2-1"	"0.0-3.0-7.0-9.0-4.0-6.0-8.0-5.0-2.0-1.0"	99	"AV_HG01361#haplotype2#0001322:101872897-102186552"	115042	123464
"ENST00000370083.9"	1785	2	1784	"+"	"AV_HG02148#haplotype2#0002863:16304803-16712699"	407896	293780	302572	1769	8792	0	"P"	557	1686	1686	1e-04	0	"AV_HG02148#haplotype2#0002863:16304803-16712699"	"AMY1A-201"	"1"	"AV_HG02148"	"0-3-7-9-4-6-8-5-2-4-9-7-2-5-2-1"	"0.0-3.0-7.0-9.0-4.0-6.0-8.0-5.0-2.0-4.1-9.1-7.1-2.1-5.0-2.0-1.0"	100	"AV_HG02148#haplotype2#0002863:16304803-16712699"	293780	302572
"ENST00000370083.9"	1785	2	1784	"-"	"AV_HG02148#haplotype2#0002863:16304803-16712699"	407896	231316	240110	1769	8794	0	"S"	557	1686	NA	1e-04	0	"AV_HG02148#haplotype2#0002863:16304803-16712699"	"AMY1A-201"	"1"	"AV_HG02148"	"0-3-7-9-4-6-8-5-2-4-9-7-2-5-2-1"	"0.0-3.0-7.0-9.0-4.0-6.0-8.0-5.0-2.0-4.1-9.1-7.1-2.1-5.0-2.0-1.0"	100	"AV_HG02148#haplotype2#0002863:16304803-16712699"	231316	240110
"ENST00000370083.9"	1785	2	1784	"+"	"AV_HG02148#haplotype2#0002863:16304803-16712699"	407896	199660	208453	1769	8793	0	"S"	557	1686	NA	1e-04	0	"AV_HG02148#haplotype2#0002863:16304803-16712699"	"AMY1A-201"	"1"	"AV_HG02148"	"0-3-7-9-4-6-8-5-2-4-9-7-2-5-2-1"	"0.0-3.0-7.0-9.0-4.0-6.0-8.0-5.0-2.0-4.1-9.1-7.1-2.1-5.0-2.0-1.0"	100	"AV_HG02148#haplotype2#0002863:16304803-16712699"	199660	208453
"ENST00000414303.7"	1584	4	1583	"+"	"AV_HG02148#haplotype2#0002863:16304803-16712699"	407896	161403	169673	1574	8270	30	"P"	491	1499	1342	1e-04	0	"AV_HG02148#haplotype2#0002863:16304803-16712699"	"AMY2A-201"	"2A"	"AV_HG02148"	"0-3-7-9-4-6-8-5-2-4-9-7-2-5-2-1"	"0.0-3.0-7.0-9.0-4.0-6.0-8.0-5.0-2.0-4.1-9.1-7.1-2.1-5.0-2.0-1.0"	100	"AV_HG02148#haplotype2#0002863:16304803-16712699"	161403	169673
"ENST00000610648.1"	1736	4	1733	"+"	"AV_HG02148#haplotype2#0002863:16304803-16712699"	407896	115077	123499	1720	8422	48	"P"	531	1638	1371	1e-04	0	"AV_HG02148#haplotype2#0002863:16304803-16712699"	"AMY2B-208"	"2B"	"AV_HG02148"	"0-3-7-9-4-6-8-5-2-4-9-7-2-5-2-1"	"0.0-3.0-7.0-9.0-4.0-6.0-8.0-5.0-2.0-4.1-9.1-7.1-2.1-5.0-2.0-1.0"	100	"AV_HG02148#haplotype2#0002863:16304803-16712699"	115077	123499
"ENST00000370083.9"	1785	2	1784	"+"	"AV_HG02257#haplotype2#0001152:102843493-103251377"	407884	293786	302577	1769	8791	0	"P"	557	1686	1686	1e-04	0	"AV_HG02257#haplotype2#0001152:102843493-103251377"	"AMY1A-201"	"1"	"AV_HG02257"	"0-3-7-9-4-6-8-5-2-4-9-7-2-5-2-1"	"0.0-3.0-7.0-9.0-4.0-6.0-8.0-5.0-2.0-4.1-9.1-7.1-2.1-5.0-2.0-1.0"	99	"AV_HG02257#haplotype2#0001152:102843493-103251377"	293786	302577
"ENST00000370083.9"	1785	2	1784	"+"	"AV_HG02257#haplotype2#0001152:102843493-103251377"	407884	199674	208464	1769	8790	0	"S"	557	1686	NA	1e-04	0	"AV_HG02257#haplotype2#0001152:102843493-103251377"	"AMY1A-201"	"1"	"AV_HG02257"	"0-3-7-9-4-6-8-5-2-4-9-7-2-5-2-1"	"0.0-3.0-7.0-9.0-4.0-6.0-8.0-5.0-2.0-4.1-9.1-7.1-2.1-5.0-2.0-1.0"	99	"AV_HG02257#haplotype2#0001152:102843493-103251377"	199674	208464
"ENST00000370083.9"	1785	2	1784	"-"	"AV_HG02257#haplotype2#0001152:102843493-103251377"	407884	231323	240114	1769	8791	0	"S"	557	1686	NA	1e-04	0	"AV_HG02257#haplotype2#0001152:102843493-103251377"	"AMY1A-201"	"1"	"AV_HG02257"	"0-3-7-9-4-6-8-5-2-4-9-7-2-5-2-1"	"0.0-3.0-7.0-9.0-4.0-6.0-8.0-5.0-2.0-4.1-9.1-7.1-2.1-5.0-2.0-1.0"	99	"AV_HG02257#haplotype2#0001152:102843493-103251377"	231323	240114
"ENST00000414303.7"	1584	4	1583	"+"	"AV_HG02257#haplotype2#0001152:102843493-103251377"	407884	161371	169676	1562	8305	28	"P"	480	1487	1342	0.0016	0	"AV_HG02257#haplotype2#0001152:102843493-103251377"	"AMY2A-201"	"2A"	"AV_HG02257"	"0-3-7-9-4-6-8-5-2-4-9-7-2-5-2-1"	"0.0-3.0-7.0-9.0-4.0-6.0-8.0-5.0-2.0-4.1-9.1-7.1-2.1-5.0-2.0-1.0"	99	"AV_HG02257#haplotype2#0001152:102843493-103251377"	161371	169676
"ENST00000610648.1"	1736	4	1733	"+"	"AV_HG02257#haplotype2#0001152:102843493-103251377"	407884	115038	123460	1720	8422	48	"P"	531	1638	1371	1e-04	0	"AV_HG02257#haplotype2#0001152:102843493-103251377"	"AMY2B-208"	"2B"	"AV_HG02257"	"0-3-7-9-4-6-8-5-2-4-9-7-2-5-2-1"	"0.0-3.0-7.0-9.0-4.0-6.0-8.0-5.0-2.0-4.1-9.1-7.1-2.1-5.0-2.0-1.0"	99	"AV_HG02257#haplotype2#0001152:102843493-103251377"	115038	123460
"ENST00000370083.9"	1785	2	1784	"-"	"HG02080#1#JAHEOW010000048.1_16689583_17097287_0"	407704	231201	239992	1769	8791	0	"P"	557	1686	1686	1e-04	0	"HG02080#1#JAHEOW010000048.1_16689583_17097287_0"	"AMY1A-201"	"1"	"HG02080"	"0-3-7-9-4-6-8-5-2-4-9-7-2-5-2-1"	"0.0-3.0-7.0-9.0-4.0-6.0-8.0-5.0-2.0-4.1-9.1-7.1-2.1-5.1-2.0-1.0"	98	"HG02080#1#JAHEOW010000048.1_16689583_17097287_0"	231201	239992
"ENST00000370083.9"	1785	2	1784	"+"	"HG02080#1#JAHEOW010000048.1_16689583_17097287_0"	407704	293662	302453	1769	8791	0	"S"	557	1686	NA	1e-04	0	"HG02080#1#JAHEOW010000048.1_16689583_17097287_0"	"AMY1A-201"	"1"	"HG02080"	"0-3-7-9-4-6-8-5-2-4-9-7-2-5-2-1"	"0.0-3.0-7.0-9.0-4.0-6.0-8.0-5.0-2.0-4.1-9.1-7.1-2.1-5.1-2.0-1.0"	98	"HG02080#1#JAHEOW010000048.1_16689583_17097287_0"	293662	302453
"ENST00000370083.9"	1785	2	1784	"+"	"HG02080#1#JAHEOW010000048.1_16689583_17097287_0"	407704	199566	208357	1769	8791	0	"S"	557	1686	NA	1e-04	0	"HG02080#1#JAHEOW010000048.1_16689583_17097287_0"	"AMY1A-201"	"1"	"HG02080"	"0-3-7-9-4-6-8-5-2-4-9-7-2-5-2-1"	"0.0-3.0-7.0-9.0-4.0-6.0-8.0-5.0-2.0-4.1-9.1-7.1-2.1-5.1-2.0-1.0"	98	"HG02080#1#JAHEOW010000048.1_16689583_17097287_0"	199566	208357
"ENST00000414303.7"	1584	4	1579	"+"	"HG02080#1#JAHEOW010000048.1_16689583_17097287_0"	407704	161314	169580	1563	8266	28	"P"	484	1488	1342	0.001	0	"HG02080#1#JAHEOW010000048.1_16689583_17097287_0"	"AMY2A-201"	"2A"	"HG02080"	"0-3-7-9-4-6-8-5-2-4-9-7-2-5-2-1"	"0.0-3.0-7.0-9.0-4.0-6.0-8.0-5.0-2.0-4.1-9.1-7.1-2.1-5.1-2.0-1.0"	98	"HG02080#1#JAHEOW010000048.1_16689583_17097287_0"	161314	169580
"ENST00000610648.1"	1736	4	1733	"+"	"HG02080#1#JAHEOW010000048.1_16689583_17097287_0"	407704	114996	123418	1720	8422	48	"P"	531	1638	1371	1e-04	0	"HG02080#1#JAHEOW010000048.1_16689583_17097287_0"	"AMY2B-208"	"2B"	"HG02080"	"0-3-7-9-4-6-8-5-2-4-9-7-2-5-2-1"	"0.0-3.0-7.0-9.0-4.0-6.0-8.0-5.0-2.0-4.1-9.1-7.1-2.1-5.1-2.0-1.0"	98	"HG02080#1#JAHEOW010000048.1_16689583_17097287_0"	114996	123418
"ENST00000370083.9"	1785	2	1784	"+"	"HG00621#2#JAHBCC010000031.1_16669999_17077865_0"	407866	293780	302572	1769	8792	0	"P"	557	1686	1686	1e-04	0	"HG00621#2#JAHBCC010000031.1_16669999_17077865_0"	"AMY1A-201"	"1"	"HG00621"	"0-3-7-9-4-6-8-5-2-4-9-7-2-5-2-1"	"0.0-3.0-7.0-9.0-4.0-6.0-8.0-5.0-2.0-4.1-9.1-7.1-2.1-5.0-2.0-1.0"	99	"HG00621#2#JAHBCC010000031.1_16669999_17077865_0"	293780	302572
"ENST00000370083.9"	1785	2	1784	"+"	"HG00621#2#JAHBCC010000031.1_16669999_17077865_0"	407866	199648	208439	1769	8791	0	"S"	557	1686	NA	1e-04	0	"HG00621#2#JAHBCC010000031.1_16669999_17077865_0"	"AMY1A-201"	"1"	"HG00621"	"0-3-7-9-4-6-8-5-2-4-9-7-2-5-2-1"	"0.0-3.0-7.0-9.0-4.0-6.0-8.0-5.0-2.0-4.1-9.1-7.1-2.1-5.0-2.0-1.0"	99	"HG00621#2#JAHBCC010000031.1_16669999_17077865_0"	199648	208439
"ENST00000370083.9"	1785	2	1784	"-"	"HG00621#2#JAHBCC010000031.1_16669999_17077865_0"	407866	231306	240098	1769	8792	0	"S"	557	1686	NA	1e-04	0	"HG00621#2#JAHBCC010000031.1_16669999_17077865_0"	"AMY1A-201"	"1"	"HG00621"	"0-3-7-9-4-6-8-5-2-4-9-7-2-5-2-1"	"0.0-3.0-7.0-9.0-4.0-6.0-8.0-5.0-2.0-4.1-9.1-7.1-2.1-5.0-2.0-1.0"	99	"HG00621#2#JAHBCC010000031.1_16669999_17077865_0"	231306	240098
"ENST00000414303.7"	1584	4	1583	"+"	"HG00621#2#JAHBCC010000031.1_16669999_17077865_0"	407866	161404	169674	1574	8270	30	"P"	491	1499	1342	1e-04	0	"HG00621#2#JAHBCC010000031.1_16669999_17077865_0"	"AMY2A-201"	"2A"	"HG00621"	"0-3-7-9-4-6-8-5-2-4-9-7-2-5-2-1"	"0.0-3.0-7.0-9.0-4.0-6.0-8.0-5.0-2.0-4.1-9.1-7.1-2.1-5.0-2.0-1.0"	99	"HG00621#2#JAHBCC010000031.1_16669999_17077865_0"	161404	169674
"ENST00000610648.1"	1736	4	1733	"+"	"HG00621#2#JAHBCC010000031.1_16669999_17077865_0"	407866	115075	123499	1720	8424	48	"P"	531	1638	1371	1e-04	0	"HG00621#2#JAHBCC010000031.1_16669999_17077865_0"	"AMY2B-208"	"2B"	"HG00621"	"0-3-7-9-4-6-8-5-2-4-9-7-2-5-2-1"	"0.0-3.0-7.0-9.0-4.0-6.0-8.0-5.0-2.0-4.1-9.1-7.1-2.1-5.0-2.0-1.0"	99	"HG00621#2#JAHBCC010000031.1_16669999_17077865_0"	115075	123499
"ENST00000370083.9"	1785	2	1784	"+"	"HG00621#1#JAHBCD010000034.1_2122997_2624098_1"	501101	293828	302620	1769	8792	0	"P"	557	1686	1686	1e-04	0	"HG00621#1#JAHBCD010000034.1_2122997_2624098_1"	"AMY1A-201"	"1"	"HG00621"	"0-3-7-9-4-6-8-5-2-4-9-7-2-5-2-4-9-7-2-5-2-1"	"0.0-3.0-7.0-9.0-4.0-6.0-8.0-5.0-2.0-4.1-9.1-7.1-2.1-5.1-2.0-4.1-9.1-7.1-2.1-5.1-2.0-1.0"	155	"HG00621#1#JAHBCD010000034.1_2122997_2624098_1"	293828	302620
"ENST00000370083.9"	1785	2	1784	"-"	"HG00621#1#JAHBCD010000034.1_2122997_2624098_1"	501101	231335	240128	1769	8793	0	"S"	557	1686	NA	1e-04	0	"HG00621#1#JAHBCD010000034.1_2122997_2624098_1"	"AMY1A-201"	"1"	"HG00621"	"0-3-7-9-4-6-8-5-2-4-9-7-2-5-2-4-9-7-2-5-2-1"	"0.0-3.0-7.0-9.0-4.0-6.0-8.0-5.0-2.0-4.1-9.1-7.1-2.1-5.1-2.0-4.1-9.1-7.1-2.1-5.1-2.0-1.0"	155	"HG00621#1#JAHBCD010000034.1_2122997_2624098_1"	231335	240128
"ENST00000370083.9"	1785	2	1784	"+"	"HG00621#1#JAHBCD010000034.1_2122997_2624098_1"	501101	199680	208474	1769	8794	0	"S"	557	1686	NA	1e-04	0	"HG00621#1#JAHBCD010000034.1_2122997_2624098_1"	"AMY1A-201"	"1"	"HG00621"	"0-3-7-9-4-6-8-5-2-4-9-7-2-5-2-4-9-7-2-5-2-1"	"0.0-3.0-7.0-9.0-4.0-6.0-8.0-5.0-2.0-4.1-9.1-7.1-2.1-5.1-2.0-4.1-9.1-7.1-2.1-5.1-2.0-1.0"	155	"HG00621#1#JAHBCD010000034.1_2122997_2624098_1"	199680	208474
"ENST00000370083.9"	1785	2	1784	"+"	"HG00621#1#JAHBCD010000034.1_2122997_2624098_1"	501101	387982	396774	1769	8792	0	"S"	557	1686	NA	1e-04	0	"HG00621#1#JAHBCD010000034.1_2122997_2624098_1"	"AMY1A-201"	"1"	"HG00621"	"0-3-7-9-4-6-8-5-2-4-9-7-2-5-2-4-9-7-2-5-2-1"	"0.0-3.0-7.0-9.0-4.0-6.0-8.0-5.0-2.0-4.1-9.1-7.1-2.1-5.1-2.0-4.1-9.1-7.1-2.1-5.1-2.0-1.0"	155	"HG00621#1#JAHBCD010000034.1_2122997_2624098_1"	387982	396774
"ENST00000370083.9"	1785	2	1784	"-"	"HG00621#1#JAHBCD010000034.1_2122997_2624098_1"	501101	325489	334282	1769	8793	0	"S"	557	1686	NA	1e-04	0	"HG00621#1#JAHBCD010000034.1_2122997_2624098_1"	"AMY1A-201"	"1"	"HG00621"	"0-3-7-9-4-6-8-5-2-4-9-7-2-5-2-4-9-7-2-5-2-1"	"0.0-3.0-7.0-9.0-4.0-6.0-8.0-5.0-2.0-4.1-9.1-7.1-2.1-5.1-2.0-4.1-9.1-7.1-2.1-5.1-2.0-1.0"	155	"HG00621#1#JAHBCD010000034.1_2122997_2624098_1"	325489	334282
"ENST00000414303.7"	1584	4	1583	"+"	"HG00621#1#JAHBCD010000034.1_2122997_2624098_1"	501101	161422	169692	1574	8270	30	"P"	491	1499	1342	1e-04	0	"HG00621#1#JAHBCD010000034.1_2122997_2624098_1"	"AMY2A-201"	"2A"	"HG00621"	"0-3-7-9-4-6-8-5-2-4-9-7-2-5-2-4-9-7-2-5-2-1"	"0.0-3.0-7.0-9.0-4.0-6.0-8.0-5.0-2.0-4.1-9.1-7.1-2.1-5.1-2.0-4.1-9.1-7.1-2.1-5.1-2.0-1.0"	155	"HG00621#1#JAHBCD010000034.1_2122997_2624098_1"	161422	169692
"ENST00000610648.1"	1736	4	1733	"+"	"HG00621#1#JAHBCD010000034.1_2122997_2624098_1"	501101	115093	123517	1720	8424	48	"P"	531	1638	1371	1e-04	0	"HG00621#1#JAHBCD010000034.1_2122997_2624098_1"	"AMY2B-208"	"2B"	"HG00621"	"0-3-7-9-4-6-8-5-2-4-9-7-2-5-2-4-9-7-2-5-2-1"	"0.0-3.0-7.0-9.0-4.0-6.0-8.0-5.0-2.0-4.1-9.1-7.1-2.1-5.1-2.0-4.1-9.1-7.1-2.1-5.1-2.0-1.0"	155	"HG00621#1#JAHBCD010000034.1_2122997_2624098_1"	115093	123517
"ENST00000370083.9"	1785	2	1784	"-"	"HG02818#2#JAHEOR010000010.1_31775319_32183091_1"	407772	231351	240143	1769	8792	0	"P"	557	1686	1686	1e-04	0	"HG02818#2#JAHEOR010000010.1_31775319_32183091_1"	"AMY1A-201"	"1"	"HG02818"	"0-3-7-9-4-6-8-5-2-4-9-7-2-5-2-1"	"0.0-3.0-7.0-9.0-4.0-6.0-8.0-5.0-2.0-4.1-9.1-7.1-2.1-5.0-2.0-1.0"	154	"HG02818#2#JAHEOR010000010.1_31775319_32183091_1"	231351	240143
"ENST00000370083.9"	1785	2	1784	"+"	"HG02818#2#JAHEOR010000010.1_31775319_32183091_1"	407772	293830	302621	1769	8791	0	"S"	557	1686	NA	1e-04	0	"HG02818#2#JAHEOR010000010.1_31775319_32183091_1"	"AMY1A-201"	"1"	"HG02818"	"0-3-7-9-4-6-8-5-2-4-9-7-2-5-2-1"	"0.0-3.0-7.0-9.0-4.0-6.0-8.0-5.0-2.0-4.1-9.1-7.1-2.1-5.0-2.0-1.0"	154	"HG02818#2#JAHEOR010000010.1_31775319_32183091_1"	293830	302621
"ENST00000370083.9"	1785	2	1784	"+"	"HG02818#2#JAHEOR010000010.1_31775319_32183091_1"	407772	199708	208500	1769	8792	0	"S"	557	1686	NA	1e-04	0	"HG02818#2#JAHEOR010000010.1_31775319_32183091_1"	"AMY1A-201"	"1"	"HG02818"	"0-3-7-9-4-6-8-5-2-4-9-7-2-5-2-1"	"0.0-3.0-7.0-9.0-4.0-6.0-8.0-5.0-2.0-4.1-9.1-7.1-2.1-5.0-2.0-1.0"	154	"HG02818#2#JAHEOR010000010.1_31775319_32183091_1"	199708	208500
"ENST00000414303.7"	1584	4	1583	"+"	"HG02818#2#JAHEOR010000010.1_31775319_32183091_1"	407772	161409	169713	1563	8304	28	"P"	488	1488	1342	5e-04	0	"HG02818#2#JAHEOR010000010.1_31775319_32183091_1"	"AMY2A-201"	"2A"	"HG02818"	"0-3-7-9-4-6-8-5-2-4-9-7-2-5-2-1"	"0.0-3.0-7.0-9.0-4.0-6.0-8.0-5.0-2.0-4.1-9.1-7.1-2.1-5.0-2.0-1.0"	154	"HG02818#2#JAHEOR010000010.1_31775319_32183091_1"	161409	169713
"ENST00000610648.1"	1736	4	1733	"+"	"HG02818#2#JAHEOR010000010.1_31775319_32183091_1"	407772	115078	123502	1720	8424	48	"P"	531	1638	1371	1e-04	0	"HG02818#2#JAHEOR010000010.1_31775319_32183091_1"	"AMY2B-208"	"2B"	"HG02818"	"0-3-7-9-4-6-8-5-2-4-9-7-2-5-2-1"	"0.0-3.0-7.0-9.0-4.0-6.0-8.0-5.0-2.0-4.1-9.1-7.1-2.1-5.0-2.0-1.0"	154	"HG02818#2#JAHEOR010000010.1_31775319_32183091_1"	115078	123502
"ENST00000370083.9"	1785	2	1784	"+"	"HG02723#1#JAHEOU010000204.1_2102082_2414876_1"	312794	199716	208507	1769	8791	49	"P"	557	1686	1404	1e-04	0	"HG02723#1#JAHEOU010000204.1_2102082_2414876_1"	"AMY1A-201"	"1"	"HG02723"	"0-3-7-9-4-6-8-5-2-1"	"0.0-3.0-7.0-9.0-4.0-6.0-8.0-5.0-2.0-1.0"	154	"HG02723#1#JAHEOU010000204.1_2102082_2414876_1"	199716	208507
"ENST00000414303.7"	1584	4	1583	"+"	"HG02723#1#JAHEOU010000204.1_2102082_2414876_1"	312794	161428	169733	1574	8305	30	"P"	491	1499	1342	1e-04	0	"HG02723#1#JAHEOU010000204.1_2102082_2414876_1"	"AMY2A-201"	"2A"	"HG02723"	"0-3-7-9-4-6-8-5-2-1"	"0.0-3.0-7.0-9.0-4.0-6.0-8.0-5.0-2.0-1.0"	154	"HG02723#1#JAHEOU010000204.1_2102082_2414876_1"	161428	169733
"ENST00000610648.1"	1736	4	1733	"+"	"HG02723#1#JAHEOU010000204.1_2102082_2414876_1"	312794	115087	123511	1720	8424	50	"P"	531	1638	1358	1e-04	0	"HG02723#1#JAHEOU010000204.1_2102082_2414876_1"	"AMY2B-208"	"2B"	"HG02723"	"0-3-7-9-4-6-8-5-2-1"	"0.0-3.0-7.0-9.0-4.0-6.0-8.0-5.0-2.0-1.0"	154	"HG02723#1#JAHEOU010000204.1_2102082_2414876_1"	115087	123511
"ENST00000370083.9"	1785	2	1784	"+"	"HG00741#1#JAHALY010000007.1_18781197_19307680_1"	526483	315478	324258	1769	8780	0	"P"	557	1686	1686	1e-04	0	"HG00741#1#JAHALY010000007.1_18781197_19307680_1"	"AMY1A-201"	"1"	"HG00741"	"0-3-7-9-4-6-8-5-2-4-0-3-7-9-4-6-8-5-2-4-4-2-5-2-1"	"0.0-3.0-7.0-9.0-4.0-6.0-8.0-5.0-2.0-4.1-0.0-3.0-7.0-9.0-4.0-6.0-8.0-5.0-2.0-4.1-4.0-2.1-5.0-2.0-1.0"	154	"HG00741#1#JAHALY010000007.1_18781197_19307680_1"	315478	324258
"ENST00000370083.9"	1785	2	1784	"+"	"HG00741#1#JAHALY010000007.1_18781197_19307680_1"	526483	199696	208476	1769	8780	0	"S"	557	1686	NA	1e-04	0	"HG00741#1#JAHALY010000007.1_18781197_19307680_1"	"AMY1A-201"	"1"	"HG00741"	"0-3-7-9-4-6-8-5-2-4-0-3-7-9-4-6-8-5-2-4-4-2-5-2-1"	"0.0-3.0-7.0-9.0-4.0-6.0-8.0-5.0-2.0-4.1-0.0-3.0-7.0-9.0-4.0-6.0-8.0-5.0-2.0-4.1-4.0-2.1-5.0-2.0-1.0"	154	"HG00741#1#JAHALY010000007.1_18781197_19307680_1"	199696	208476
"ENST00000370083.9"	1785	2	1784	"-"	"HG00741#1#JAHALY010000007.1_18781197_19307680_1"	526483	350026	358806	1769	8780	0	"S"	557	1686	NA	1e-04	0	"HG00741#1#JAHALY010000007.1_18781197_19307680_1"	"AMY1A-201"	"1"	"HG00741"	"0-3-7-9-4-6-8-5-2-4-0-3-7-9-4-6-8-5-2-4-4-2-5-2-1"	"0.0-3.0-7.0-9.0-4.0-6.0-8.0-5.0-2.0-4.1-0.0-3.0-7.0-9.0-4.0-6.0-8.0-5.0-2.0-4.1-4.0-2.1-5.0-2.0-1.0"	154	"HG00741#1#JAHALY010000007.1_18781197_19307680_1"	350026	358806
"ENST00000370083.9"	1785	2	1784	"+"	"HG00741#1#JAHALY010000007.1_18781197_19307680_1"	526483	412487	421278	1769	8791	0	"S"	557	1686	NA	1e-04	0	"HG00741#1#JAHALY010000007.1_18781197_19307680_1"	"AMY1A-201"	"1"	"HG00741"	"0-3-7-9-4-6-8-5-2-4-0-3-7-9-4-6-8-5-2-4-4-2-5-2-1"	"0.0-3.0-7.0-9.0-4.0-6.0-8.0-5.0-2.0-4.1-0.0-3.0-7.0-9.0-4.0-6.0-8.0-5.0-2.0-4.1-4.0-2.1-5.0-2.0-1.0"	154	"HG00741#1#JAHALY010000007.1_18781197_19307680_1"	412487	421278
"ENST00000414303.7"	1584	4	1583	"+"	"HG00741#1#JAHALY010000007.1_18781197_19307680_1"	526483	277188	285493	1563	8305	0	"P"	488	1488	1488	5e-04	0	"HG00741#1#JAHALY010000007.1_18781197_19307680_1"	"AMY2A-201"	"2A"	"HG00741"	"0-3-7-9-4-6-8-5-2-4-0-3-7-9-4-6-8-5-2-4-4-2-5-2-1"	"0.0-3.0-7.0-9.0-4.0-6.0-8.0-5.0-2.0-4.1-0.0-3.0-7.0-9.0-4.0-6.0-8.0-5.0-2.0-4.1-4.0-2.1-5.0-2.0-1.0"	154	"HG00741#1#JAHALY010000007.1_18781197_19307680_1"	277188	285493
"ENST00000414303.7"	1584	4	1583	"+"	"HG00741#1#JAHALY010000007.1_18781197_19307680_1"	526483	161444	169714	1563	8270	0	"S"	488	1488	NA	5e-04	0	"HG00741#1#JAHALY010000007.1_18781197_19307680_1"	"AMY2A-201"	"2A"	"HG00741"	"0-3-7-9-4-6-8-5-2-4-0-3-7-9-4-6-8-5-2-4-4-2-5-2-1"	"0.0-3.0-7.0-9.0-4.0-6.0-8.0-5.0-2.0-4.1-0.0-3.0-7.0-9.0-4.0-6.0-8.0-5.0-2.0-4.1-4.0-2.1-5.0-2.0-1.0"	154	"HG00741#1#JAHALY010000007.1_18781197_19307680_1"	161444	169714
"ENST00000610648.1"	1736	4	1733	"+"	"HG00741#1#JAHALY010000007.1_18781197_19307680_1"	526483	115108	123530	1720	8422	0	"P"	531	1638	1638	1e-04	0	"HG00741#1#JAHALY010000007.1_18781197_19307680_1"	"AMY2B-208"	"2B"	"HG00741"	"0-3-7-9-4-6-8-5-2-4-0-3-7-9-4-6-8-5-2-4-4-2-5-2-1"	"0.0-3.0-7.0-9.0-4.0-6.0-8.0-5.0-2.0-4.1-0.0-3.0-7.0-9.0-4.0-6.0-8.0-5.0-2.0-4.1-4.0-2.1-5.0-2.0-1.0"	154	"HG00741#1#JAHALY010000007.1_18781197_19307680_1"	115108	123530
"ENST00000610648.1"	1736	4	1733	"+"	"HG00741#1#JAHALY010000007.1_18781197_19307680_1"	526483	230850	239272	1720	8422	0	"S"	531	1638	NA	1e-04	0	"HG00741#1#JAHALY010000007.1_18781197_19307680_1"	"AMY2B-208"	"2B"	"HG00741"	"0-3-7-9-4-6-8-5-2-4-0-3-7-9-4-6-8-5-2-4-4-2-5-2-1"	"0.0-3.0-7.0-9.0-4.0-6.0-8.0-5.0-2.0-4.1-0.0-3.0-7.0-9.0-4.0-6.0-8.0-5.0-2.0-4.1-4.0-2.1-5.0-2.0-1.0"	154	"HG00741#1#JAHALY010000007.1_18781197_19307680_1"	230850	239272
"ENST00000370083.9"	1785	2	1784	"-"	"HG01109#1#JAHEPA010000099.1_2104245_2511104_1"	406859	231324	240117	1769	8793	0	"P"	557	1686	1686	1e-04	0	"HG01109#1#JAHEPA010000099.1_2104245_2511104_1"	"AMY1A-201"	"1"	"HG01109"	"0-3-7-9-4-6-8-5-2-7-9-4-2-5-2-1"	"0.0-3.0-7.0-9.0-4.0-6.0-8.0-5.0-2.0-7.0-9.0-4.0-2.1-5.1-2.0-1.0"	155	"HG01109#1#JAHEPA010000099.1_2104245_2511104_1"	231324	240117
"ENST00000370083.9"	1785	2	1784	"+"	"HG01109#1#JAHEPA010000099.1_2104245_2511104_1"	406859	293807	302600	1769	8793	0	"S"	557	1686	NA	1e-04	0	"HG01109#1#JAHEPA010000099.1_2104245_2511104_1"	"AMY1A-201"	"1"	"HG01109"	"0-3-7-9-4-6-8-5-2-7-9-4-2-5-2-1"	"0.0-3.0-7.0-9.0-4.0-6.0-8.0-5.0-2.0-7.0-9.0-4.0-2.1-5.1-2.0-1.0"	155	"HG01109#1#JAHEPA010000099.1_2104245_2511104_1"	293807	302600
"ENST00000370083.9"	1785	2	1784	"+"	"HG01109#1#JAHEPA010000099.1_2104245_2511104_1"	406859	199670	208462	1769	8792	0	"S"	557	1686	NA	1e-04	0	"HG01109#1#JAHEPA010000099.1_2104245_2511104_1"	"AMY1A-201"	"1"	"HG01109"	"0-3-7-9-4-6-8-5-2-7-9-4-2-5-2-1"	"0.0-3.0-7.0-9.0-4.0-6.0-8.0-5.0-2.0-7.0-9.0-4.0-2.1-5.1-2.0-1.0"	155	"HG01109#1#JAHEPA010000099.1_2104245_2511104_1"	199670	208462
"ENST00000414303.7"	1584	4	1583	"+"	"HG01109#1#JAHEPA010000099.1_2104245_2511104_1"	406859	161418	169688	1574	8270	30	"P"	491	1499	1342	1e-04	0	"HG01109#1#JAHEPA010000099.1_2104245_2511104_1"	"AMY2A-201"	"2A"	"HG01109"	"0-3-7-9-4-6-8-5-2-7-9-4-2-5-2-1"	"0.0-3.0-7.0-9.0-4.0-6.0-8.0-5.0-2.0-7.0-9.0-4.0-2.1-5.1-2.0-1.0"	155	"HG01109#1#JAHEPA010000099.1_2104245_2511104_1"	161418	169688
"ENST00000610648.1"	1736	4	1733	"+"	"HG01109#1#JAHEPA010000099.1_2104245_2511104_1"	406859	115090	123514	1720	8424	48	"P"	531	1638	1371	1e-04	0	"HG01109#1#JAHEPA010000099.1_2104245_2511104_1"	"AMY2B-208"	"2B"	"HG01109"	"0-3-7-9-4-6-8-5-2-7-9-4-2-5-2-1"	"0.0-3.0-7.0-9.0-4.0-6.0-8.0-5.0-2.0-7.0-9.0-4.0-2.1-5.1-2.0-1.0"	155	"HG01109#1#JAHEPA010000099.1_2104245_2511104_1"	115090	123514
"ENST00000370083.9"	1785	2	1784	"+"	"HG03486#1#JAHEOQ010000123.1_16677696_17085575_0"	407879	199649	208441	1769	8792	0	"P"	557	1686	1686	1e-04	0	"HG03486#1#JAHEOQ010000123.1_16677696_17085575_0"	"AMY1A-201"	"1"	"HG03486"	"0-3-7-9-4-6-8-5-2-4-9-7-2-5-2-1"	"0.0-3.0-7.0-9.0-4.0-6.0-8.0-5.0-2.0-4.1-9.1-7.1-2.1-5.0-2.0-1.0"	99	"HG03486#1#JAHEOQ010000123.1_16677696_17085575_0"	199649	208441
"ENST00000370083.9"	1785	2	1784	"-"	"HG03486#1#JAHEOQ010000123.1_16677696_17085575_0"	407879	231305	240098	1769	8793	0	"S"	557	1686	NA	1e-04	0	"HG03486#1#JAHEOQ010000123.1_16677696_17085575_0"	"AMY1A-201"	"1"	"HG03486"	"0-3-7-9-4-6-8-5-2-4-9-7-2-5-2-1"	"0.0-3.0-7.0-9.0-4.0-6.0-8.0-5.0-2.0-4.1-9.1-7.1-2.1-5.0-2.0-1.0"	99	"HG03486#1#JAHEOQ010000123.1_16677696_17085575_0"	231305	240098
"ENST00000370083.9"	1785	2	1784	"+"	"HG03486#1#JAHEOQ010000123.1_16677696_17085575_0"	407879	293776	302568	1769	8792	0	"S"	557	1686	NA	1e-04	0	"HG03486#1#JAHEOQ010000123.1_16677696_17085575_0"	"AMY1A-201"	"1"	"HG03486"	"0-3-7-9-4-6-8-5-2-4-9-7-2-5-2-1"	"0.0-3.0-7.0-9.0-4.0-6.0-8.0-5.0-2.0-4.1-9.1-7.1-2.1-5.0-2.0-1.0"	99	"HG03486#1#JAHEOQ010000123.1_16677696_17085575_0"	293776	302568
"ENST00000414303.7"	1584	4	1583	"+"	"HG03486#1#JAHEOQ010000123.1_16677696_17085575_0"	407879	161395	169665	1574	8270	30	"P"	491	1499	1342	1e-04	0	"HG03486#1#JAHEOQ010000123.1_16677696_17085575_0"	"AMY2A-201"	"2A"	"HG03486"	"0-3-7-9-4-6-8-5-2-4-9-7-2-5-2-1"	"0.0-3.0-7.0-9.0-4.0-6.0-8.0-5.0-2.0-4.1-9.1-7.1-2.1-5.0-2.0-1.0"	99	"HG03486#1#JAHEOQ010000123.1_16677696_17085575_0"	161395	169665
"ENST00000610648.1"	1736	4	1733	"+"	"HG03486#1#JAHEOQ010000123.1_16677696_17085575_0"	407879	115071	123493	1720	8422	48	"P"	531	1638	1371	1e-04	0	"HG03486#1#JAHEOQ010000123.1_16677696_17085575_0"	"AMY2B-208"	"2B"	"HG03486"	"0-3-7-9-4-6-8-5-2-4-9-7-2-5-2-1"	"0.0-3.0-7.0-9.0-4.0-6.0-8.0-5.0-2.0-4.1-9.1-7.1-2.1-5.0-2.0-1.0"	99	"HG03486#1#JAHEOQ010000123.1_16677696_17085575_0"	115071	123493
"ENST00000370083.9"	1785	2	1784	"+"	"HG02559#1#JAGYVK010000012.1_51505852_51913611_0"	407759	199633	208425	1769	8792	0	"P"	557	1686	1686	1e-04	0	"HG02559#1#JAGYVK010000012.1_51505852_51913611_0"	"AMY1A-201"	"1"	"HG02559"	"0-3-7-9-4-6-8-5-2-4-9-7-2-5-2-1"	"0.0-3.0-7.0-9.0-4.0-6.0-8.0-5.0-2.0-4.1-9.1-7.1-2.1-5.1-2.0-1.0"	98	"HG02559#1#JAGYVK010000012.1_51505852_51913611_0"	199633	208425
"ENST00000370083.9"	1785	2	1784	"+"	"HG02559#1#JAGYVK010000012.1_51505852_51913611_0"	407759	293761	302552	1769	8791	0	"S"	557	1686	NA	1e-04	0	"HG02559#1#JAGYVK010000012.1_51505852_51913611_0"	"AMY1A-201"	"1"	"HG02559"	"0-3-7-9-4-6-8-5-2-4-9-7-2-5-2-1"	"0.0-3.0-7.0-9.0-4.0-6.0-8.0-5.0-2.0-4.1-9.1-7.1-2.1-5.1-2.0-1.0"	98	"HG02559#1#JAGYVK010000012.1_51505852_51913611_0"	293761	302552
"ENST00000370083.9"	1785	2	1784	"-"	"HG02559#1#JAGYVK010000012.1_51505852_51913611_0"	407759	231286	240078	1769	8792	0	"S"	557	1686	NA	1e-04	0	"HG02559#1#JAGYVK010000012.1_51505852_51913611_0"	"AMY1A-201"	"1"	"HG02559"	"0-3-7-9-4-6-8-5-2-4-9-7-2-5-2-1"	"0.0-3.0-7.0-9.0-4.0-6.0-8.0-5.0-2.0-4.1-9.1-7.1-2.1-5.1-2.0-1.0"	98	"HG02559#1#JAGYVK010000012.1_51505852_51913611_0"	231286	240078
"ENST00000414303.7"	1584	4	1583	"+"	"HG02559#1#JAGYVK010000012.1_51505852_51913611_0"	407759	161373	169643	1563	8270	28	"P"	488	1488	1342	5e-04	0	"HG02559#1#JAGYVK010000012.1_51505852_51913611_0"	"AMY2A-201"	"2A"	"HG02559"	"0-3-7-9-4-6-8-5-2-4-9-7-2-5-2-1"	"0.0-3.0-7.0-9.0-4.0-6.0-8.0-5.0-2.0-4.1-9.1-7.1-2.1-5.1-2.0-1.0"	98	"HG02559#1#JAGYVK010000012.1_51505852_51913611_0"	161373	169643
"ENST00000610648.1"	1736	4	1733	"+"	"HG02559#1#JAGYVK010000012.1_51505852_51913611_0"	407759	115044	123468	1720	8424	48	"P"	531	1638	1371	1e-04	0	"HG02559#1#JAGYVK010000012.1_51505852_51913611_0"	"AMY2B-208"	"2B"	"HG02559"	"0-3-7-9-4-6-8-5-2-4-9-7-2-5-2-1"	"0.0-3.0-7.0-9.0-4.0-6.0-8.0-5.0-2.0-4.1-9.1-7.1-2.1-5.1-2.0-1.0"	98	"HG02559#1#JAGYVK010000012.1_51505852_51913611_0"	115044	123468
"ENST00000370083.9"	1785	2	1784	"+"	"HG02630#1#JAHAOQ010000102.1_16672145_17079089_0"	406944	293812	302603	1769	8791	0	"P"	557	1686	1686	1e-04	0	"HG02630#1#JAHAOQ010000102.1_16672145_17079089_0"	"AMY1A-201"	"1"	"HG02630"	"0-3-7-9-4-6-8-5-2-4-9-7-2-5-2-1"	"0.0-3.0-7.0-9.0-4.0-6.0-8.0-5.0-2.0-4.1-9.1-7.1-2.1-5.0-2.0-1.0"	98	"HG02630#1#JAHAOQ010000102.1_16672145_17079089_0"	293812	302603
"ENST00000370083.9"	1785	2	1784	"+"	"HG02630#1#JAHAOQ010000102.1_16672145_17079089_0"	406944	199709	208499	1769	8790	0	"S"	557	1686	NA	1e-04	0	"HG02630#1#JAHAOQ010000102.1_16672145_17079089_0"	"AMY1A-201"	"1"	"HG02630"	"0-3-7-9-4-6-8-5-2-4-9-7-2-5-2-1"	"0.0-3.0-7.0-9.0-4.0-6.0-8.0-5.0-2.0-4.1-9.1-7.1-2.1-5.0-2.0-1.0"	98	"HG02630#1#JAHAOQ010000102.1_16672145_17079089_0"	199709	208499
"ENST00000370083.9"	1785	2	1784	"-"	"HG02630#1#JAHAOQ010000102.1_16672145_17079089_0"	406944	231359	240150	1769	8791	0	"S"	557	1686	NA	1e-04	0	"HG02630#1#JAHAOQ010000102.1_16672145_17079089_0"	"AMY1A-201"	"1"	"HG02630"	"0-3-7-9-4-6-8-5-2-4-9-7-2-5-2-1"	"0.0-3.0-7.0-9.0-4.0-6.0-8.0-5.0-2.0-4.1-9.1-7.1-2.1-5.0-2.0-1.0"	98	"HG02630#1#JAHAOQ010000102.1_16672145_17079089_0"	231359	240150
"ENST00000414303.7"	1584	4	1583	"+"	"HG02630#1#JAHAOQ010000102.1_16672145_17079089_0"	406944	161389	169694	1568	8305	29	"P"	486	1493	1342	8e-04	0	"HG02630#1#JAHAOQ010000102.1_16672145_17079089_0"	"AMY2A-201"	"2A"	"HG02630"	"0-3-7-9-4-6-8-5-2-4-9-7-2-5-2-1"	"0.0-3.0-7.0-9.0-4.0-6.0-8.0-5.0-2.0-4.1-9.1-7.1-2.1-5.0-2.0-1.0"	98	"HG02630#1#JAHAOQ010000102.1_16672145_17079089_0"	161389	169694
"ENST00000610648.1"	1736	4	1733	"+"	"HG02630#1#JAHAOQ010000102.1_16672145_17079089_0"	406944	115033	123455	1720	8422	48	"P"	531	1638	1371	1e-04	0	"HG02630#1#JAHAOQ010000102.1_16672145_17079089_0"	"AMY2B-208"	"2B"	"HG02630"	"0-3-7-9-4-6-8-5-2-4-9-7-2-5-2-1"	"0.0-3.0-7.0-9.0-4.0-6.0-8.0-5.0-2.0-4.1-9.1-7.1-2.1-5.0-2.0-1.0"	98	"HG02630#1#JAHAOQ010000102.1_16672145_17079089_0"	115033	123455
"ENST00000370083.9"	1785	2	1784	"+"	"HG02717#1#JAHAOS010000015.1_16660311_17067250_0"	406939	293749	302540	1769	8791	0	"P"	557	1686	1686	1e-04	0	"HG02717#1#JAHAOS010000015.1_16660311_17067250_0"	"AMY1A-201"	"1"	"HG02717"	"0-3-7-9-4-6-8-5-2-4-9-7-2-5-2-1"	"0.0-3.0-7.0-9.0-4.0-6.0-8.0-5.0-2.0-4.1-9.1-7.1-2.1-5.0-2.0-1.0"	98	"HG02717#1#JAHAOS010000015.1_16660311_17067250_0"	293749	302540
"ENST00000370083.9"	1785	2	1784	"-"	"HG02717#1#JAHAOS010000015.1_16660311_17067250_0"	406939	231287	240077	1769	8790	0	"S"	557	1686	NA	1e-04	0	"HG02717#1#JAHAOS010000015.1_16660311_17067250_0"	"AMY1A-201"	"1"	"HG02717"	"0-3-7-9-4-6-8-5-2-4-9-7-2-5-2-1"	"0.0-3.0-7.0-9.0-4.0-6.0-8.0-5.0-2.0-4.1-9.1-7.1-2.1-5.0-2.0-1.0"	98	"HG02717#1#JAHAOS010000015.1_16660311_17067250_0"	231287	240077
"ENST00000370083.9"	1785	2	1784	"+"	"HG02717#1#JAHAOS010000015.1_16660311_17067250_0"	406939	199637	208427	1761	8790	0	"S"	551	1678	NA	8e-04	0	"HG02717#1#JAHAOS010000015.1_16660311_17067250_0"	"AMY1A-201"	"1"	"HG02717"	"0-3-7-9-4-6-8-5-2-4-9-7-2-5-2-1"	"0.0-3.0-7.0-9.0-4.0-6.0-8.0-5.0-2.0-4.1-9.1-7.1-2.1-5.0-2.0-1.0"	98	"HG02717#1#JAHAOS010000015.1_16660311_17067250_0"	199637	208427
"ENST00000414303.7"	1584	4	1583	"+"	"HG02717#1#JAHAOS010000015.1_16660311_17067250_0"	406939	161337	169642	1562	8305	28	"P"	480	1487	1342	0.0016	0	"HG02717#1#JAHAOS010000015.1_16660311_17067250_0"	"AMY2A-201"	"2A"	"HG02717"	"0-3-7-9-4-6-8-5-2-4-9-7-2-5-2-1"	"0.0-3.0-7.0-9.0-4.0-6.0-8.0-5.0-2.0-4.1-9.1-7.1-2.1-5.0-2.0-1.0"	98	"HG02717#1#JAHAOS010000015.1_16660311_17067250_0"	161337	169642
"ENST00000610648.1"	1736	4	1733	"+"	"HG02717#1#JAHAOS010000015.1_16660311_17067250_0"	406939	115004	123426	1720	8422	48	"P"	531	1638	1371	1e-04	0	"HG02717#1#JAHAOS010000015.1_16660311_17067250_0"	"AMY2B-208"	"2B"	"HG02717"	"0-3-7-9-4-6-8-5-2-4-9-7-2-5-2-1"	"0.0-3.0-7.0-9.0-4.0-6.0-8.0-5.0-2.0-4.1-9.1-7.1-2.1-5.0-2.0-1.0"	98	"HG02717#1#JAHAOS010000015.1_16660311_17067250_0"	115004	123426
"ENST00000370083.9"	1785	2	1784	"+"	"HG03453#1#JAGYVW010000157.1_2105722_2585000_1"	479278	272074	280867	1769	8793	0	"P"	557	1686	1686	1e-04	0	"HG03453#1#JAGYVW010000157.1_2105722_2585000_1"	"AMY1A-201"	"1"	"HG03453"	"0-3-7-9-4-6-8-5-2-7-9-4-6-8-5-2-7-9-4-2-5-2-1"	"0.0-3.0-7.0-9.0-4.0-6.0-8.0-5.0-2.0-7.0-9.0-4.0-6.0-8.0-5.0-2.0-7.0-9.0-4.0-2.1-5.0-2.0-1.0"	154	"HG03453#1#JAGYVW010000157.1_2105722_2585000_1"	272074	280867
"ENST00000370083.9"	1785	2	1784	"+"	"HG03453#1#JAGYVW010000157.1_2105722_2585000_1"	479278	366208	374998	1769	8790	0	"S"	557	1686	NA	1e-04	0	"HG03453#1#JAGYVW010000157.1_2105722_2585000_1"	"AMY1A-201"	"1"	"HG03453"	"0-3-7-9-4-6-8-5-2-7-9-4-6-8-5-2-7-9-4-2-5-2-1"	"0.0-3.0-7.0-9.0-4.0-6.0-8.0-5.0-2.0-7.0-9.0-4.0-6.0-8.0-5.0-2.0-7.0-9.0-4.0-2.1-5.0-2.0-1.0"	154	"HG03453#1#JAGYVW010000157.1_2105722_2585000_1"	366208	374998
"ENST00000370083.9"	1785	2	1784	"+"	"HG03453#1#JAGYVW010000157.1_2105722_2585000_1"	479278	199652	208444	1769	8792	0	"S"	557	1686	NA	1e-04	0	"HG03453#1#JAGYVW010000157.1_2105722_2585000_1"	"AMY1A-201"	"1"	"HG03453"	"0-3-7-9-4-6-8-5-2-7-9-4-6-8-5-2-7-9-4-2-5-2-1"	"0.0-3.0-7.0-9.0-4.0-6.0-8.0-5.0-2.0-7.0-9.0-4.0-6.0-8.0-5.0-2.0-7.0-9.0-4.0-2.1-5.0-2.0-1.0"	154	"HG03453#1#JAGYVW010000157.1_2105722_2585000_1"	199652	208444
"ENST00000370083.9"	1785	2	1784	"-"	"HG03453#1#JAGYVW010000157.1_2105722_2585000_1"	479278	303727	312519	1769	8792	0	"S"	557	1686	NA	1e-04	0	"HG03453#1#JAGYVW010000157.1_2105722_2585000_1"	"AMY1A-201"	"1"	"HG03453"	"0-3-7-9-4-6-8-5-2-7-9-4-6-8-5-2-7-9-4-2-5-2-1"	"0.0-3.0-7.0-9.0-4.0-6.0-8.0-5.0-2.0-7.0-9.0-4.0-6.0-8.0-5.0-2.0-7.0-9.0-4.0-2.1-5.0-2.0-1.0"	154	"HG03453#1#JAGYVW010000157.1_2105722_2585000_1"	303727	312519
"ENST00000414303.7"	1584	4	1583	"+"	"HG03453#1#JAGYVW010000157.1_2105722_2585000_1"	479278	161392	169662	1569	8270	0	"P"	486	1494	1494	8e-04	0	"HG03453#1#JAGYVW010000157.1_2105722_2585000_1"	"AMY2A-201"	"2A"	"HG03453"	"0-3-7-9-4-6-8-5-2-7-9-4-6-8-5-2-7-9-4-2-5-2-1"	"0.0-3.0-7.0-9.0-4.0-6.0-8.0-5.0-2.0-7.0-9.0-4.0-6.0-8.0-5.0-2.0-7.0-9.0-4.0-2.1-5.0-2.0-1.0"	154	"HG03453#1#JAGYVW010000157.1_2105722_2585000_1"	161392	169662
"ENST00000414303.7"	1584	4	1583	"+"	"HG03453#1#JAGYVW010000157.1_2105722_2585000_1"	479278	233814	242084	1569	8270	0	"S"	486	1494	NA	8e-04	0	"HG03453#1#JAGYVW010000157.1_2105722_2585000_1"	"AMY2A-201"	"2A"	"HG03453"	"0-3-7-9-4-6-8-5-2-7-9-4-6-8-5-2-7-9-4-2-5-2-1"	"0.0-3.0-7.0-9.0-4.0-6.0-8.0-5.0-2.0-7.0-9.0-4.0-6.0-8.0-5.0-2.0-7.0-9.0-4.0-2.1-5.0-2.0-1.0"	154	"HG03453#1#JAGYVW010000157.1_2105722_2585000_1"	233814	242084
"ENST00000610648.1"	1736	4	1733	"+"	"HG03453#1#JAGYVW010000157.1_2105722_2585000_1"	479278	115063	123481	1720	8418	46	"P"	531	1638	1382	1e-04	0	"HG03453#1#JAGYVW010000157.1_2105722_2585000_1"	"AMY2B-208"	"2B"	"HG03453"	"0-3-7-9-4-6-8-5-2-7-9-4-6-8-5-2-7-9-4-2-5-2-1"	"0.0-3.0-7.0-9.0-4.0-6.0-8.0-5.0-2.0-7.0-9.0-4.0-6.0-8.0-5.0-2.0-7.0-9.0-4.0-2.1-5.0-2.0-1.0"	154	"HG03453#1#JAGYVW010000157.1_2105722_2585000_1"	115063	123481
"ENST00000370083.9"	1785	2	1784	"+"	"HG01928#1#JAGYVQ010000053.1_16676493_17083407_0"	406914	293749	302541	1769	8792	0	"P"	557	1686	1686	1e-04	0	"HG01928#1#JAGYVQ010000053.1_16676493_17083407_0"	"AMY1A-201"	"1"	"HG01928"	"0-3-7-9-4-6-8-5-2-4-9-7-2-5-2-1"	"0.0-3.0-7.0-9.0-4.0-6.0-8.0-5.0-2.0-4.1-9.1-7.1-2.1-5.1-2.0-1.0"	99	"HG01928#1#JAGYVQ010000053.1_16676493_17083407_0"	293749	302541
"ENST00000370083.9"	1785	2	1784	"+"	"HG01928#1#JAGYVQ010000053.1_16676493_17083407_0"	406914	199597	208389	1769	8792	0	"S"	557	1686	NA	1e-04	0	"HG01928#1#JAGYVQ010000053.1_16676493_17083407_0"	"AMY1A-201"	"1"	"HG01928"	"0-3-7-9-4-6-8-5-2-4-9-7-2-5-2-1"	"0.0-3.0-7.0-9.0-4.0-6.0-8.0-5.0-2.0-4.1-9.1-7.1-2.1-5.1-2.0-1.0"	99	"HG01928#1#JAGYVQ010000053.1_16676493_17083407_0"	199597	208389
"ENST00000370083.9"	1785	2	1784	"-"	"HG01928#1#JAGYVQ010000053.1_16676493_17083407_0"	406914	231255	240048	1769	8793	0	"S"	557	1686	NA	1e-04	0	"HG01928#1#JAGYVQ010000053.1_16676493_17083407_0"	"AMY1A-201"	"1"	"HG01928"	"0-3-7-9-4-6-8-5-2-4-9-7-2-5-2-1"	"0.0-3.0-7.0-9.0-4.0-6.0-8.0-5.0-2.0-4.1-9.1-7.1-2.1-5.1-2.0-1.0"	99	"HG01928#1#JAGYVQ010000053.1_16676493_17083407_0"	231255	240048
"ENST00000414303.7"	1584	4	1583	"+"	"HG01928#1#JAGYVQ010000053.1_16676493_17083407_0"	406914	161343	169613	1574	8270	30	"P"	491	1499	1342	1e-04	0	"HG01928#1#JAGYVQ010000053.1_16676493_17083407_0"	"AMY2A-201"	"2A"	"HG01928"	"0-3-7-9-4-6-8-5-2-4-9-7-2-5-2-1"	"0.0-3.0-7.0-9.0-4.0-6.0-8.0-5.0-2.0-4.1-9.1-7.1-2.1-5.1-2.0-1.0"	99	"HG01928#1#JAGYVQ010000053.1_16676493_17083407_0"	161343	169613
"ENST00000610648.1"	1736	4	1733	"+"	"HG01928#1#JAGYVQ010000053.1_16676493_17083407_0"	406914	115018	123438	1720	8420	48	"P"	531	1638	1371	1e-04	0	"HG01928#1#JAGYVQ010000053.1_16676493_17083407_0"	"AMY2B-208"	"2B"	"HG01928"	"0-3-7-9-4-6-8-5-2-4-9-7-2-5-2-1"	"0.0-3.0-7.0-9.0-4.0-6.0-8.0-5.0-2.0-4.1-9.1-7.1-2.1-5.1-2.0-1.0"	99	"HG01928#1#JAGYVQ010000053.1_16676493_17083407_0"	115018	123438
"ENST00000370083.9"	1785	2	1784	"-"	"HG005#1#JAHEPO010000002.1_51519219_51926067_0"	406848	231268	240060	1769	8792	0	"P"	557	1686	1686	1e-04	0	"HG005#1#JAHEPO010000002.1_51519219_51926067_0"	"AMY1A-201"	"1"	"HG005"	"0-3-7-9-4-6-8-5-2-7-9-4-2-5-2-1"	"0.0-3.0-7.0-9.0-4.0-6.0-8.0-5.0-2.0-7.0-9.0-4.0-2.1-5.1-2.0-1.0"	98	"HG005#1#JAHEPO010000002.1_51519219_51926067_0"	231268	240060
"ENST00000370083.9"	1785	2	1784	"+"	"HG005#1#JAHEPO010000002.1_51519219_51926067_0"	406848	293745	302535	1769	8790	0	"S"	557	1686	NA	1e-04	0	"HG005#1#JAHEPO010000002.1_51519219_51926067_0"	"AMY1A-201"	"1"	"HG005"	"0-3-7-9-4-6-8-5-2-7-9-4-2-5-2-1"	"0.0-3.0-7.0-9.0-4.0-6.0-8.0-5.0-2.0-7.0-9.0-4.0-2.1-5.1-2.0-1.0"	98	"HG005#1#JAHEPO010000002.1_51519219_51926067_0"	293745	302535
"ENST00000370083.9"	1785	2	1784	"+"	"HG005#1#JAHEPO010000002.1_51519219_51926067_0"	406848	199620	208411	1769	8791	0	"S"	557	1686	NA	1e-04	0	"HG005#1#JAHEPO010000002.1_51519219_51926067_0"	"AMY1A-201"	"1"	"HG005"	"0-3-7-9-4-6-8-5-2-7-9-4-2-5-2-1"	"0.0-3.0-7.0-9.0-4.0-6.0-8.0-5.0-2.0-7.0-9.0-4.0-2.1-5.1-2.0-1.0"	98	"HG005#1#JAHEPO010000002.1_51519219_51926067_0"	199620	208411
"ENST00000414303.7"	1584	4	1583	"+"	"HG005#1#JAHEPO010000002.1_51519219_51926067_0"	406848	161362	169632	1574	8270	30	"P"	491	1499	1342	1e-04	0	"HG005#1#JAHEPO010000002.1_51519219_51926067_0"	"AMY2A-201"	"2A"	"HG005"	"0-3-7-9-4-6-8-5-2-7-9-4-2-5-2-1"	"0.0-3.0-7.0-9.0-4.0-6.0-8.0-5.0-2.0-7.0-9.0-4.0-2.1-5.1-2.0-1.0"	98	"HG005#1#JAHEPO010000002.1_51519219_51926067_0"	161362	169632
"ENST00000610648.1"	1736	4	1733	"+"	"HG005#1#JAHEPO010000002.1_51519219_51926067_0"	406848	115023	123445	1720	8422	48	"P"	531	1638	1371	1e-04	0	"HG005#1#JAHEPO010000002.1_51519219_51926067_0"	"AMY2B-208"	"2B"	"HG005"	"0-3-7-9-4-6-8-5-2-7-9-4-2-5-2-1"	"0.0-3.0-7.0-9.0-4.0-6.0-8.0-5.0-2.0-7.0-9.0-4.0-2.1-5.1-2.0-1.0"	98	"HG005#1#JAHEPO010000002.1_51519219_51926067_0"	115023	123445
"ENST00000370083.9"	1785	2	1784	"+"	"HG02559#2#JAGYVJ010000037.1_52167780_52574597_1"	406817	199671	208462	1769	8791	0	"P"	557	1686	1686	1e-04	0	"HG02559#2#JAGYVJ010000037.1_52167780_52574597_1"	"AMY1A-201"	"1"	"HG02559"	"0-3-7-9-4-6-8-5-2-4-9-7-2-5-2-1"	"0.0-3.0-7.0-9.0-4.0-6.0-8.0-5.0-2.0-4.1-9.1-7.1-2.1-5.1-2.0-1.0"	154	"HG02559#2#JAGYVJ010000037.1_52167780_52574597_1"	199671	208462
"ENST00000370083.9"	1785	2	1784	"-"	"HG02559#2#JAGYVJ010000037.1_52167780_52574597_1"	406817	231323	240114	1769	8791	0	"S"	557	1686	NA	1e-04	0	"HG02559#2#JAGYVJ010000037.1_52167780_52574597_1"	"AMY1A-201"	"1"	"HG02559"	"0-3-7-9-4-6-8-5-2-4-9-7-2-5-2-1"	"0.0-3.0-7.0-9.0-4.0-6.0-8.0-5.0-2.0-4.1-9.1-7.1-2.1-5.1-2.0-1.0"	154	"HG02559#2#JAGYVJ010000037.1_52167780_52574597_1"	231323	240114
"ENST00000370083.9"	1785	2	1784	"+"	"HG02559#2#JAGYVJ010000037.1_52167780_52574597_1"	406817	293768	302559	1769	8791	0	"S"	557	1686	NA	1e-04	0	"HG02559#2#JAGYVJ010000037.1_52167780_52574597_1"	"AMY1A-201"	"1"	"HG02559"	"0-3-7-9-4-6-8-5-2-4-9-7-2-5-2-1"	"0.0-3.0-7.0-9.0-4.0-6.0-8.0-5.0-2.0-4.1-9.1-7.1-2.1-5.1-2.0-1.0"	154	"HG02559#2#JAGYVJ010000037.1_52167780_52574597_1"	293768	302559
"ENST00000414303.7"	1584	4	1579	"+"	"HG02559#2#JAGYVJ010000037.1_52167780_52574597_1"	406817	161367	169633	1570	8266	30	"P"	490	1495	1339	1e-04	0	"HG02559#2#JAGYVJ010000037.1_52167780_52574597_1"	"AMY2A-201"	"2A"	"HG02559"	"0-3-7-9-4-6-8-5-2-4-9-7-2-5-2-1"	"0.0-3.0-7.0-9.0-4.0-6.0-8.0-5.0-2.0-4.1-9.1-7.1-2.1-5.1-2.0-1.0"	154	"HG02559#2#JAGYVJ010000037.1_52167780_52574597_1"	161367	169633
"ENST00000610648.1"	1736	4	1733	"+"	"HG02559#2#JAGYVJ010000037.1_52167780_52574597_1"	406817	115051	123473	1717	8422	47	"P"	526	1635	1371	8e-04	0	"HG02559#2#JAGYVJ010000037.1_52167780_52574597_1"	"AMY2B-208"	"2B"	"HG02559"	"0-3-7-9-4-6-8-5-2-4-9-7-2-5-2-1"	"0.0-3.0-7.0-9.0-4.0-6.0-8.0-5.0-2.0-4.1-9.1-7.1-2.1-5.1-2.0-1.0"	154	"HG02559#2#JAGYVJ010000037.1_52167780_52574597_1"	115051	123473
"ENST00000370083.9"	1785	2	1784	"+"	"HG03492#2#JAHEPH010000288.1_2098270_2432686_1"	334416	221393	230184	1769	8791	0	"P"	557	1686	1686	1e-04	0	"HG03492#2#JAHEPH010000288.1_2098270_2432686_1"	"AMY1A-201"	"1"	"HG03492"	"0-3-7-9-4-2-5-2-1"	"0.0-3.0-7.0-9.0-4.0-2.1-5.1-2.0-1.0"	154	"HG03492#2#JAHEPH010000288.1_2098270_2432686_1"	221393	230184
"ENST00000370083.9"	1785	2	1784	"-"	"HG03492#2#JAHEPH010000288.1_2098270_2432686_1"	334416	158917	167710	1769	8793	0	"S"	557	1686	NA	1e-04	0	"HG03492#2#JAHEPH010000288.1_2098270_2432686_1"	"AMY1A-201"	"1"	"HG03492"	"0-3-7-9-4-2-5-2-1"	"0.0-3.0-7.0-9.0-4.0-2.1-5.1-2.0-1.0"	154	"HG03492#2#JAHEPH010000288.1_2098270_2432686_1"	158917	167710
"ENST00000610648.1"	1736	4	1733	"+"	"HG03492#2#JAHEPH010000288.1_2098270_2432686_1"	334416	115091	123515	1720	8424	48	"P"	531	1638	1371	1e-04	0	"HG03492#2#JAHEPH010000288.1_2098270_2432686_1"	"AMY2B-208"	"2B"	"HG03492"	"0-3-7-9-4-2-5-2-1"	"0.0-3.0-7.0-9.0-4.0-2.1-5.1-2.0-1.0"	154	"HG03492#2#JAHEPH010000288.1_2098270_2432686_1"	115091	123515
"ENST00000370083.9"	1785	2	1784	"+"	"HG02145#2#JAHKSF010000206.1_1005292_1413195_1"	407903	293903	302694	1769	8791	0	"P"	557	1686	1686	1e-04	0	"HG02145#2#JAHKSF010000206.1_1005292_1413195_1"	"AMY1A-201"	"1"	"HG02145"	"0-3-7-9-4-6-8-5-2-4-9-7-2-5-2-1"	"0.0-3.0-7.0-9.0-4.0-6.0-8.0-5.0-2.0-4.1-9.1-7.1-2.1-5.0-2.0-1.0"	154	"HG02145#2#JAHKSF010000206.1_1005292_1413195_1"	293903	302694
"ENST00000370083.9"	1785	2	1784	"+"	"HG02145#2#JAHKSF010000206.1_1005292_1413195_1"	407903	199791	208581	1769	8790	0	"S"	557	1686	NA	1e-04	0	"HG02145#2#JAHKSF010000206.1_1005292_1413195_1"	"AMY1A-201"	"1"	"HG02145"	"0-3-7-9-4-6-8-5-2-4-9-7-2-5-2-1"	"0.0-3.0-7.0-9.0-4.0-6.0-8.0-5.0-2.0-4.1-9.1-7.1-2.1-5.0-2.0-1.0"	154	"HG02145#2#JAHKSF010000206.1_1005292_1413195_1"	199791	208581
"ENST00000370083.9"	1785	2	1784	"-"	"HG02145#2#JAHKSF010000206.1_1005292_1413195_1"	407903	231440	240231	1769	8791	0	"S"	557	1686	NA	1e-04	0	"HG02145#2#JAHKSF010000206.1_1005292_1413195_1"	"AMY1A-201"	"1"	"HG02145"	"0-3-7-9-4-6-8-5-2-4-9-7-2-5-2-1"	"0.0-3.0-7.0-9.0-4.0-6.0-8.0-5.0-2.0-4.1-9.1-7.1-2.1-5.0-2.0-1.0"	154	"HG02145#2#JAHKSF010000206.1_1005292_1413195_1"	231440	240231
"ENST00000414303.7"	1584	4	1583	"+"	"HG02145#2#JAHKSF010000206.1_1005292_1413195_1"	407903	161472	169777	1568	8305	29	"P"	486	1493	1342	8e-04	0	"HG02145#2#JAHKSF010000206.1_1005292_1413195_1"	"AMY2A-201"	"2A"	"HG02145"	"0-3-7-9-4-6-8-5-2-4-9-7-2-5-2-1"	"0.0-3.0-7.0-9.0-4.0-6.0-8.0-5.0-2.0-4.1-9.1-7.1-2.1-5.0-2.0-1.0"	154	"HG02145#2#JAHKSF010000206.1_1005292_1413195_1"	161472	169777
"ENST00000610648.1"	1736	4	1733	"+"	"HG02145#2#JAHKSF010000206.1_1005292_1413195_1"	407903	115130	123552	1720	8422	48	"P"	531	1638	1371	1e-04	0	"HG02145#2#JAHKSF010000206.1_1005292_1413195_1"	"AMY2B-208"	"2B"	"HG02145"	"0-3-7-9-4-6-8-5-2-4-9-7-2-5-2-1"	"0.0-3.0-7.0-9.0-4.0-6.0-8.0-5.0-2.0-4.1-9.1-7.1-2.1-5.0-2.0-1.0"	154	"HG02145#2#JAHKSF010000206.1_1005292_1413195_1"	115130	123552
"ENST00000370083.9"	1785	2	1784	"-"	"NA20129#2#JAHEPD010000155.1_90039_569275_0"	479236	231221	240012	1769	8791	0	"P"	557	1686	1686	1e-04	0	"NA20129#2#JAHEPD010000155.1_90039_569275_0"	"AMY1A-201"	"1"	"NA20129"	"0-3-7-9-4-6-8-5-2-7-9-4-2-5-8-6-4-9-7-2-5-2-1"	"0.0-3.0-7.0-9.0-4.0-6.0-8.0-5.0-2.0-7.0-9.0-4.0-2.1-5.1-8.1-6.1-4.1-9.1-7.1-2.1-5.0-2.0-1.0"	98	"NA20129#2#JAHEPD010000155.1_90039_569275_0"	231221	240012
"ENST00000370083.9"	1785	2	1784	"+"	"NA20129#2#JAHEPD010000155.1_90039_569275_0"	479236	366081	374872	1769	8791	0	"S"	557	1686	NA	1e-04	0	"NA20129#2#JAHEPD010000155.1_90039_569275_0"	"AMY1A-201"	"1"	"NA20129"	"0-3-7-9-4-6-8-5-2-7-9-4-2-5-8-6-4-9-7-2-5-2-1"	"0.0-3.0-7.0-9.0-4.0-6.0-8.0-5.0-2.0-7.0-9.0-4.0-2.1-5.1-8.1-6.1-4.1-9.1-7.1-2.1-5.0-2.0-1.0"	98	"NA20129#2#JAHEPD010000155.1_90039_569275_0"	366081	374872
"ENST00000370083.9"	1785	2	1784	"+"	"NA20129#2#JAHEPD010000155.1_90039_569275_0"	479236	199566	208358	1769	8792	0	"S"	557	1686	NA	1e-04	0	"NA20129#2#JAHEPD010000155.1_90039_569275_0"	"AMY1A-201"	"1"	"NA20129"	"0-3-7-9-4-6-8-5-2-7-9-4-2-5-8-6-4-9-7-2-5-2-1"	"0.0-3.0-7.0-9.0-4.0-6.0-8.0-5.0-2.0-7.0-9.0-4.0-2.1-5.1-8.1-6.1-4.1-9.1-7.1-2.1-5.0-2.0-1.0"	98	"NA20129#2#JAHEPD010000155.1_90039_569275_0"	199566	208358
"ENST00000370083.9"	1785	2	1784	"-"	"NA20129#2#JAHEPD010000155.1_90039_569275_0"	479236	303638	312430	1769	8792	0	"S"	557	1686	NA	1e-04	0	"NA20129#2#JAHEPD010000155.1_90039_569275_0"	"AMY1A-201"	"1"	"NA20129"	"0-3-7-9-4-6-8-5-2-7-9-4-2-5-8-6-4-9-7-2-5-2-1"	"0.0-3.0-7.0-9.0-4.0-6.0-8.0-5.0-2.0-7.0-9.0-4.0-2.1-5.1-8.1-6.1-4.1-9.1-7.1-2.1-5.0-2.0-1.0"	98	"NA20129#2#JAHEPD010000155.1_90039_569275_0"	303638	312430
"ENST00000414303.7"	1584	4	1583	"-"	"NA20129#2#JAHEPD010000155.1_90039_569275_0"	479236	269995	278265	1571	8270	0	"P"	486	1496	1494	8e-04	0	"NA20129#2#JAHEPD010000155.1_90039_569275_0"	"AMY2A-201"	"2A"	"NA20129"	"0-3-7-9-4-6-8-5-2-7-9-4-2-5-8-6-4-9-7-2-5-2-1"	"0.0-3.0-7.0-9.0-4.0-6.0-8.0-5.0-2.0-7.0-9.0-4.0-2.1-5.1-8.1-6.1-4.1-9.1-7.1-2.1-5.0-2.0-1.0"	98	"NA20129#2#JAHEPD010000155.1_90039_569275_0"	269995	278265
"ENST00000414303.7"	1584	4	1583	"+"	"NA20129#2#JAHEPD010000155.1_90039_569275_0"	479236	161308	169578	1569	8270	0	"S"	486	1494	NA	8e-04	0	"NA20129#2#JAHEPD010000155.1_90039_569275_0"	"AMY2A-201"	"2A"	"NA20129"	"0-3-7-9-4-6-8-5-2-7-9-4-2-5-8-6-4-9-7-2-5-2-1"	"0.0-3.0-7.0-9.0-4.0-6.0-8.0-5.0-2.0-7.0-9.0-4.0-2.1-5.1-8.1-6.1-4.1-9.1-7.1-2.1-5.0-2.0-1.0"	98	"NA20129#2#JAHEPD010000155.1_90039_569275_0"	161308	169578
"ENST00000610648.1"	1736	4	1733	"+"	"NA20129#2#JAHEPD010000155.1_90039_569275_0"	479236	114981	123392	1717	8411	40	"P"	524	1635	1411	9e-04	0	"NA20129#2#JAHEPD010000155.1_90039_569275_0"	"AMY2B-208"	"2B"	"NA20129"	"0-3-7-9-4-6-8-5-2-7-9-4-2-5-8-6-4-9-7-2-5-2-1"	"0.0-3.0-7.0-9.0-4.0-6.0-8.0-5.0-2.0-7.0-9.0-4.0-2.1-5.1-8.1-6.1-4.1-9.1-7.1-2.1-5.0-2.0-1.0"	98	"NA20129#2#JAHEPD010000155.1_90039_569275_0"	114981	123392
"ENST00000370083.9"	1785	2	1784	"+"	"HG01123#2#JAGYYY010000006.1_51579630_51892388_0"	312758	199614	208406	1769	8792	49	"P"	557	1686	1404	1e-04	0	"HG01123#2#JAGYYY010000006.1_51579630_51892388_0"	"AMY1A-201"	"1"	"HG01123"	"0-3-7-9-4-6-8-5-2-1"	"0.0-3.0-7.0-9.0-4.0-6.0-8.0-5.0-2.0-1.0"	99	"HG01123#2#JAGYYY010000006.1_51579630_51892388_0"	199614	208406
"ENST00000414303.7"	1584	4	1583	"+"	"HG01123#2#JAGYYY010000006.1_51579630_51892388_0"	312758	161364	169634	1574	8270	30	"P"	491	1499	1342	1e-04	0	"HG01123#2#JAGYYY010000006.1_51579630_51892388_0"	"AMY2A-201"	"2A"	"HG01123"	"0-3-7-9-4-6-8-5-2-1"	"0.0-3.0-7.0-9.0-4.0-6.0-8.0-5.0-2.0-1.0"	99	"HG01123#2#JAGYYY010000006.1_51579630_51892388_0"	161364	169634
"ENST00000610648.1"	1736	4	1733	"+"	"HG01123#2#JAGYYY010000006.1_51579630_51892388_0"	312758	115032	123456	1720	8424	50	"P"	531	1638	1358	1e-04	0	"HG01123#2#JAGYYY010000006.1_51579630_51892388_0"	"AMY2B-208"	"2B"	"HG01123"	"0-3-7-9-4-6-8-5-2-1"	"0.0-3.0-7.0-9.0-4.0-6.0-8.0-5.0-2.0-1.0"	99	"HG01123#2#JAGYYY010000006.1_51579630_51892388_0"	115032	123456
"ENST00000370083.9"	1785	2	1784	"+"	"HG03579#2#JAGYVT010000094.1_51581892_51895531_0"	313639	199590	208380	1753	8790	45	"P"	553	1670	1415	6e-04	0	"HG03579#2#JAGYVT010000094.1_51581892_51895531_0"	"AMY1A-201"	"1"	"HG03579"	"0-3-7-9-4-6-8-5-2-1"	"0.0-3.0-7.0-9.0-4.0-6.0-8.0-5.0-2.0-1.0"	98	"HG03579#2#JAGYVT010000094.1_51581892_51895531_0"	199590	208380
"ENST00000414303.7"	1584	4	1583	"+"	"HG03579#2#JAGYVT010000094.1_51581892_51895531_0"	313639	161331	169601	1569	8270	29	"P"	486	1494	1342	1e-04	0	"HG03579#2#JAGYVT010000094.1_51581892_51895531_0"	"AMY2A-201"	"2A"	"HG03579"	"0-3-7-9-4-6-8-5-2-1"	"0.0-3.0-7.0-9.0-4.0-6.0-8.0-5.0-2.0-1.0"	98	"HG03579#2#JAGYVT010000094.1_51581892_51895531_0"	161331	169601
"ENST00000610648.1"	1736	4	1733	"+"	"HG03579#2#JAGYVT010000094.1_51581892_51895531_0"	313639	115005	123426	1720	8421	50	"P"	531	1638	1360	1e-04	0	"HG03579#2#JAGYVT010000094.1_51581892_51895531_0"	"AMY2B-208"	"2B"	"HG03579"	"0-3-7-9-4-6-8-5-2-1"	"0.0-3.0-7.0-9.0-4.0-6.0-8.0-5.0-2.0-1.0"	98	"HG03579#2#JAGYVT010000094.1_51581892_51895531_0"	115005	123426
"ENST00000370083.9"	1785	2	1784	"+"	"HG02630#2#JAHAOP010000089.1_16669255_17076135_0"	406880	293792	302580	1769	8788	0	"P"	557	1686	1686	1e-04	0	"HG02630#2#JAHAOP010000089.1_16669255_17076135_0"	"AMY1A-201"	"1"	"HG02630"	"0-3-7-9-4-6-8-5-2-7-9-4-2-5-2-1"	"0.0-3.0-7.0-9.0-4.0-6.0-8.0-5.0-2.0-7.0-9.0-4.0-2.1-5.1-2.0-1.0"	98	"HG02630#2#JAHAOP010000089.1_16669255_17076135_0"	293792	302580
"ENST00000370083.9"	1785	2	1784	"+"	"HG02630#2#JAHAOP010000089.1_16669255_17076135_0"	406880	199641	208432	1769	8791	0	"S"	557	1686	NA	1e-04	0	"HG02630#2#JAHAOP010000089.1_16669255_17076135_0"	"AMY1A-201"	"1"	"HG02630"	"0-3-7-9-4-6-8-5-2-7-9-4-2-5-2-1"	"0.0-3.0-7.0-9.0-4.0-6.0-8.0-5.0-2.0-7.0-9.0-4.0-2.1-5.1-2.0-1.0"	98	"HG02630#2#JAHAOP010000089.1_16669255_17076135_0"	199641	208432
"ENST00000370083.9"	1785	2	1784	"-"	"HG02630#2#JAHAOP010000089.1_16669255_17076135_0"	406880	231306	240098	1769	8792	0	"S"	557	1686	NA	1e-04	0	"HG02630#2#JAHAOP010000089.1_16669255_17076135_0"	"AMY1A-201"	"1"	"HG02630"	"0-3-7-9-4-6-8-5-2-7-9-4-2-5-2-1"	"0.0-3.0-7.0-9.0-4.0-6.0-8.0-5.0-2.0-7.0-9.0-4.0-2.1-5.1-2.0-1.0"	98	"HG02630#2#JAHAOP010000089.1_16669255_17076135_0"	231306	240098
"ENST00000414303.7"	1584	4	1583	"+"	"HG02630#2#JAHAOP010000089.1_16669255_17076135_0"	406880	161373	169643	1563	8270	28	"P"	488	1488	1342	5e-04	0	"HG02630#2#JAHAOP010000089.1_16669255_17076135_0"	"AMY2A-201"	"2A"	"HG02630"	"0-3-7-9-4-6-8-5-2-7-9-4-2-5-2-1"	"0.0-3.0-7.0-9.0-4.0-6.0-8.0-5.0-2.0-7.0-9.0-4.0-2.1-5.1-2.0-1.0"	98	"HG02630#2#JAHAOP010000089.1_16669255_17076135_0"	161373	169643
"ENST00000610648.1"	1736	4	1733	"+"	"HG02630#2#JAHAOP010000089.1_16669255_17076135_0"	406880	115038	123460	1720	8422	48	"P"	531	1638	1371	1e-04	0	"HG02630#2#JAHAOP010000089.1_16669255_17076135_0"	"AMY2B-208"	"2B"	"HG02630"	"0-3-7-9-4-6-8-5-2-7-9-4-2-5-2-1"	"0.0-3.0-7.0-9.0-4.0-6.0-8.0-5.0-2.0-7.0-9.0-4.0-2.1-5.1-2.0-1.0"	98	"HG02630#2#JAHAOP010000089.1_16669255_17076135_0"	115038	123460
"ENST00000370083.9"	1785	2	1784	"+"	"chr1_hg19_103998686_104406594_0"	407908	199697	208489	1769	8792	0	"P"	557	1686	1686	1e-04	0	"chr1_hg19_103998686_104406594_0"	"AMY1A-201"	"1"	"chr1_hg19_103998686_104406594_0"	"0-3-7-9-4-6-8-5-2-4-9-7-2-5-2-1"	"0.0-3.0-7.0-9.0-4.0-6.0-8.0-5.0-2.0-4.1-9.1-7.1-2.1-5.0-2.0-1.0"	99	"chr1_hg19_103998686_104406594_0"	199697	208489
"ENST00000370083.9"	1785	2	1784	"-"	"chr1_hg19_103998686_104406594_0"	407908	231351	240144	1769	8793	0	"S"	557	1686	NA	1e-04	0	"chr1_hg19_103998686_104406594_0"	"AMY1A-201"	"1"	"chr1_hg19_103998686_104406594_0"	"0-3-7-9-4-6-8-5-2-4-9-7-2-5-2-1"	"0.0-3.0-7.0-9.0-4.0-6.0-8.0-5.0-2.0-4.1-9.1-7.1-2.1-5.0-2.0-1.0"	99	"chr1_hg19_103998686_104406594_0"	231351	240144
"ENST00000370083.9"	1785	2	1784	"+"	"chr1_hg19_103998686_104406594_0"	407908	293835	302627	1769	8792	0	"S"	557	1686	NA	1e-04	0	"chr1_hg19_103998686_104406594_0"	"AMY1A-201"	"1"	"chr1_hg19_103998686_104406594_0"	"0-3-7-9-4-6-8-5-2-4-9-7-2-5-2-1"	"0.0-3.0-7.0-9.0-4.0-6.0-8.0-5.0-2.0-4.1-9.1-7.1-2.1-5.0-2.0-1.0"	99	"chr1_hg19_103998686_104406594_0"	293835	302627
"ENST00000414303.7"	1584	4	1583	"+"	"chr1_hg19_103998686_104406594_0"	407908	161366	169715	1574	8349	30	"P"	491	1499	1342	1e-04	0	"chr1_hg19_103998686_104406594_0"	"AMY2A-201"	"2A"	"chr1_hg19_103998686_104406594_0"	"0-3-7-9-4-6-8-5-2-4-9-7-2-5-2-1"	"0.0-3.0-7.0-9.0-4.0-6.0-8.0-5.0-2.0-4.1-9.1-7.1-2.1-5.0-2.0-1.0"	99	"chr1_hg19_103998686_104406594_0"	161366	169715
"ENST00000610648.1"	1736	4	1733	"+"	"chr1_hg19_103998686_104406594_0"	407908	115039	123463	1720	8424	48	"P"	531	1638	1371	1e-04	0	"chr1_hg19_103998686_104406594_0"	"AMY2B-208"	"2B"	"chr1_hg19_103998686_104406594_0"	"0-3-7-9-4-6-8-5-2-4-9-7-2-5-2-1"	"0.0-3.0-7.0-9.0-4.0-6.0-8.0-5.0-2.0-4.1-9.1-7.1-2.1-5.0-2.0-1.0"	99	"chr1_hg19_103998686_104406594_0"	115039	123463
"ENST00000370083.9"	1785	2	1784	"+"	"HG03098#2#JAHEPL010000003.1_93803759_94117426_0"	313667	199667	208458	1769	8791	51	"P"	557	1686	1393	1e-04	0	"HG03098#2#JAHEPL010000003.1_93803759_94117426_0"	"AMY1A-201"	"1"	"HG03098"	"0-3-7-9-4-6-8-5-2-1"	"0.0-3.0-7.0-9.0-4.0-6.0-8.0-5.0-2.0-1.0"	98	"HG03098#2#JAHEPL010000003.1_93803759_94117426_0"	199667	208458
"ENST00000414303.7"	1584	4	1583	"+"	"HG03098#2#JAHEPL010000003.1_93803759_94117426_0"	313667	161369	169673	1563	8304	28	"P"	488	1488	1342	5e-04	0	"HG03098#2#JAHEPL010000003.1_93803759_94117426_0"	"AMY2A-201"	"2A"	"HG03098"	"0-3-7-9-4-6-8-5-2-1"	"0.0-3.0-7.0-9.0-4.0-6.0-8.0-5.0-2.0-1.0"	98	"HG03098#2#JAHEPL010000003.1_93803759_94117426_0"	161369	169673
"ENST00000610648.1"	1736	4	1733	"+"	"HG03098#2#JAHEPL010000003.1_93803759_94117426_0"	313667	115040	123464	1720	8424	52	"P"	531	1638	1347	1e-04	0	"HG03098#2#JAHEPL010000003.1_93803759_94117426_0"	"AMY2B-208"	"2B"	"HG03098"	"0-3-7-9-4-6-8-5-2-1"	"0.0-3.0-7.0-9.0-4.0-6.0-8.0-5.0-2.0-1.0"	98	"HG03098#2#JAHEPL010000003.1_93803759_94117426_0"	115040	123464
"ENST00000370083.9"	1785	2	1784	"-"	"HG00438#1#JAHBCB010000015.1_33474867_33954171_0"	479304	303685	312476	1769	8791	0	"P"	557	1686	1686	1e-04	0	"HG00438#1#JAHBCB010000015.1_33474867_33954171_0"	"AMY1A-201"	"1"	"HG00438"	"0-3-7-9-4-6-8-5-2-4-9-7-2-5-8-6-4-9-7-2-5-2-1"	"0.0-3.0-7.0-9.0-4.0-6.0-8.0-5.0-2.0-4.1-9.1-7.1-2.1-5.1-8.1-6.1-4.1-9.1-7.1-2.1-5.1-2.0-1.0"	98	"HG00438#1#JAHBCB010000015.1_33474867_33954171_0"	303685	312476
"ENST00000370083.9"	1785	2	1784	"+"	"HG00438#1#JAHBCB010000015.1_33474867_33954171_0"	479304	366163	374956	1769	8793	0	"S"	557	1686	NA	1e-04	0	"HG00438#1#JAHBCB010000015.1_33474867_33954171_0"	"AMY1A-201"	"1"	"HG00438"	"0-3-7-9-4-6-8-5-2-4-9-7-2-5-8-6-4-9-7-2-5-2-1"	"0.0-3.0-7.0-9.0-4.0-6.0-8.0-5.0-2.0-4.1-9.1-7.1-2.1-5.1-8.1-6.1-4.1-9.1-7.1-2.1-5.1-2.0-1.0"	98	"HG00438#1#JAHBCB010000015.1_33474867_33954171_0"	366163	374956
"ENST00000370083.9"	1785	2	1784	"-"	"HG00438#1#JAHBCB010000015.1_33474867_33954171_0"	479304	231273	240064	1769	8791	0	"S"	557	1686	NA	1e-04	0	"HG00438#1#JAHBCB010000015.1_33474867_33954171_0"	"AMY1A-201"	"1"	"HG00438"	"0-3-7-9-4-6-8-5-2-4-9-7-2-5-8-6-4-9-7-2-5-2-1"	"0.0-3.0-7.0-9.0-4.0-6.0-8.0-5.0-2.0-4.1-9.1-7.1-2.1-5.1-8.1-6.1-4.1-9.1-7.1-2.1-5.1-2.0-1.0"	98	"HG00438#1#JAHBCB010000015.1_33474867_33954171_0"	231273	240064
"ENST00000370083.9"	1785	2	1784	"+"	"HG00438#1#JAHBCB010000015.1_33474867_33954171_0"	479304	199618	208411	1769	8793	0	"S"	557	1686	NA	1e-04	0	"HG00438#1#JAHBCB010000015.1_33474867_33954171_0"	"AMY1A-201"	"1"	"HG00438"	"0-3-7-9-4-6-8-5-2-4-9-7-2-5-8-6-4-9-7-2-5-2-1"	"0.0-3.0-7.0-9.0-4.0-6.0-8.0-5.0-2.0-4.1-9.1-7.1-2.1-5.1-8.1-6.1-4.1-9.1-7.1-2.1-5.1-2.0-1.0"	98	"HG00438#1#JAHBCB010000015.1_33474867_33954171_0"	199618	208411
"ENST00000414303.7"	1584	4	1583	"-"	"HG00438#1#JAHBCB010000015.1_33474867_33954171_0"	479304	270047	278317	1574	8270	0	"P"	491	1499	1499	1e-04	0	"HG00438#1#JAHBCB010000015.1_33474867_33954171_0"	"AMY2A-201"	"2A"	"HG00438"	"0-3-7-9-4-6-8-5-2-4-9-7-2-5-8-6-4-9-7-2-5-2-1"	"0.0-3.0-7.0-9.0-4.0-6.0-8.0-5.0-2.0-4.1-9.1-7.1-2.1-5.1-8.1-6.1-4.1-9.1-7.1-2.1-5.1-2.0-1.0"	98	"HG00438#1#JAHBCB010000015.1_33474867_33954171_0"	270047	278317
"ENST00000414303.7"	1584	4	1583	"+"	"HG00438#1#JAHBCB010000015.1_33474867_33954171_0"	479304	161365	169635	1574	8270	0	"S"	491	1499	NA	1e-04	0	"HG00438#1#JAHBCB010000015.1_33474867_33954171_0"	"AMY2A-201"	"2A"	"HG00438"	"0-3-7-9-4-6-8-5-2-4-9-7-2-5-8-6-4-9-7-2-5-2-1"	"0.0-3.0-7.0-9.0-4.0-6.0-8.0-5.0-2.0-4.1-9.1-7.1-2.1-5.1-8.1-6.1-4.1-9.1-7.1-2.1-5.1-2.0-1.0"	98	"HG00438#1#JAHBCB010000015.1_33474867_33954171_0"	161365	169635
"ENST00000610648.1"	1736	4	1733	"+"	"HG00438#1#JAHBCB010000015.1_33474867_33954171_0"	479304	115030	123452	1720	8422	40	"P"	531	1638	1414	1e-04	0	"HG00438#1#JAHBCB010000015.1_33474867_33954171_0"	"AMY2B-208"	"2B"	"HG00438"	"0-3-7-9-4-6-8-5-2-4-9-7-2-5-8-6-4-9-7-2-5-2-1"	"0.0-3.0-7.0-9.0-4.0-6.0-8.0-5.0-2.0-4.1-9.1-7.1-2.1-5.1-8.1-6.1-4.1-9.1-7.1-2.1-5.1-2.0-1.0"	98	"HG00438#1#JAHBCB010000015.1_33474867_33954171_0"	115030	123452
"ENST00000370083.9"	1785	2	1784	"-"	"HG02080#2#JAHEOV010000017.1_16662177_17164189_0"	502012	231299	240092	1769	8793	0	"P"	557	1686	1686	1e-04	0	"HG02080#2#JAHEOV010000017.1_16662177_17164189_0"	"AMY1A-201"	"1"	"HG02080"	"0-3-7-9-4-6-8-5-2-4-9-7-2-5-2-4-9-7-2-5-2-1"	"0.0-3.0-7.0-9.0-4.0-6.0-8.0-5.0-2.0-4.1-9.1-7.1-2.1-5.0-2.0-4.1-9.1-7.1-2.1-5.0-2.0-1.0"	99	"HG02080#2#JAHEOV010000017.1_16662177_17164189_0"	231299	240092
"ENST00000370083.9"	1785	2	1784	"-"	"HG02080#2#JAHEOV010000017.1_16662177_17164189_0"	502012	325429	334220	1769	8791	0	"S"	557	1686	NA	1e-04	0	"HG02080#2#JAHEOV010000017.1_16662177_17164189_0"	"AMY1A-201"	"1"	"HG02080"	"0-3-7-9-4-6-8-5-2-4-9-7-2-5-2-4-9-7-2-5-2-1"	"0.0-3.0-7.0-9.0-4.0-6.0-8.0-5.0-2.0-4.1-9.1-7.1-2.1-5.0-2.0-4.1-9.1-7.1-2.1-5.0-2.0-1.0"	99	"HG02080#2#JAHEOV010000017.1_16662177_17164189_0"	325429	334220
"ENST00000370083.9"	1785	2	1784	"+"	"HG02080#2#JAHEOV010000017.1_16662177_17164189_0"	502012	293773	302565	1769	8792	0	"S"	557	1686	NA	1e-04	0	"HG02080#2#JAHEOV010000017.1_16662177_17164189_0"	"AMY1A-201"	"1"	"HG02080"	"0-3-7-9-4-6-8-5-2-4-9-7-2-5-2-4-9-7-2-5-2-1"	"0.0-3.0-7.0-9.0-4.0-6.0-8.0-5.0-2.0-4.1-9.1-7.1-2.1-5.0-2.0-4.1-9.1-7.1-2.1-5.0-2.0-1.0"	99	"HG02080#2#JAHEOV010000017.1_16662177_17164189_0"	293773	302565
"ENST00000370083.9"	1785	2	1784	"+"	"HG02080#2#JAHEOV010000017.1_16662177_17164189_0"	502012	199639	208432	1769	8793	0	"S"	557	1686	NA	1e-04	0	"HG02080#2#JAHEOV010000017.1_16662177_17164189_0"	"AMY1A-201"	"1"	"HG02080"	"0-3-7-9-4-6-8-5-2-4-9-7-2-5-2-4-9-7-2-5-2-1"	"0.0-3.0-7.0-9.0-4.0-6.0-8.0-5.0-2.0-4.1-9.1-7.1-2.1-5.0-2.0-4.1-9.1-7.1-2.1-5.0-2.0-1.0"	99	"HG02080#2#JAHEOV010000017.1_16662177_17164189_0"	199639	208432
"ENST00000370083.9"	1785	2	1784	"+"	"HG02080#2#JAHEOV010000017.1_16662177_17164189_0"	502012	387911	396703	1769	8792	0	"S"	557	1686	NA	1e-04	0	"HG02080#2#JAHEOV010000017.1_16662177_17164189_0"	"AMY1A-201"	"1"	"HG02080"	"0-3-7-9-4-6-8-5-2-4-9-7-2-5-2-4-9-7-2-5-2-1"	"0.0-3.0-7.0-9.0-4.0-6.0-8.0-5.0-2.0-4.1-9.1-7.1-2.1-5.0-2.0-4.1-9.1-7.1-2.1-5.0-2.0-1.0"	99	"HG02080#2#JAHEOV010000017.1_16662177_17164189_0"	387911	396703
"ENST00000414303.7"	1584	4	1583	"+"	"HG02080#2#JAHEOV010000017.1_16662177_17164189_0"	502012	161384	169654	1574	8270	16	"P"	491	1499	1417	1e-04	0	"HG02080#2#JAHEOV010000017.1_16662177_17164189_0"	"AMY2A-201"	"2A"	"HG02080"	"0-3-7-9-4-6-8-5-2-4-9-7-2-5-2-4-9-7-2-5-2-1"	"0.0-3.0-7.0-9.0-4.0-6.0-8.0-5.0-2.0-4.1-9.1-7.1-2.1-5.0-2.0-4.1-9.1-7.1-2.1-5.0-2.0-1.0"	99	"HG02080#2#JAHEOV010000017.1_16662177_17164189_0"	161384	169654
"ENST00000610648.1"	1736	4	1733	"+"	"HG02080#2#JAHEOV010000017.1_16662177_17164189_0"	502012	115059	123483	1720	8424	48	"P"	531	1638	1371	1e-04	0	"HG02080#2#JAHEOV010000017.1_16662177_17164189_0"	"AMY2B-208"	"2B"	"HG02080"	"0-3-7-9-4-6-8-5-2-4-9-7-2-5-2-4-9-7-2-5-2-1"	"0.0-3.0-7.0-9.0-4.0-6.0-8.0-5.0-2.0-4.1-9.1-7.1-2.1-5.0-2.0-4.1-9.1-7.1-2.1-5.0-2.0-1.0"	99	"HG02080#2#JAHEOV010000017.1_16662177_17164189_0"	115059	123483
"ENST00000370083.9"	1785	2	1784	"+"	"HG02622#2#JAHAON010000012.1_51551779_52031001_0"	479222	366064	374855	1769	8791	0	"P"	557	1686	1686	1e-04	0	"HG02622#2#JAHAON010000012.1_51551779_52031001_0"	"AMY1A-201"	"1"	"HG02622"	"0-3-7-9-4-6-8-5-2-7-9-4-2-5-8-6-4-9-7-2-5-2-1"	"0.0-3.0-7.0-9.0-4.0-6.0-8.0-5.0-2.0-7.0-9.0-4.0-2.1-5.1-8.1-6.1-4.1-9.1-7.1-2.1-5.0-2.0-1.0"	98	"HG02622#2#JAHAON010000012.1_51551779_52031001_0"	366064	374855
"ENST00000370083.9"	1785	2	1784	"-"	"HG02622#2#JAHAON010000012.1_51551779_52031001_0"	479222	303625	312417	1769	8792	0	"S"	557	1686	NA	1e-04	0	"HG02622#2#JAHAON010000012.1_51551779_52031001_0"	"AMY1A-201"	"1"	"HG02622"	"0-3-7-9-4-6-8-5-2-7-9-4-2-5-8-6-4-9-7-2-5-2-1"	"0.0-3.0-7.0-9.0-4.0-6.0-8.0-5.0-2.0-7.0-9.0-4.0-2.1-5.1-8.1-6.1-4.1-9.1-7.1-2.1-5.0-2.0-1.0"	98	"HG02622#2#JAHAON010000012.1_51551779_52031001_0"	303625	312417
"ENST00000370083.9"	1785	2	1784	"+"	"HG02622#2#JAHAON010000012.1_51551779_52031001_0"	479222	199563	208355	1769	8792	0	"S"	557	1686	NA	1e-04	0	"HG02622#2#JAHAON010000012.1_51551779_52031001_0"	"AMY1A-201"	"1"	"HG02622"	"0-3-7-9-4-6-8-5-2-7-9-4-2-5-8-6-4-9-7-2-5-2-1"	"0.0-3.0-7.0-9.0-4.0-6.0-8.0-5.0-2.0-7.0-9.0-4.0-2.1-5.1-8.1-6.1-4.1-9.1-7.1-2.1-5.0-2.0-1.0"	98	"HG02622#2#JAHAON010000012.1_51551779_52031001_0"	199563	208355
"ENST00000370083.9"	1785	2	1784	"-"	"HG02622#2#JAHAON010000012.1_51551779_52031001_0"	479222	231204	239995	1769	8791	0	"S"	557	1686	NA	1e-04	0	"HG02622#2#JAHAON010000012.1_51551779_52031001_0"	"AMY1A-201"	"1"	"HG02622"	"0-3-7-9-4-6-8-5-2-7-9-4-2-5-8-6-4-9-7-2-5-2-1"	"0.0-3.0-7.0-9.0-4.0-6.0-8.0-5.0-2.0-7.0-9.0-4.0-2.1-5.1-8.1-6.1-4.1-9.1-7.1-2.1-5.0-2.0-1.0"	98	"HG02622#2#JAHAON010000012.1_51551779_52031001_0"	231204	239995
"ENST00000414303.7"	1584	4	1583	"-"	"HG02622#2#JAHAON010000012.1_51551779_52031001_0"	479222	269979	278249	1571	8270	0	"P"	486	1496	1494	8e-04	0	"HG02622#2#JAHAON010000012.1_51551779_52031001_0"	"AMY2A-201"	"2A"	"HG02622"	"0-3-7-9-4-6-8-5-2-7-9-4-2-5-8-6-4-9-7-2-5-2-1"	"0.0-3.0-7.0-9.0-4.0-6.0-8.0-5.0-2.0-7.0-9.0-4.0-2.1-5.1-8.1-6.1-4.1-9.1-7.1-2.1-5.0-2.0-1.0"	98	"HG02622#2#JAHAON010000012.1_51551779_52031001_0"	269979	278249
"ENST00000414303.7"	1584	4	1583	"+"	"HG02622#2#JAHAON010000012.1_51551779_52031001_0"	479222	161309	169579	1569	8270	0	"S"	486	1494	NA	8e-04	0	"HG02622#2#JAHAON010000012.1_51551779_52031001_0"	"AMY2A-201"	"2A"	"HG02622"	"0-3-7-9-4-6-8-5-2-7-9-4-2-5-8-6-4-9-7-2-5-2-1"	"0.0-3.0-7.0-9.0-4.0-6.0-8.0-5.0-2.0-7.0-9.0-4.0-2.1-5.1-8.1-6.1-4.1-9.1-7.1-2.1-5.0-2.0-1.0"	98	"HG02622#2#JAHAON010000012.1_51551779_52031001_0"	161309	169579
"ENST00000610648.1"	1736	4	1733	"+"	"HG02622#2#JAHAON010000012.1_51551779_52031001_0"	479222	114978	123389	1717	8411	40	"P"	524	1635	1411	9e-04	0	"HG02622#2#JAHAON010000012.1_51551779_52031001_0"	"AMY2B-208"	"2B"	"HG02622"	"0-3-7-9-4-6-8-5-2-7-9-4-2-5-8-6-4-9-7-2-5-2-1"	"0.0-3.0-7.0-9.0-4.0-6.0-8.0-5.0-2.0-7.0-9.0-4.0-2.1-5.1-8.1-6.1-4.1-9.1-7.1-2.1-5.0-2.0-1.0"	98	"HG02622#2#JAHAON010000012.1_51551779_52031001_0"	114978	123389
"ENST00000370083.9"	1785	2	1784	"+"	"HG01123#1#JAGYYZ010000015.1_51528240_51935090_0"	406850	293749	302540	1769	8791	0	"P"	557	1686	1686	1e-04	0	"HG01123#1#JAGYYZ010000015.1_51528240_51935090_0"	"AMY1A-201"	"1"	"HG01123"	"0-3-7-9-4-6-8-5-2-7-9-4-2-5-2-1"	"0.0-3.0-7.0-9.0-4.0-6.0-8.0-5.0-2.0-7.0-9.0-4.0-2.1-5.1-2.0-1.0"	98	"HG01123#1#JAGYYZ010000015.1_51528240_51935090_0"	293749	302540
"ENST00000370083.9"	1785	2	1784	"-"	"HG01123#1#JAGYYZ010000015.1_51528240_51935090_0"	406850	231268	240061	1769	8793	0	"S"	557	1686	NA	1e-04	0	"HG01123#1#JAGYYZ010000015.1_51528240_51935090_0"	"AMY1A-201"	"1"	"HG01123"	"0-3-7-9-4-6-8-5-2-7-9-4-2-5-2-1"	"0.0-3.0-7.0-9.0-4.0-6.0-8.0-5.0-2.0-7.0-9.0-4.0-2.1-5.1-2.0-1.0"	98	"HG01123#1#JAGYYZ010000015.1_51528240_51935090_0"	231268	240061
"ENST00000370083.9"	1785	2	1784	"+"	"HG01123#1#JAGYYZ010000015.1_51528240_51935090_0"	406850	199613	208406	1767	8793	0	"S"	552	1684	NA	7e-04	0	"HG01123#1#JAGYYZ010000015.1_51528240_51935090_0"	"AMY1A-201"	"1"	"HG01123"	"0-3-7-9-4-6-8-5-2-7-9-4-2-5-2-1"	"0.0-3.0-7.0-9.0-4.0-6.0-8.0-5.0-2.0-7.0-9.0-4.0-2.1-5.1-2.0-1.0"	98	"HG01123#1#JAGYYZ010000015.1_51528240_51935090_0"	199613	208406
"ENST00000414303.7"	1584	4	1583	"+"	"HG01123#1#JAGYYZ010000015.1_51528240_51935090_0"	406850	161352	169622	1574	8270	30	"P"	491	1499	1342	1e-04	0	"HG01123#1#JAGYYZ010000015.1_51528240_51935090_0"	"AMY2A-201"	"2A"	"HG01123"	"0-3-7-9-4-6-8-5-2-7-9-4-2-5-2-1"	"0.0-3.0-7.0-9.0-4.0-6.0-8.0-5.0-2.0-7.0-9.0-4.0-2.1-5.1-2.0-1.0"	98	"HG01123#1#JAGYYZ010000015.1_51528240_51935090_0"	161352	169622
"ENST00000610648.1"	1736	4	1733	"+"	"HG01123#1#JAGYYZ010000015.1_51528240_51935090_0"	406850	115030	123452	1720	8422	48	"P"	531	1638	1371	1e-04	0	"HG01123#1#JAGYYZ010000015.1_51528240_51935090_0"	"AMY2B-208"	"2B"	"HG01123"	"0-3-7-9-4-6-8-5-2-7-9-4-2-5-2-1"	"0.0-3.0-7.0-9.0-4.0-6.0-8.0-5.0-2.0-7.0-9.0-4.0-2.1-5.1-2.0-1.0"	98	"HG01123#1#JAGYYZ010000015.1_51528240_51935090_0"	115030	123452
"ENST00000370083.9"	1785	2	1784	"-"	"HG01071#1#JAHBCF010000053.1_26607100_27108065_1"	500965	325425	334218	1769	8793	0	"P"	557	1686	1686	1e-04	0	"HG01071#1#JAHBCF010000053.1_26607100_27108065_1"	"AMY1A-201"	"1"	"HG01071"	"0-3-7-9-4-6-8-5-2-4-9-7-2-5-2-7-9-4-2-5-2-1"	"0.0-3.0-7.0-9.0-4.0-6.0-8.0-5.0-2.0-4.1-9.1-7.1-2.1-5.0-2.0-7.0-9.0-4.0-2.1-5.1-2.0-1.0"	155	"HG01071#1#JAHBCF010000053.1_26607100_27108065_1"	325425	334218
"ENST00000370083.9"	1785	2	1784	"+"	"HG01071#1#JAHBCF010000053.1_26607100_27108065_1"	500965	387900	396694	1769	8794	0	"S"	557	1686	NA	1e-04	0	"HG01071#1#JAHBCF010000053.1_26607100_27108065_1"	"AMY1A-201"	"1"	"HG01071"	"0-3-7-9-4-6-8-5-2-4-9-7-2-5-2-7-9-4-2-5-2-1"	"0.0-3.0-7.0-9.0-4.0-6.0-8.0-5.0-2.0-4.1-9.1-7.1-2.1-5.0-2.0-7.0-9.0-4.0-2.1-5.1-2.0-1.0"	155	"HG01071#1#JAHBCF010000053.1_26607100_27108065_1"	387900	396694
"ENST00000370083.9"	1785	2	1784	"-"	"HG01071#1#JAHBCF010000053.1_26607100_27108065_1"	500965	231297	240090	1769	8793	0	"S"	557	1686	NA	1e-04	0	"HG01071#1#JAHBCF010000053.1_26607100_27108065_1"	"AMY1A-201"	"1"	"HG01071"	"0-3-7-9-4-6-8-5-2-4-9-7-2-5-2-7-9-4-2-5-2-1"	"0.0-3.0-7.0-9.0-4.0-6.0-8.0-5.0-2.0-4.1-9.1-7.1-2.1-5.0-2.0-7.0-9.0-4.0-2.1-5.1-2.0-1.0"	155	"HG01071#1#JAHBCF010000053.1_26607100_27108065_1"	231297	240090
"ENST00000370083.9"	1785	2	1784	"+"	"HG01071#1#JAHBCF010000053.1_26607100_27108065_1"	500965	293767	302560	1769	8793	0	"S"	557	1686	NA	1e-04	0	"HG01071#1#JAHBCF010000053.1_26607100_27108065_1"	"AMY1A-201"	"1"	"HG01071"	"0-3-7-9-4-6-8-5-2-4-9-7-2-5-2-7-9-4-2-5-2-1"	"0.0-3.0-7.0-9.0-4.0-6.0-8.0-5.0-2.0-4.1-9.1-7.1-2.1-5.0-2.0-7.0-9.0-4.0-2.1-5.1-2.0-1.0"	155	"HG01071#1#JAHBCF010000053.1_26607100_27108065_1"	293767	302560
"ENST00000370083.9"	1785	2	1784	"+"	"HG01071#1#JAHBCF010000053.1_26607100_27108065_1"	500965	199640	208434	1769	8794	0	"S"	557	1686	NA	1e-04	0	"HG01071#1#JAHBCF010000053.1_26607100_27108065_1"	"AMY1A-201"	"1"	"HG01071"	"0-3-7-9-4-6-8-5-2-4-9-7-2-5-2-7-9-4-2-5-2-1"	"0.0-3.0-7.0-9.0-4.0-6.0-8.0-5.0-2.0-4.1-9.1-7.1-2.1-5.0-2.0-7.0-9.0-4.0-2.1-5.1-2.0-1.0"	155	"HG01071#1#JAHBCF010000053.1_26607100_27108065_1"	199640	208434
"ENST00000414303.7"	1584	4	1583	"+"	"HG01071#1#JAHBCF010000053.1_26607100_27108065_1"	500965	161385	169655	1574	8270	30	"P"	491	1499	1342	1e-04	0	"HG01071#1#JAHBCF010000053.1_26607100_27108065_1"	"AMY2A-201"	"2A"	"HG01071"	"0-3-7-9-4-6-8-5-2-4-9-7-2-5-2-7-9-4-2-5-2-1"	"0.0-3.0-7.0-9.0-4.0-6.0-8.0-5.0-2.0-4.1-9.1-7.1-2.1-5.0-2.0-7.0-9.0-4.0-2.1-5.1-2.0-1.0"	155	"HG01071#1#JAHBCF010000053.1_26607100_27108065_1"	161385	169655
"ENST00000610648.1"	1736	4	1733	"+"	"HG01071#1#JAHBCF010000053.1_26607100_27108065_1"	500965	115055	123479	1720	8424	48	"P"	531	1638	1371	1e-04	0	"HG01071#1#JAHBCF010000053.1_26607100_27108065_1"	"AMY2B-208"	"2B"	"HG01071"	"0-3-7-9-4-6-8-5-2-4-9-7-2-5-2-7-9-4-2-5-2-1"	"0.0-3.0-7.0-9.0-4.0-6.0-8.0-5.0-2.0-4.1-9.1-7.1-2.1-5.0-2.0-7.0-9.0-4.0-2.1-5.1-2.0-1.0"	155	"HG01071#1#JAHBCF010000053.1_26607100_27108065_1"	115055	123479
"ENST00000370083.9"	1785	2	1784	"+"	"HG02723#2#JAHEOT010000034.1_19776337_20321518_1"	545181	315450	324229	1769	8779	0	"P"	557	1686	1686	1e-04	0	"HG02723#2#JAHEOT010000034.1_19776337_20321518_1"	"AMY1A-201"	"1"	"HG02723"	"0-3-7-9-4-2-5-8-6-4-9-7-3-0-4-6-8-5-2-4-0-3-7-9-4-6-8-5-2-1"	"0.0-3.0-7.0-9.0-4.0-2.1-5.1-8.1-6.1-4.1-9.1-7.1-3.1-0.1-4.0-6.0-8.0-5.0-2.0-4.1-0.0-3.0-7.0-9.0-4.0-6.0-8.0-5.0-2.0-1.0"	154	"HG02723#2#JAHEOT010000034.1_19776337_20321518_1"	315450	324229
"ENST00000370083.9"	1785	2	1784	"-"	"HG02723#2#JAHEOT010000034.1_19776337_20321518_1"	545181	158935	167715	1769	8780	0	"S"	557	1686	NA	1e-04	0	"HG02723#2#JAHEOT010000034.1_19776337_20321518_1"	"AMY1A-201"	"1"	"HG02723"	"0-3-7-9-4-2-5-8-6-4-9-7-3-0-4-6-8-5-2-4-0-3-7-9-4-6-8-5-2-1"	"0.0-3.0-7.0-9.0-4.0-2.1-5.1-8.1-6.1-4.1-9.1-7.1-3.1-0.1-4.0-6.0-8.0-5.0-2.0-4.1-0.0-3.0-7.0-9.0-4.0-6.0-8.0-5.0-2.0-1.0"	154	"HG02723#2#JAHEOT010000034.1_19776337_20321518_1"	158935	167715
"ENST00000370083.9"	1785	2	1784	"+"	"HG02723#2#JAHEOT010000034.1_19776337_20321518_1"	545181	431200	439991	1769	8791	0	"S"	557	1686	NA	1e-04	0	"HG02723#2#JAHEOT010000034.1_19776337_20321518_1"	"AMY1A-201"	"1"	"HG02723"	"0-3-7-9-4-2-5-8-6-4-9-7-3-0-4-6-8-5-2-4-0-3-7-9-4-6-8-5-2-1"	"0.0-3.0-7.0-9.0-4.0-2.1-5.1-8.1-6.1-4.1-9.1-7.1-3.1-0.1-4.0-6.0-8.0-5.0-2.0-4.1-0.0-3.0-7.0-9.0-4.0-6.0-8.0-5.0-2.0-1.0"	154	"HG02723#2#JAHEOT010000034.1_19776337_20321518_1"	431200	439991
"ENST00000414303.7"	1584	4	1583	"-"	"HG02723#2#JAHEOT010000034.1_19776337_20321518_1"	545181	197698	205968	1563	8270	0	"P"	488	1488	1488	5e-04	0	"HG02723#2#JAHEOT010000034.1_19776337_20321518_1"	"AMY2A-201"	"2A"	"HG02723"	"0-3-7-9-4-2-5-8-6-4-9-7-3-0-4-6-8-5-2-4-0-3-7-9-4-6-8-5-2-1"	"0.0-3.0-7.0-9.0-4.0-2.1-5.1-8.1-6.1-4.1-9.1-7.1-3.1-0.1-4.0-6.0-8.0-5.0-2.0-4.1-0.0-3.0-7.0-9.0-4.0-6.0-8.0-5.0-2.0-1.0"	154	"HG02723#2#JAHEOT010000034.1_19776337_20321518_1"	197698	205968
"ENST00000414303.7"	1584	4	1583	"+"	"HG02723#2#JAHEOT010000034.1_19776337_20321518_1"	545181	277190	285460	1563	8270	0	"S"	488	1488	NA	5e-04	0	"HG02723#2#JAHEOT010000034.1_19776337_20321518_1"	"AMY2A-201"	"2A"	"HG02723"	"0-3-7-9-4-2-5-8-6-4-9-7-3-0-4-6-8-5-2-4-0-3-7-9-4-6-8-5-2-1"	"0.0-3.0-7.0-9.0-4.0-2.1-5.1-8.1-6.1-4.1-9.1-7.1-3.1-0.1-4.0-6.0-8.0-5.0-2.0-4.1-0.0-3.0-7.0-9.0-4.0-6.0-8.0-5.0-2.0-1.0"	154	"HG02723#2#JAHEOT010000034.1_19776337_20321518_1"	277190	285460
"ENST00000414303.7"	1584	4	1583	"+"	"HG02723#2#JAHEOT010000034.1_19776337_20321518_1"	545181	392941	401211	1563	8270	0	"S"	488	1488	NA	5e-04	0	"HG02723#2#JAHEOT010000034.1_19776337_20321518_1"	"AMY2A-201"	"2A"	"HG02723"	"0-3-7-9-4-2-5-8-6-4-9-7-3-0-4-6-8-5-2-4-0-3-7-9-4-6-8-5-2-1"	"0.0-3.0-7.0-9.0-4.0-2.1-5.1-8.1-6.1-4.1-9.1-7.1-3.1-0.1-4.0-6.0-8.0-5.0-2.0-4.1-0.0-3.0-7.0-9.0-4.0-6.0-8.0-5.0-2.0-1.0"	154	"HG02723#2#JAHEOT010000034.1_19776337_20321518_1"	392941	401211
"ENST00000610648.1"	1736	4	1733	"-"	"HG02723#2#JAHEOT010000034.1_19776337_20321518_1"	545181	243882	252304	1720	8422	0	"P"	531	1638	1638	1e-04	0	"HG02723#2#JAHEOT010000034.1_19776337_20321518_1"	"AMY2B-208"	"2B"	"HG02723"	"0-3-7-9-4-2-5-8-6-4-9-7-3-0-4-6-8-5-2-4-0-3-7-9-4-6-8-5-2-1"	"0.0-3.0-7.0-9.0-4.0-2.1-5.1-8.1-6.1-4.1-9.1-7.1-3.1-0.1-4.0-6.0-8.0-5.0-2.0-4.1-0.0-3.0-7.0-9.0-4.0-6.0-8.0-5.0-2.0-1.0"	154	"HG02723#2#JAHEOT010000034.1_19776337_20321518_1"	243882	252304
"ENST00000610648.1"	1736	4	1733	"+"	"HG02723#2#JAHEOT010000034.1_19776337_20321518_1"	545181	346605	355027	1720	8422	0	"S"	531	1638	NA	1e-04	0	"HG02723#2#JAHEOT010000034.1_19776337_20321518_1"	"AMY2B-208"	"2B"	"HG02723"	"0-3-7-9-4-2-5-8-6-4-9-7-3-0-4-6-8-5-2-4-0-3-7-9-4-6-8-5-2-1"	"0.0-3.0-7.0-9.0-4.0-2.1-5.1-8.1-6.1-4.1-9.1-7.1-3.1-0.1-4.0-6.0-8.0-5.0-2.0-4.1-0.0-3.0-7.0-9.0-4.0-6.0-8.0-5.0-2.0-1.0"	154	"HG02723#2#JAHEOT010000034.1_19776337_20321518_1"	346605	355027
"ENST00000610648.1"	1736	4	1733	"+"	"HG02723#2#JAHEOT010000034.1_19776337_20321518_1"	545181	115110	123532	1720	8422	0	"S"	531	1638	NA	1e-04	0	"HG02723#2#JAHEOT010000034.1_19776337_20321518_1"	"AMY2B-208"	"2B"	"HG02723"	"0-3-7-9-4-2-5-8-6-4-9-7-3-0-4-6-8-5-2-4-0-3-7-9-4-6-8-5-2-1"	"0.0-3.0-7.0-9.0-4.0-2.1-5.1-8.1-6.1-4.1-9.1-7.1-3.1-0.1-4.0-6.0-8.0-5.0-2.0-4.1-0.0-3.0-7.0-9.0-4.0-6.0-8.0-5.0-2.0-1.0"	154	"HG02723#2#JAHEOT010000034.1_19776337_20321518_1"	115110	123532
"ENST00000370083.9"	1785	2	1784	"-"	"HG02886#1#JAHAOU010000178.1_62411_469262_0"	406851	231276	240068	1769	8792	0	"P"	557	1686	1686	1e-04	0	"HG02886#1#JAHAOU010000178.1_62411_469262_0"	"AMY1A-201"	"1"	"HG02886"	"0-3-7-9-4-6-8-5-2-4-9-7-2-5-2-1"	"0.0-3.0-7.0-9.0-4.0-6.0-8.0-5.0-2.0-4.1-9.1-7.1-2.1-5.1-2.0-1.0"	98	"HG02886#1#JAHAOU010000178.1_62411_469262_0"	231276	240068
"ENST00000370083.9"	1785	2	1784	"+"	"HG02886#1#JAHAOU010000178.1_62411_469262_0"	406851	293745	302536	1769	8791	0	"S"	557	1686	NA	1e-04	0	"HG02886#1#JAHAOU010000178.1_62411_469262_0"	"AMY1A-201"	"1"	"HG02886"	"0-3-7-9-4-6-8-5-2-4-9-7-2-5-2-1"	"0.0-3.0-7.0-9.0-4.0-6.0-8.0-5.0-2.0-4.1-9.1-7.1-2.1-5.1-2.0-1.0"	98	"HG02886#1#JAHAOU010000178.1_62411_469262_0"	293745	302536
"ENST00000370083.9"	1785	2	1784	"+"	"HG02886#1#JAHAOU010000178.1_62411_469262_0"	406851	199618	208409	1769	8791	0	"S"	557	1686	NA	1e-04	0	"HG02886#1#JAHAOU010000178.1_62411_469262_0"	"AMY1A-201"	"1"	"HG02886"	"0-3-7-9-4-6-8-5-2-4-9-7-2-5-2-1"	"0.0-3.0-7.0-9.0-4.0-6.0-8.0-5.0-2.0-4.1-9.1-7.1-2.1-5.1-2.0-1.0"	98	"HG02886#1#JAHAOU010000178.1_62411_469262_0"	199618	208409
"ENST00000414303.7"	1584	4	1583	"+"	"HG02886#1#JAHAOU010000178.1_62411_469262_0"	406851	161366	169636	1563	8270	28	"P"	488	1488	1342	5e-04	0	"HG02886#1#JAHAOU010000178.1_62411_469262_0"	"AMY2A-201"	"2A"	"HG02886"	"0-3-7-9-4-6-8-5-2-4-9-7-2-5-2-1"	"0.0-3.0-7.0-9.0-4.0-6.0-8.0-5.0-2.0-4.1-9.1-7.1-2.1-5.1-2.0-1.0"	98	"HG02886#1#JAHAOU010000178.1_62411_469262_0"	161366	169636
"ENST00000610648.1"	1736	4	1733	"+"	"HG02886#1#JAHAOU010000178.1_62411_469262_0"	406851	115023	123447	1720	8424	48	"P"	531	1638	1371	1e-04	0	"HG02886#1#JAHAOU010000178.1_62411_469262_0"	"AMY2B-208"	"2B"	"HG02886"	"0-3-7-9-4-6-8-5-2-4-9-7-2-5-2-1"	"0.0-3.0-7.0-9.0-4.0-6.0-8.0-5.0-2.0-4.1-9.1-7.1-2.1-5.1-2.0-1.0"	98	"HG02886#1#JAHAOU010000178.1_62411_469262_0"	115023	123447
"ENST00000370083.9"	1785	2	1784	"+"	"HG00438#2#JAHBCA010000012.1_51513023_51826723_0"	313700	199617	208409	1769	8792	49	"P"	557	1686	1404	1e-04	0	"HG00438#2#JAHBCA010000012.1_51513023_51826723_0"	"AMY1A-201"	"1"	"HG00438"	"0-3-7-9-4-6-8-5-2-1"	"0.0-3.0-7.0-9.0-4.0-6.0-8.0-5.0-2.0-1.0"	99	"HG00438#2#JAHBCA010000012.1_51513023_51826723_0"	199617	208409
"ENST00000414303.7"	1584	4	1583	"+"	"HG00438#2#JAHBCA010000012.1_51513023_51826723_0"	313700	161354	169624	1574	8270	30	"P"	491	1499	1342	1e-04	0	"HG00438#2#JAHBCA010000012.1_51513023_51826723_0"	"AMY2A-201"	"2A"	"HG00438"	"0-3-7-9-4-6-8-5-2-1"	"0.0-3.0-7.0-9.0-4.0-6.0-8.0-5.0-2.0-1.0"	99	"HG00438#2#JAHBCA010000012.1_51513023_51826723_0"	161354	169624
"ENST00000610648.1"	1736	4	1733	"+"	"HG00438#2#JAHBCA010000012.1_51513023_51826723_0"	313700	115025	123449	1720	8424	50	"P"	531	1638	1358	1e-04	0	"HG00438#2#JAHBCA010000012.1_51513023_51826723_0"	"AMY2B-208"	"2B"	"HG00438"	"0-3-7-9-4-6-8-5-2-1"	"0.0-3.0-7.0-9.0-4.0-6.0-8.0-5.0-2.0-1.0"	99	"HG00438#2#JAHBCA010000012.1_51513023_51826723_0"	115025	123449
"ENST00000370083.9"	1785	2	1784	"+"	"HG01978#1#JAGYVS010000002.1_51519970_52021951_0"	501981	293766	302558	1769	8792	0	"P"	557	1686	1686	1e-04	0	"HG01978#1#JAGYVS010000002.1_51519970_52021951_0"	"AMY1A-201"	"1"	"HG01978"	"0-3-7-9-4-6-8-5-2-4-9-7-2-5-2-4-9-7-2-5-2-1"	"0.0-3.0-7.0-9.0-4.0-6.0-8.0-5.0-2.0-4.1-9.1-7.1-2.1-5.1-2.0-4.1-9.1-7.1-2.1-5.0-2.0-1.0"	99	"HG01978#1#JAGYVS010000002.1_51519970_52021951_0"	293766	302558
"ENST00000370083.9"	1785	2	1784	"+"	"HG01978#1#JAGYVS010000002.1_51519970_52021951_0"	501981	199615	208408	1769	8793	0	"S"	557	1686	NA	1e-04	0	"HG01978#1#JAGYVS010000002.1_51519970_52021951_0"	"AMY1A-201"	"1"	"HG01978"	"0-3-7-9-4-6-8-5-2-4-9-7-2-5-2-4-9-7-2-5-2-1"	"0.0-3.0-7.0-9.0-4.0-6.0-8.0-5.0-2.0-4.1-9.1-7.1-2.1-5.1-2.0-4.1-9.1-7.1-2.1-5.0-2.0-1.0"	99	"HG01978#1#JAGYVS010000002.1_51519970_52021951_0"	199615	208408
"ENST00000370083.9"	1785	2	1784	"-"	"HG01978#1#JAGYVS010000002.1_51519970_52021951_0"	501981	325429	334220	1769	8791	0	"S"	557	1686	NA	1e-04	0	"HG01978#1#JAGYVS010000002.1_51519970_52021951_0"	"AMY1A-201"	"1"	"HG01978"	"0-3-7-9-4-6-8-5-2-4-9-7-2-5-2-4-9-7-2-5-2-1"	"0.0-3.0-7.0-9.0-4.0-6.0-8.0-5.0-2.0-4.1-9.1-7.1-2.1-5.1-2.0-4.1-9.1-7.1-2.1-5.0-2.0-1.0"	99	"HG01978#1#JAGYVS010000002.1_51519970_52021951_0"	325429	334220
"ENST00000370083.9"	1785	2	1784	"+"	"HG01978#1#JAGYVS010000002.1_51519970_52021951_0"	501981	387895	396687	1769	8792	0	"S"	557	1686	NA	1e-04	0	"HG01978#1#JAGYVS010000002.1_51519970_52021951_0"	"AMY1A-201"	"1"	"HG01978"	"0-3-7-9-4-6-8-5-2-4-9-7-2-5-2-4-9-7-2-5-2-1"	"0.0-3.0-7.0-9.0-4.0-6.0-8.0-5.0-2.0-4.1-9.1-7.1-2.1-5.1-2.0-4.1-9.1-7.1-2.1-5.0-2.0-1.0"	99	"HG01978#1#JAGYVS010000002.1_51519970_52021951_0"	387895	396687
"ENST00000370083.9"	1785	2	1784	"-"	"HG01978#1#JAGYVS010000002.1_51519970_52021951_0"	501981	231275	240068	1764	8793	0	"S"	552	1681	NA	7e-04	0	"HG01978#1#JAGYVS010000002.1_51519970_52021951_0"	"AMY1A-201"	"1"	"HG01978"	"0-3-7-9-4-6-8-5-2-4-9-7-2-5-2-4-9-7-2-5-2-1"	"0.0-3.0-7.0-9.0-4.0-6.0-8.0-5.0-2.0-4.1-9.1-7.1-2.1-5.1-2.0-4.1-9.1-7.1-2.1-5.0-2.0-1.0"	99	"HG01978#1#JAGYVS010000002.1_51519970_52021951_0"	231275	240068
"ENST00000414303.7"	1584	4	1583	"+"	"HG01978#1#JAGYVS010000002.1_51519970_52021951_0"	501981	161364	169634	1574	8270	15	"P"	491	1499	1420	1e-04	0	"HG01978#1#JAGYVS010000002.1_51519970_52021951_0"	"AMY2A-201"	"2A"	"HG01978"	"0-3-7-9-4-6-8-5-2-4-9-7-2-5-2-4-9-7-2-5-2-1"	"0.0-3.0-7.0-9.0-4.0-6.0-8.0-5.0-2.0-4.1-9.1-7.1-2.1-5.1-2.0-4.1-9.1-7.1-2.1-5.0-2.0-1.0"	99	"HG01978#1#JAGYVS010000002.1_51519970_52021951_0"	161364	169634
"ENST00000610648.1"	1736	4	1733	"+"	"HG01978#1#JAGYVS010000002.1_51519970_52021951_0"	501981	115037	123457	1720	8420	48	"P"	531	1638	1371	1e-04	0	"HG01978#1#JAGYVS010000002.1_51519970_52021951_0"	"AMY2B-208"	"2B"	"HG01978"	"0-3-7-9-4-6-8-5-2-4-9-7-2-5-2-4-9-7-2-5-2-1"	"0.0-3.0-7.0-9.0-4.0-6.0-8.0-5.0-2.0-4.1-9.1-7.1-2.1-5.1-2.0-4.1-9.1-7.1-2.1-5.0-2.0-1.0"	99	"HG01978#1#JAGYVS010000002.1_51519970_52021951_0"	115037	123457
"ENST00000370083.9"	1785	2	1784	"+"	"HG03492#1#JAHEPI010000180.1_2103395_2543326_1"	439931	199686	208477	1769	8791	0	"P"	557	1686	1686	1e-04	0	"HG03492#1#JAHEPI010000180.1_2103395_2543326_1"	"AMY1A-201"	"1"	"HG03492"	"0-3-7-9-4-6-8-5-2-7-9-4-6-8-5-2-4-2-5-2-1"	"0.0-3.0-7.0-9.0-4.0-6.0-8.0-5.0-2.0-7.0-9.0-4.0-6.0-8.0-5.0-2.0-4.0-2.1-5.1-2.0-1.0"	154	"HG03492#1#JAHEPI010000180.1_2103395_2543326_1"	199686	208477
"ENST00000370083.9"	1785	2	1784	"+"	"HG03492#1#JAHEPI010000180.1_2103395_2543326_1"	439931	325964	334755	1769	8791	0	"S"	557	1686	NA	1e-04	0	"HG03492#1#JAHEPI010000180.1_2103395_2543326_1"	"AMY1A-201"	"1"	"HG03492"	"0-3-7-9-4-6-8-5-2-7-9-4-6-8-5-2-4-2-5-2-1"	"0.0-3.0-7.0-9.0-4.0-6.0-8.0-5.0-2.0-7.0-9.0-4.0-6.0-8.0-5.0-2.0-4.0-2.1-5.1-2.0-1.0"	154	"HG03492#1#JAHEPI010000180.1_2103395_2543326_1"	325964	334755
"ENST00000370083.9"	1785	2	1784	"-"	"HG03492#1#JAHEPI010000180.1_2103395_2543326_1"	439931	263489	272282	1769	8793	0	"S"	557	1686	NA	1e-04	0	"HG03492#1#JAHEPI010000180.1_2103395_2543326_1"	"AMY1A-201"	"1"	"HG03492"	"0-3-7-9-4-6-8-5-2-7-9-4-6-8-5-2-4-2-5-2-1"	"0.0-3.0-7.0-9.0-4.0-6.0-8.0-5.0-2.0-7.0-9.0-4.0-6.0-8.0-5.0-2.0-4.0-2.1-5.1-2.0-1.0"	154	"HG03492#1#JAHEPI010000180.1_2103395_2543326_1"	263489	272282
"ENST00000414303.7"	1584	4	1583	"+"	"HG03492#1#JAHEPI010000180.1_2103395_2543326_1"	439931	161421	169691	1574	8270	1	"P"	491	1499	1493	1e-04	0	"HG03492#1#JAHEPI010000180.1_2103395_2543326_1"	"AMY2A-201"	"2A"	"HG03492"	"0-3-7-9-4-6-8-5-2-7-9-4-6-8-5-2-4-2-5-2-1"	"0.0-3.0-7.0-9.0-4.0-6.0-8.0-5.0-2.0-7.0-9.0-4.0-6.0-8.0-5.0-2.0-4.0-2.1-5.1-2.0-1.0"	154	"HG03492#1#JAHEPI010000180.1_2103395_2543326_1"	161421	169691
"ENST00000414303.7"	1584	4	1583	"+"	"HG03492#1#JAHEPI010000180.1_2103395_2543326_1"	439931	233842	242112	1568	8270	0	"S"	485	1493	NA	0.001	0	"HG03492#1#JAHEPI010000180.1_2103395_2543326_1"	"AMY2A-201"	"2A"	"HG03492"	"0-3-7-9-4-6-8-5-2-7-9-4-6-8-5-2-4-2-5-2-1"	"0.0-3.0-7.0-9.0-4.0-6.0-8.0-5.0-2.0-7.0-9.0-4.0-6.0-8.0-5.0-2.0-4.0-2.1-5.1-2.0-1.0"	154	"HG03492#1#JAHEPI010000180.1_2103395_2543326_1"	233842	242112
"ENST00000610648.1"	1736	4	1733	"+"	"HG03492#1#JAHEPI010000180.1_2103395_2543326_1"	439931	115093	123515	1720	8422	48	"P"	531	1638	1371	1e-04	0	"HG03492#1#JAHEPI010000180.1_2103395_2543326_1"	"AMY2B-208"	"2B"	"HG03492"	"0-3-7-9-4-6-8-5-2-7-9-4-6-8-5-2-4-2-5-2-1"	"0.0-3.0-7.0-9.0-4.0-6.0-8.0-5.0-2.0-7.0-9.0-4.0-6.0-8.0-5.0-2.0-4.0-2.1-5.1-2.0-1.0"	154	"HG03492#1#JAHEPI010000180.1_2103395_2543326_1"	115093	123515
"ENST00000370083.9"	1785	2	1784	"+"	"chr1_hg38_103456064_103863972_0"	407908	199697	208489	1769	8792	0	"P"	557	1686	1686	1e-04	0	"chr1_hg38_103456064_103863972_0"	"AMY1A-201"	"1"	"chr1_hg38_103456064_103863972_0"	"0-3-7-9-4-6-8-5-2-4-9-7-2-5-2-1"	"0.0-3.0-7.0-9.0-4.0-6.0-8.0-5.0-2.0-4.1-9.1-7.1-2.1-5.0-2.0-1.0"	99	"chr1_hg38_103456064_103863972_0"	199697	208489
"ENST00000370083.9"	1785	2	1784	"-"	"chr1_hg38_103456064_103863972_0"	407908	231351	240144	1769	8793	0	"S"	557	1686	NA	1e-04	0	"chr1_hg38_103456064_103863972_0"	"AMY1A-201"	"1"	"chr1_hg38_103456064_103863972_0"	"0-3-7-9-4-6-8-5-2-4-9-7-2-5-2-1"	"0.0-3.0-7.0-9.0-4.0-6.0-8.0-5.0-2.0-4.1-9.1-7.1-2.1-5.0-2.0-1.0"	99	"chr1_hg38_103456064_103863972_0"	231351	240144
"ENST00000370083.9"	1785	2	1784	"+"	"chr1_hg38_103456064_103863972_0"	407908	293835	302627	1769	8792	0	"S"	557	1686	NA	1e-04	0	"chr1_hg38_103456064_103863972_0"	"AMY1A-201"	"1"	"chr1_hg38_103456064_103863972_0"	"0-3-7-9-4-6-8-5-2-4-9-7-2-5-2-1"	"0.0-3.0-7.0-9.0-4.0-6.0-8.0-5.0-2.0-4.1-9.1-7.1-2.1-5.0-2.0-1.0"	99	"chr1_hg38_103456064_103863972_0"	293835	302627
"ENST00000414303.7"	1584	4	1583	"+"	"chr1_hg38_103456064_103863972_0"	407908	161366	169715	1574	8349	30	"P"	491	1499	1342	1e-04	0	"chr1_hg38_103456064_103863972_0"	"AMY2A-201"	"2A"	"chr1_hg38_103456064_103863972_0"	"0-3-7-9-4-6-8-5-2-4-9-7-2-5-2-1"	"0.0-3.0-7.0-9.0-4.0-6.0-8.0-5.0-2.0-4.1-9.1-7.1-2.1-5.0-2.0-1.0"	99	"chr1_hg38_103456064_103863972_0"	161366	169715
"ENST00000610648.1"	1736	4	1733	"+"	"chr1_hg38_103456064_103863972_0"	407908	115039	123463	1720	8424	48	"P"	531	1638	1371	1e-04	0	"chr1_hg38_103456064_103863972_0"	"AMY2B-208"	"2B"	"chr1_hg38_103456064_103863972_0"	"0-3-7-9-4-6-8-5-2-4-9-7-2-5-2-1"	"0.0-3.0-7.0-9.0-4.0-6.0-8.0-5.0-2.0-4.1-9.1-7.1-2.1-5.0-2.0-1.0"	99	"chr1_hg38_103456064_103863972_0"	115039	123463
"ENST00000370083.9"	1785	2	1784	"-"	"HG03453#2#JAGYVV010000088.1_22597550_23005370_1"	407820	231339	240133	1769	8794	0	"P"	557	1686	1686	1e-04	0	"HG03453#2#JAGYVV010000088.1_22597550_23005370_1"	"AMY1A-201"	"1"	"HG03453"	"0-3-7-9-4-6-8-5-2-7-9-4-2-5-2-1"	"0.0-3.0-7.0-9.0-4.0-6.0-8.0-5.0-2.0-7.0-9.0-4.0-2.1-5.1-2.0-1.0"	154	"HG03453#2#JAGYVV010000088.1_22597550_23005370_1"	231339	240133
"ENST00000370083.9"	1785	2	1784	"+"	"HG03453#2#JAGYVV010000088.1_22597550_23005370_1"	407820	293811	302602	1769	8791	0	"S"	557	1686	NA	1e-04	0	"HG03453#2#JAGYVV010000088.1_22597550_23005370_1"	"AMY1A-201"	"1"	"HG03453"	"0-3-7-9-4-6-8-5-2-7-9-4-2-5-2-1"	"0.0-3.0-7.0-9.0-4.0-6.0-8.0-5.0-2.0-7.0-9.0-4.0-2.1-5.1-2.0-1.0"	154	"HG03453#2#JAGYVV010000088.1_22597550_23005370_1"	293811	302602
"ENST00000370083.9"	1785	2	1784	"+"	"HG03453#2#JAGYVV010000088.1_22597550_23005370_1"	407820	199680	208474	1767	8794	0	"S"	553	1684	NA	6e-04	0	"HG03453#2#JAGYVV010000088.1_22597550_23005370_1"	"AMY1A-201"	"1"	"HG03453"	"0-3-7-9-4-6-8-5-2-7-9-4-2-5-2-1"	"0.0-3.0-7.0-9.0-4.0-6.0-8.0-5.0-2.0-7.0-9.0-4.0-2.1-5.1-2.0-1.0"	154	"HG03453#2#JAGYVV010000088.1_22597550_23005370_1"	199680	208474
"ENST00000414303.7"	1584	4	1583	"+"	"HG03453#2#JAGYVV010000088.1_22597550_23005370_1"	407820	161420	169690	1566	8270	29	"P"	486	1491	1342	8e-04	0	"HG03453#2#JAGYVV010000088.1_22597550_23005370_1"	"AMY2A-201"	"2A"	"HG03453"	"0-3-7-9-4-6-8-5-2-7-9-4-2-5-2-1"	"0.0-3.0-7.0-9.0-4.0-6.0-8.0-5.0-2.0-7.0-9.0-4.0-2.1-5.1-2.0-1.0"	154	"HG03453#2#JAGYVV010000088.1_22597550_23005370_1"	161420	169690
"ENST00000610648.1"	1736	4	1733	"+"	"HG03453#2#JAGYVV010000088.1_22597550_23005370_1"	407820	115095	123517	1720	8422	48	"P"	531	1638	1371	1e-04	0	"HG03453#2#JAGYVV010000088.1_22597550_23005370_1"	"AMY2B-208"	"2B"	"HG03453"	"0-3-7-9-4-6-8-5-2-7-9-4-2-5-2-1"	"0.0-3.0-7.0-9.0-4.0-6.0-8.0-5.0-2.0-7.0-9.0-4.0-2.1-5.1-2.0-1.0"	154	"HG03453#2#JAGYVV010000088.1_22597550_23005370_1"	115095	123517
"ENST00000370083.9"	1785	2	1784	"+"	"HG03486#2#JAHEOP010000248.1_2105565_2584784_1"	479219	199638	208430	1769	8792	0	"P"	557	1686	1686	1e-04	0	"HG03486#2#JAHEOP010000248.1_2105565_2584784_1"	"AMY1A-201"	"1"	"HG03486"	"0-3-7-9-4-6-8-5-2-7-9-4-6-8-5-2-7-9-4-2-5-2-1"	"0.0-3.0-7.0-9.0-4.0-6.0-8.0-5.0-2.0-7.0-9.0-4.0-6.0-8.0-5.0-2.0-7.0-9.0-4.0-2.1-5.1-2.0-1.0"	154	"HG03486#2#JAHEOP010000248.1_2105565_2584784_1"	199638	208430
"ENST00000370083.9"	1785	2	1784	"+"	"HG03486#2#JAHEOP010000248.1_2105565_2584784_1"	479219	272048	280840	1769	8792	0	"S"	557	1686	NA	1e-04	0	"HG03486#2#JAHEOP010000248.1_2105565_2584784_1"	"AMY1A-201"	"1"	"HG03486"	"0-3-7-9-4-6-8-5-2-7-9-4-6-8-5-2-7-9-4-2-5-2-1"	"0.0-3.0-7.0-9.0-4.0-6.0-8.0-5.0-2.0-7.0-9.0-4.0-6.0-8.0-5.0-2.0-7.0-9.0-4.0-2.1-5.1-2.0-1.0"	154	"HG03486#2#JAHEOP010000248.1_2105565_2584784_1"	272048	280840
"ENST00000370083.9"	1785	2	1784	"-"	"HG03486#2#JAHEOP010000248.1_2105565_2584784_1"	479219	303702	312493	1769	8791	0	"S"	557	1686	NA	1e-04	0	"HG03486#2#JAHEOP010000248.1_2105565_2584784_1"	"AMY1A-201"	"1"	"HG03486"	"0-3-7-9-4-6-8-5-2-7-9-4-6-8-5-2-7-9-4-2-5-2-1"	"0.0-3.0-7.0-9.0-4.0-6.0-8.0-5.0-2.0-7.0-9.0-4.0-6.0-8.0-5.0-2.0-7.0-9.0-4.0-2.1-5.1-2.0-1.0"	154	"HG03486#2#JAHEOP010000248.1_2105565_2584784_1"	303702	312493
"ENST00000370083.9"	1785	2	1784	"+"	"HG03486#2#JAHEOP010000248.1_2105565_2584784_1"	479219	366167	374956	1769	8789	0	"S"	557	1686	NA	1e-04	0	"HG03486#2#JAHEOP010000248.1_2105565_2584784_1"	"AMY1A-201"	"1"	"HG03486"	"0-3-7-9-4-6-8-5-2-7-9-4-6-8-5-2-7-9-4-2-5-2-1"	"0.0-3.0-7.0-9.0-4.0-6.0-8.0-5.0-2.0-7.0-9.0-4.0-6.0-8.0-5.0-2.0-7.0-9.0-4.0-2.1-5.1-2.0-1.0"	154	"HG03486#2#JAHEOP010000248.1_2105565_2584784_1"	366167	374956
"ENST00000414303.7"	1584	4	1583	"+"	"HG03486#2#JAHEOP010000248.1_2105565_2584784_1"	479219	233799	242069	1569	8270	0	"P"	486	1494	1494	8e-04	0	"HG03486#2#JAHEOP010000248.1_2105565_2584784_1"	"AMY2A-201"	"2A"	"HG03486"	"0-3-7-9-4-6-8-5-2-7-9-4-6-8-5-2-7-9-4-2-5-2-1"	"0.0-3.0-7.0-9.0-4.0-6.0-8.0-5.0-2.0-7.0-9.0-4.0-6.0-8.0-5.0-2.0-7.0-9.0-4.0-2.1-5.1-2.0-1.0"	154	"HG03486#2#JAHEOP010000248.1_2105565_2584784_1"	233799	242069
"ENST00000414303.7"	1584	4	1583	"+"	"HG03486#2#JAHEOP010000248.1_2105565_2584784_1"	479219	161381	169651	1569	8270	0	"S"	486	1494	NA	8e-04	0	"HG03486#2#JAHEOP010000248.1_2105565_2584784_1"	"AMY2A-201"	"2A"	"HG03486"	"0-3-7-9-4-6-8-5-2-7-9-4-6-8-5-2-7-9-4-2-5-2-1"	"0.0-3.0-7.0-9.0-4.0-6.0-8.0-5.0-2.0-7.0-9.0-4.0-6.0-8.0-5.0-2.0-7.0-9.0-4.0-2.1-5.1-2.0-1.0"	154	"HG03486#2#JAHEOP010000248.1_2105565_2584784_1"	161381	169651
"ENST00000610648.1"	1736	4	1733	"+"	"HG03486#2#JAHEOP010000248.1_2105565_2584784_1"	479219	115050	123470	1720	8420	48	"P"	531	1638	1371	1e-04	0	"HG03486#2#JAHEOP010000248.1_2105565_2584784_1"	"AMY2B-208"	"2B"	"HG03486"	"0-3-7-9-4-6-8-5-2-7-9-4-6-8-5-2-7-9-4-2-5-2-1"	"0.0-3.0-7.0-9.0-4.0-6.0-8.0-5.0-2.0-7.0-9.0-4.0-6.0-8.0-5.0-2.0-7.0-9.0-4.0-2.1-5.1-2.0-1.0"	154	"HG03486#2#JAHEOP010000248.1_2105565_2584784_1"	115050	123470
"ENST00000370083.9"	1785	2	1784	"+"	"HG01258#1#JAGYYV010000004.1_56955948_57456952_1"	501004	293820	302612	1769	8792	0	"P"	557	1686	1686	1e-04	0	"HG01258#1#JAGYYV010000004.1_56955948_57456952_1"	"AMY1A-201"	"1"	"HG01258"	"0-3-7-9-4-6-8-5-2-4-9-7-2-5-2-7-9-4-2-5-2-1"	"0.0-3.0-7.0-9.0-4.0-6.0-8.0-5.0-2.0-4.1-9.1-7.1-2.1-5.0-2.0-7.0-9.0-4.0-2.1-5.0-2.0-1.0"	155	"HG01258#1#JAGYYV010000004.1_56955948_57456952_1"	293820	302612
"ENST00000370083.9"	1785	2	1784	"-"	"HG01258#1#JAGYYV010000004.1_56955948_57456952_1"	501004	325475	334268	1769	8793	0	"S"	557	1686	NA	1e-04	0	"HG01258#1#JAGYYV010000004.1_56955948_57456952_1"	"AMY1A-201"	"1"	"HG01258"	"0-3-7-9-4-6-8-5-2-4-9-7-2-5-2-7-9-4-2-5-2-1"	"0.0-3.0-7.0-9.0-4.0-6.0-8.0-5.0-2.0-4.1-9.1-7.1-2.1-5.0-2.0-7.0-9.0-4.0-2.1-5.0-2.0-1.0"	155	"HG01258#1#JAGYYV010000004.1_56955948_57456952_1"	325475	334268
"ENST00000370083.9"	1785	2	1784	"+"	"HG01258#1#JAGYYV010000004.1_56955948_57456952_1"	501004	387949	396742	1769	8793	0	"S"	557	1686	NA	1e-04	0	"HG01258#1#JAGYYV010000004.1_56955948_57456952_1"	"AMY1A-201"	"1"	"HG01258"	"0-3-7-9-4-6-8-5-2-4-9-7-2-5-2-7-9-4-2-5-2-1"	"0.0-3.0-7.0-9.0-4.0-6.0-8.0-5.0-2.0-4.1-9.1-7.1-2.1-5.0-2.0-7.0-9.0-4.0-2.1-5.0-2.0-1.0"	155	"HG01258#1#JAGYYV010000004.1_56955948_57456952_1"	387949	396742
"ENST00000370083.9"	1785	2	1784	"+"	"HG01258#1#JAGYYV010000004.1_56955948_57456952_1"	501004	199693	208487	1769	8794	0	"S"	557	1686	NA	1e-04	0	"HG01258#1#JAGYYV010000004.1_56955948_57456952_1"	"AMY1A-201"	"1"	"HG01258"	"0-3-7-9-4-6-8-5-2-4-9-7-2-5-2-7-9-4-2-5-2-1"	"0.0-3.0-7.0-9.0-4.0-6.0-8.0-5.0-2.0-4.1-9.1-7.1-2.1-5.0-2.0-7.0-9.0-4.0-2.1-5.0-2.0-1.0"	155	"HG01258#1#JAGYYV010000004.1_56955948_57456952_1"	199693	208487
"ENST00000370083.9"	1785	2	1784	"-"	"HG01258#1#JAGYYV010000004.1_56955948_57456952_1"	501004	231352	240147	1768	8795	0	"S"	553	1685	NA	6e-04	0	"HG01258#1#JAGYYV010000004.1_56955948_57456952_1"	"AMY1A-201"	"1"	"HG01258"	"0-3-7-9-4-6-8-5-2-4-9-7-2-5-2-7-9-4-2-5-2-1"	"0.0-3.0-7.0-9.0-4.0-6.0-8.0-5.0-2.0-4.1-9.1-7.1-2.1-5.0-2.0-7.0-9.0-4.0-2.1-5.0-2.0-1.0"	155	"HG01258#1#JAGYYV010000004.1_56955948_57456952_1"	231352	240147
"ENST00000414303.7"	1584	4	1583	"+"	"HG01258#1#JAGYYV010000004.1_56955948_57456952_1"	501004	161440	169710	1574	8270	13	"P"	491	1499	1431	1e-04	0	"HG01258#1#JAGYYV010000004.1_56955948_57456952_1"	"AMY2A-201"	"2A"	"HG01258"	"0-3-7-9-4-6-8-5-2-4-9-7-2-5-2-7-9-4-2-5-2-1"	"0.0-3.0-7.0-9.0-4.0-6.0-8.0-5.0-2.0-4.1-9.1-7.1-2.1-5.0-2.0-7.0-9.0-4.0-2.1-5.0-2.0-1.0"	155	"HG01258#1#JAGYYV010000004.1_56955948_57456952_1"	161440	169710
"ENST00000610648.1"	1736	4	1733	"+"	"HG01258#1#JAGYYV010000004.1_56955948_57456952_1"	501004	115110	123534	1720	8424	48	"P"	531	1638	1371	1e-04	0	"HG01258#1#JAGYYV010000004.1_56955948_57456952_1"	"AMY2B-208"	"2B"	"HG01258"	"0-3-7-9-4-6-8-5-2-4-9-7-2-5-2-7-9-4-2-5-2-1"	"0.0-3.0-7.0-9.0-4.0-6.0-8.0-5.0-2.0-4.1-9.1-7.1-2.1-5.0-2.0-7.0-9.0-4.0-2.1-5.0-2.0-1.0"	155	"HG01258#1#JAGYYV010000004.1_56955948_57456952_1"	115110	123534
"ENST00000370083.9"	1785	2	1784	"+"	"HG02109#1#JAHEPG010000026.1_16673035_17080816_0"	407781	293735	302525	1769	8790	0	"P"	557	1686	1686	1e-04	0	"HG02109#1#JAHEPG010000026.1_16673035_17080816_0"	"AMY1A-201"	"1"	"HG02109"	"0-3-7-9-4-6-8-5-2-4-9-7-2-5-2-1"	"0.0-3.0-7.0-9.0-4.0-6.0-8.0-5.0-2.0-4.1-9.1-7.1-2.1-5.1-2.0-1.0"	98	"HG02109#1#JAHEPG010000026.1_16673035_17080816_0"	293735	302525
"ENST00000370083.9"	1785	2	1784	"-"	"HG02109#1#JAHEPG010000026.1_16673035_17080816_0"	407781	231273	240066	1769	8793	0	"S"	557	1686	NA	1e-04	0	"HG02109#1#JAHEPG010000026.1_16673035_17080816_0"	"AMY1A-201"	"1"	"HG02109"	"0-3-7-9-4-6-8-5-2-4-9-7-2-5-2-1"	"0.0-3.0-7.0-9.0-4.0-6.0-8.0-5.0-2.0-4.1-9.1-7.1-2.1-5.1-2.0-1.0"	98	"HG02109#1#JAHEPG010000026.1_16673035_17080816_0"	231273	240066
"ENST00000370083.9"	1785	2	1784	"+"	"HG02109#1#JAHEPG010000026.1_16673035_17080816_0"	407781	199620	208413	1769	8793	0	"S"	557	1686	NA	1e-04	0	"HG02109#1#JAHEPG010000026.1_16673035_17080816_0"	"AMY1A-201"	"1"	"HG02109"	"0-3-7-9-4-6-8-5-2-4-9-7-2-5-2-1"	"0.0-3.0-7.0-9.0-4.0-6.0-8.0-5.0-2.0-4.1-9.1-7.1-2.1-5.1-2.0-1.0"	98	"HG02109#1#JAHEPG010000026.1_16673035_17080816_0"	199620	208413
"ENST00000414303.7"	1584	4	1583	"+"	"HG02109#1#JAHEPG010000026.1_16673035_17080816_0"	407781	161367	169637	1569	8270	29	"P"	486	1494	1342	8e-04	0	"HG02109#1#JAHEPG010000026.1_16673035_17080816_0"	"AMY2A-201"	"2A"	"HG02109"	"0-3-7-9-4-6-8-5-2-4-9-7-2-5-2-1"	"0.0-3.0-7.0-9.0-4.0-6.0-8.0-5.0-2.0-4.1-9.1-7.1-2.1-5.1-2.0-1.0"	98	"HG02109#1#JAHEPG010000026.1_16673035_17080816_0"	161367	169637
"ENST00000610648.1"	1736	4	1733	"+"	"HG02109#1#JAHEPG010000026.1_16673035_17080816_0"	407781	115035	123455	1720	8420	48	"P"	531	1638	1371	1e-04	0	"HG02109#1#JAHEPG010000026.1_16673035_17080816_0"	"AMY2B-208"	"2B"	"HG02109"	"0-3-7-9-4-6-8-5-2-4-9-7-2-5-2-1"	"0.0-3.0-7.0-9.0-4.0-6.0-8.0-5.0-2.0-4.1-9.1-7.1-2.1-5.1-2.0-1.0"	98	"HG02109#1#JAHEPG010000026.1_16673035_17080816_0"	115035	123455
"ENST00000370083.9"	1785	2	1784	"+"	"HG02622#1#JAHAOO010000002.1_16673678_17080663_0"	406985	199725	208515	1769	8790	0	"P"	557	1686	1686	1e-04	0	"HG02622#1#JAHAOO010000002.1_16673678_17080663_0"	"AMY1A-201"	"1"	"HG02622"	"0-3-7-9-4-6-8-5-2-4-9-7-2-5-2-1"	"0.0-3.0-7.0-9.0-4.0-6.0-8.0-5.0-2.0-4.1-9.1-7.1-2.1-5.0-2.0-1.0"	98	"HG02622#1#JAHAOO010000002.1_16673678_17080663_0"	199725	208515
"ENST00000370083.9"	1785	2	1784	"+"	"HG02622#1#JAHAOO010000002.1_16673678_17080663_0"	406985	293847	302639	1769	8792	0	"S"	557	1686	NA	1e-04	0	"HG02622#1#JAHAOO010000002.1_16673678_17080663_0"	"AMY1A-201"	"1"	"HG02622"	"0-3-7-9-4-6-8-5-2-4-9-7-2-5-2-1"	"0.0-3.0-7.0-9.0-4.0-6.0-8.0-5.0-2.0-4.1-9.1-7.1-2.1-5.0-2.0-1.0"	98	"HG02622#1#JAHAOO010000002.1_16673678_17080663_0"	293847	302639
"ENST00000370083.9"	1785	2	1784	"-"	"HG02622#1#JAHAOO010000002.1_16673678_17080663_0"	406985	231376	240167	1769	8791	0	"S"	557	1686	NA	1e-04	0	"HG02622#1#JAHAOO010000002.1_16673678_17080663_0"	"AMY1A-201"	"1"	"HG02622"	"0-3-7-9-4-6-8-5-2-4-9-7-2-5-2-1"	"0.0-3.0-7.0-9.0-4.0-6.0-8.0-5.0-2.0-4.1-9.1-7.1-2.1-5.0-2.0-1.0"	98	"HG02622#1#JAHAOO010000002.1_16673678_17080663_0"	231376	240167
"ENST00000414303.7"	1584	4	1583	"+"	"HG02622#1#JAHAOO010000002.1_16673678_17080663_0"	406985	161427	169732	1568	8305	29	"P"	486	1493	1342	8e-04	0	"HG02622#1#JAHAOO010000002.1_16673678_17080663_0"	"AMY2A-201"	"2A"	"HG02622"	"0-3-7-9-4-6-8-5-2-4-9-7-2-5-2-1"	"0.0-3.0-7.0-9.0-4.0-6.0-8.0-5.0-2.0-4.1-9.1-7.1-2.1-5.0-2.0-1.0"	98	"HG02622#1#JAHAOO010000002.1_16673678_17080663_0"	161427	169732
"ENST00000610648.1"	1736	4	1733	"+"	"HG02622#1#JAHAOO010000002.1_16673678_17080663_0"	406985	115072	123494	1720	8422	48	"P"	531	1638	1371	1e-04	0	"HG02622#1#JAHAOO010000002.1_16673678_17080663_0"	"AMY2B-208"	"2B"	"HG02622"	"0-3-7-9-4-6-8-5-2-4-9-7-2-5-2-1"	"0.0-3.0-7.0-9.0-4.0-6.0-8.0-5.0-2.0-4.1-9.1-7.1-2.1-5.0-2.0-1.0"	98	"HG02622#1#JAHAOO010000002.1_16673678_17080663_0"	115072	123494
"ENST00000370083.9"	1785	2	1784	"-"	"HG03540#2#JAGYVX010000148.1_1368955_1877115_0"	508160	331592	340383	1769	8791	0	"P"	557	1686	1686	1e-04	0	"HG03540#2#JAGYVX010000148.1_1368955_1877115_0"	"AMY1A-201"	"1"	"HG03540"	"0-3-7-9-4-6-8-5-2-4-4-2-5-2-4-4-2-5-2-1"	"0.0-3.0-7.0-9.0-4.0-6.0-8.0-5.0-2.0-4.1-4.0-2.1-5.0-2.0-4.1-4.0-2.1-5.1-2.0-1.0"	98	"HG03540#2#JAGYVX010000148.1_1368955_1877115_0"	331592	340383
"ENST00000370083.9"	1785	2	1784	"+"	"HG03540#2#JAGYVX010000148.1_1368955_1877115_0"	508160	394069	402861	1769	8792	0	"S"	557	1686	NA	1e-04	0	"HG03540#2#JAGYVX010000148.1_1368955_1877115_0"	"AMY1A-201"	"1"	"HG03540"	"0-3-7-9-4-6-8-5-2-4-4-2-5-2-4-4-2-5-2-1"	"0.0-3.0-7.0-9.0-4.0-6.0-8.0-5.0-2.0-4.1-4.0-2.1-5.0-2.0-4.1-4.0-2.1-5.1-2.0-1.0"	98	"HG03540#2#JAGYVX010000148.1_1368955_1877115_0"	394069	402861
"ENST00000370083.9"	1785	2	1784	"+"	"HG03540#2#JAGYVX010000148.1_1368955_1877115_0"	508160	200028	208819	1769	8791	0	"S"	557	1686	NA	1e-04	0	"HG03540#2#JAGYVX010000148.1_1368955_1877115_0"	"AMY1A-201"	"1"	"HG03540"	"0-3-7-9-4-6-8-5-2-4-4-2-5-2-4-4-2-5-2-1"	"0.0-3.0-7.0-9.0-4.0-6.0-8.0-5.0-2.0-4.1-4.0-2.1-5.0-2.0-4.1-4.0-2.1-5.1-2.0-1.0"	98	"HG03540#2#JAGYVX010000148.1_1368955_1877115_0"	200028	208819
"ENST00000370083.9"	1785	2	1784	"+"	"HG03540#2#JAGYVX010000148.1_1368955_1877115_0"	508160	297032	305832	1767	8800	0	"S"	552	1684	NA	7e-04	0	"HG03540#2#JAGYVX010000148.1_1368955_1877115_0"	"AMY1A-201"	"1"	"HG03540"	"0-3-7-9-4-6-8-5-2-4-4-2-5-2-4-4-2-5-2-1"	"0.0-3.0-7.0-9.0-4.0-6.0-8.0-5.0-2.0-4.1-4.0-2.1-5.0-2.0-4.1-4.0-2.1-5.1-2.0-1.0"	98	"HG03540#2#JAGYVX010000148.1_1368955_1877115_0"	297032	305832
"ENST00000370083.9"	1785	2	1784	"-"	"HG03540#2#JAGYVX010000148.1_1368955_1877115_0"	508160	234573	243352	1759	8779	0	"S"	546	1676	NA	0.0014	0	"HG03540#2#JAGYVX010000148.1_1368955_1877115_0"	"AMY1A-201"	"1"	"HG03540"	"0-3-7-9-4-6-8-5-2-4-4-2-5-2-4-4-2-5-2-1"	"0.0-3.0-7.0-9.0-4.0-6.0-8.0-5.0-2.0-4.1-4.0-2.1-5.0-2.0-4.1-4.0-2.1-5.1-2.0-1.0"	98	"HG03540#2#JAGYVX010000148.1_1368955_1877115_0"	234573	243352
"ENST00000414303.7"	1584	4	1583	"+"	"HG03540#2#JAGYVX010000148.1_1368955_1877115_0"	508160	161767	170037	1563	8270	27	"P"	488	1488	1348	5e-04	0	"HG03540#2#JAGYVX010000148.1_1368955_1877115_0"	"AMY2A-201"	"2A"	"HG03540"	"0-3-7-9-4-6-8-5-2-4-4-2-5-2-4-4-2-5-2-1"	"0.0-3.0-7.0-9.0-4.0-6.0-8.0-5.0-2.0-4.1-4.0-2.1-5.0-2.0-4.1-4.0-2.1-5.1-2.0-1.0"	98	"HG03540#2#JAGYVX010000148.1_1368955_1877115_0"	161767	170037
"ENST00000610648.1"	1736	4	1733	"+"	"HG03540#2#JAGYVX010000148.1_1368955_1877115_0"	508160	115090	123512	1718	8422	47	"P"	527	1636	1371	1e-04	0	"HG03540#2#JAGYVX010000148.1_1368955_1877115_0"	"AMY2B-208"	"2B"	"HG03540"	"0-3-7-9-4-6-8-5-2-4-4-2-5-2-4-4-2-5-2-1"	"0.0-3.0-7.0-9.0-4.0-6.0-8.0-5.0-2.0-4.1-4.0-2.1-5.0-2.0-4.1-4.0-2.1-5.1-2.0-1.0"	98	"HG03540#2#JAGYVX010000148.1_1368955_1877115_0"	115090	123512
"ENST00000370083.9"	1785	2	1784	"+"	"HG02886#2#JAHAOT010000031.1_87393_401061_0"	313668	199623	208414	1769	8791	50	"P"	557	1686	1398	1e-04	0	"HG02886#2#JAHAOT010000031.1_87393_401061_0"	"AMY1A-201"	"1"	"HG02886"	"0-3-7-9-4-6-8-5-2-1"	"0.0-3.0-7.0-9.0-4.0-6.0-8.0-5.0-2.0-1.0"	98	"HG02886#2#JAHAOT010000031.1_87393_401061_0"	199623	208414
"ENST00000414303.7"	1584	4	1579	"+"	"HG02886#2#JAHAOT010000031.1_87393_401061_0"	313668	161362	169628	1563	8266	28	"P"	484	1488	1342	0.001	0	"HG02886#2#JAHAOT010000031.1_87393_401061_0"	"AMY2A-201"	"2A"	"HG02886"	"0-3-7-9-4-6-8-5-2-1"	"0.0-3.0-7.0-9.0-4.0-6.0-8.0-5.0-2.0-1.0"	98	"HG02886#2#JAHAOT010000031.1_87393_401061_0"	161362	169628
"ENST00000610648.1"	1736	4	1733	"+"	"HG02886#2#JAHAOT010000031.1_87393_401061_0"	313668	115034	123456	1720	8422	51	"P"	531	1638	1351	1e-04	0	"HG02886#2#JAHAOT010000031.1_87393_401061_0"	"AMY2B-208"	"2B"	"HG02886"	"0-3-7-9-4-6-8-5-2-1"	"0.0-3.0-7.0-9.0-4.0-6.0-8.0-5.0-2.0-1.0"	98	"HG02886#2#JAHAOT010000031.1_87393_401061_0"	115034	123456
"ENST00000370083.9"	1785	2	1784	"+"	"HG01243#1#JAHEOY010000013.1_90081_424495_0"	334414	221339	230129	1769	8790	0	"P"	557	1686	1686	1e-04	0	"HG01243#1#JAHEOY010000013.1_90081_424495_0"	"AMY1A-201"	"1"	"HG01243"	"0-3-7-9-4-2-5-2-1"	"0.0-3.0-7.0-9.0-4.0-2.1-5.1-2.0-1.0"	98	"HG01243#1#JAHEOY010000013.1_90081_424495_0"	221339	230129
"ENST00000370083.9"	1785	2	1784	"-"	"HG01243#1#JAHEOY010000013.1_90081_424495_0"	334414	158859	167652	1769	8793	0	"S"	557	1686	NA	1e-04	0	"HG01243#1#JAHEOY010000013.1_90081_424495_0"	"AMY1A-201"	"1"	"HG01243"	"0-3-7-9-4-2-5-2-1"	"0.0-3.0-7.0-9.0-4.0-2.1-5.1-2.0-1.0"	98	"HG01243#1#JAHEOY010000013.1_90081_424495_0"	158859	167652
"ENST00000610648.1"	1736	4	1733	"+"	"HG01243#1#JAHEOY010000013.1_90081_424495_0"	334414	115035	123457	1720	8422	48	"P"	531	1638	1371	1e-04	0	"HG01243#1#JAHEOY010000013.1_90081_424495_0"	"AMY2B-208"	"2B"	"HG01243"	"0-3-7-9-4-2-5-2-1"	"0.0-3.0-7.0-9.0-4.0-2.1-5.1-2.0-1.0"	98	"HG01243#1#JAHEOY010000013.1_90081_424495_0"	115035	123457
"ENST00000370083.9"	1785	2	1784	"+"	"HG03098#1#JAHEPM010000059.1_16676208_17105596_0"	429388	315351	324145	1769	8794	1	"P"	557	1686	1679	1e-04	0	"HG03098#1#JAHEPM010000059.1_16676208_17105596_0"	"AMY1A-201"	"1"	"HG03098"	"0-3-7-9-4-6-8-5-2-4-0-3-7-9-4-6-8-5-2-1"	"0.0-3.0-7.0-9.0-4.0-6.0-8.0-5.0-2.0-4.1-0.0-3.0-7.0-9.0-4.0-6.0-8.0-5.0-2.0-1.0"	98	"HG03098#1#JAHEPM010000059.1_16676208_17105596_0"	315351	324145
"ENST00000370083.9"	1785	2	1784	"+"	"HG03098#1#JAHEPM010000059.1_16676208_17105596_0"	429388	199605	208385	1762	8780	0	"S"	545	1679	NA	0.0016	0	"HG03098#1#JAHEPM010000059.1_16676208_17105596_0"	"AMY1A-201"	"1"	"HG03098"	"0-3-7-9-4-6-8-5-2-4-0-3-7-9-4-6-8-5-2-1"	"0.0-3.0-7.0-9.0-4.0-6.0-8.0-5.0-2.0-4.1-0.0-3.0-7.0-9.0-4.0-6.0-8.0-5.0-2.0-1.0"	98	"HG03098#1#JAHEPM010000059.1_16676208_17105596_0"	199605	208385
"ENST00000414303.7"	1584	4	1583	"+"	"HG03098#1#JAHEPM010000059.1_16676208_17105596_0"	429388	161342	169612	1563	8270	0	"P"	488	1488	1488	5e-04	0	"HG03098#1#JAHEPM010000059.1_16676208_17105596_0"	"AMY2A-201"	"2A"	"HG03098"	"0-3-7-9-4-6-8-5-2-4-0-3-7-9-4-6-8-5-2-1"	"0.0-3.0-7.0-9.0-4.0-6.0-8.0-5.0-2.0-4.1-0.0-3.0-7.0-9.0-4.0-6.0-8.0-5.0-2.0-1.0"	98	"HG03098#1#JAHEPM010000059.1_16676208_17105596_0"	161342	169612
"ENST00000414303.7"	1584	4	1583	"+"	"HG03098#1#JAHEPM010000059.1_16676208_17105596_0"	429388	277092	285362	1563	8270	0	"S"	488	1488	NA	5e-04	0	"HG03098#1#JAHEPM010000059.1_16676208_17105596_0"	"AMY2A-201"	"2A"	"HG03098"	"0-3-7-9-4-6-8-5-2-4-0-3-7-9-4-6-8-5-2-1"	"0.0-3.0-7.0-9.0-4.0-6.0-8.0-5.0-2.0-4.1-0.0-3.0-7.0-9.0-4.0-6.0-8.0-5.0-2.0-1.0"	98	"HG03098#1#JAHEPM010000059.1_16676208_17105596_0"	277092	285362
"ENST00000610648.1"	1736	4	1733	"+"	"HG03098#1#JAHEPM010000059.1_16676208_17105596_0"	429388	115005	123427	1720	8422	2	"P"	531	1638	1626	1e-04	0	"HG03098#1#JAHEPM010000059.1_16676208_17105596_0"	"AMY2B-208"	"2B"	"HG03098"	"0-3-7-9-4-6-8-5-2-4-0-3-7-9-4-6-8-5-2-1"	"0.0-3.0-7.0-9.0-4.0-6.0-8.0-5.0-2.0-4.1-0.0-3.0-7.0-9.0-4.0-6.0-8.0-5.0-2.0-1.0"	98	"HG03098#1#JAHEPM010000059.1_16676208_17105596_0"	115005	123427
"ENST00000610648.1"	1736	4	1733	"+"	"HG03098#1#JAHEPM010000059.1_16676208_17105596_0"	429388	230755	239177	1708	8422	0	"S"	527	1626	NA	6e-04	0	"HG03098#1#JAHEPM010000059.1_16676208_17105596_0"	"AMY2B-208"	"2B"	"HG03098"	"0-3-7-9-4-6-8-5-2-4-0-3-7-9-4-6-8-5-2-1"	"0.0-3.0-7.0-9.0-4.0-6.0-8.0-5.0-2.0-4.1-0.0-3.0-7.0-9.0-4.0-6.0-8.0-5.0-2.0-1.0"	98	"HG03098#1#JAHEPM010000059.1_16676208_17105596_0"	230755	239177
"ENST00000370083.9"	1785	2	1784	"-"	"NA18906#1#JAHEOO010000054.1_2103477_2510435_1"	406958	231417	240208	1769	8791	0	"P"	557	1686	1686	1e-04	0	"NA18906#1#JAHEOO010000054.1_2103477_2510435_1"	"AMY1A-201"	"1"	"NA18906"	"0-3-7-9-4-6-8-5-2-4-9-7-2-5-2-1"	"0.0-3.0-7.0-9.0-4.0-6.0-8.0-5.0-2.0-4.1-9.1-7.1-2.1-5.0-2.0-1.0"	154	"NA18906#1#JAHEOO010000054.1_2103477_2510435_1"	231417	240208
"ENST00000370083.9"	1785	2	1784	"+"	"NA18906#1#JAHEOO010000054.1_2103477_2510435_1"	406958	293881	302672	1769	8791	0	"S"	557	1686	NA	1e-04	0	"NA18906#1#JAHEOO010000054.1_2103477_2510435_1"	"AMY1A-201"	"1"	"NA18906"	"0-3-7-9-4-6-8-5-2-4-9-7-2-5-2-1"	"0.0-3.0-7.0-9.0-4.0-6.0-8.0-5.0-2.0-4.1-9.1-7.1-2.1-5.0-2.0-1.0"	154	"NA18906#1#JAHEOO010000054.1_2103477_2510435_1"	293881	302672
"ENST00000370083.9"	1785	2	1784	"+"	"NA18906#1#JAHEOO010000054.1_2103477_2510435_1"	406958	199767	208557	1769	8790	0	"S"	557	1686	NA	1e-04	0	"NA18906#1#JAHEOO010000054.1_2103477_2510435_1"	"AMY1A-201"	"1"	"NA18906"	"0-3-7-9-4-6-8-5-2-4-9-7-2-5-2-1"	"0.0-3.0-7.0-9.0-4.0-6.0-8.0-5.0-2.0-4.1-9.1-7.1-2.1-5.0-2.0-1.0"	154	"NA18906#1#JAHEOO010000054.1_2103477_2510435_1"	199767	208557
"ENST00000414303.7"	1584	4	1583	"+"	"NA18906#1#JAHEOO010000054.1_2103477_2510435_1"	406958	161455	169760	1568	8305	29	"P"	486	1493	1342	8e-04	0	"NA18906#1#JAHEOO010000054.1_2103477_2510435_1"	"AMY2A-201"	"2A"	"NA18906"	"0-3-7-9-4-6-8-5-2-4-9-7-2-5-2-1"	"0.0-3.0-7.0-9.0-4.0-6.0-8.0-5.0-2.0-4.1-9.1-7.1-2.1-5.0-2.0-1.0"	154	"NA18906#1#JAHEOO010000054.1_2103477_2510435_1"	161455	169760
"ENST00000610648.1"	1736	4	1733	"+"	"NA18906#1#JAHEOO010000054.1_2103477_2510435_1"	406958	115097	123519	1720	8422	48	"P"	531	1638	1371	1e-04	0	"NA18906#1#JAHEOO010000054.1_2103477_2510435_1"	"AMY2B-208"	"2B"	"NA18906"	"0-3-7-9-4-6-8-5-2-4-9-7-2-5-2-1"	"0.0-3.0-7.0-9.0-4.0-6.0-8.0-5.0-2.0-4.1-9.1-7.1-2.1-5.0-2.0-1.0"	154	"NA18906#1#JAHEOO010000054.1_2103477_2510435_1"	115097	123519
"ENST00000370083.9"	1785	2	1784	"+"	"HG01109#2#JAHEOZ010000047.1_16671232_17151375_0"	480143	366087	374877	1769	8790	0	"P"	557	1686	1686	1e-04	0	"HG01109#2#JAHEOZ010000047.1_16671232_17151375_0"	"AMY1A-201"	"1"	"HG01109"	"0-3-7-9-4-6-8-5-2-7-9-4-6-8-5-2-7-4-2-5-2-1"	"0.0-3.0-7.0-9.0-4.0-6.0-8.0-5.0-2.0-7.0-9.0-4.0-6.0-8.0-5.0-2.0-7.0-4.0-2.1-5.0-2.0-1.0"	98	"HG01109#2#JAHEOZ010000047.1_16671232_17151375_0"	366087	374877
"ENST00000370083.9"	1785	2	1784	"-"	"HG01109#2#JAHEOZ010000047.1_16671232_17151375_0"	480143	303623	312412	1769	8789	0	"S"	557	1686	NA	1e-04	0	"HG01109#2#JAHEOZ010000047.1_16671232_17151375_0"	"AMY1A-201"	"1"	"HG01109"	"0-3-7-9-4-6-8-5-2-7-9-4-6-8-5-2-7-4-2-5-2-1"	"0.0-3.0-7.0-9.0-4.0-6.0-8.0-5.0-2.0-7.0-9.0-4.0-6.0-8.0-5.0-2.0-7.0-4.0-2.1-5.0-2.0-1.0"	98	"HG01109#2#JAHEOZ010000047.1_16671232_17151375_0"	303623	312412
"ENST00000370083.9"	1785	2	1784	"+"	"HG01109#2#JAHEOZ010000047.1_16671232_17151375_0"	480143	271965	280757	1769	8792	0	"S"	557	1686	NA	1e-04	0	"HG01109#2#JAHEOZ010000047.1_16671232_17151375_0"	"AMY1A-201"	"1"	"HG01109"	"0-3-7-9-4-6-8-5-2-7-9-4-6-8-5-2-7-4-2-5-2-1"	"0.0-3.0-7.0-9.0-4.0-6.0-8.0-5.0-2.0-7.0-9.0-4.0-6.0-8.0-5.0-2.0-7.0-4.0-2.1-5.0-2.0-1.0"	98	"HG01109#2#JAHEOZ010000047.1_16671232_17151375_0"	271965	280757
"ENST00000370083.9"	1785	2	1784	"+"	"HG01109#2#JAHEOZ010000047.1_16671232_17151375_0"	480143	199563	208355	1769	8792	0	"S"	557	1686	NA	1e-04	0	"HG01109#2#JAHEOZ010000047.1_16671232_17151375_0"	"AMY1A-201"	"1"	"HG01109"	"0-3-7-9-4-6-8-5-2-7-9-4-6-8-5-2-7-4-2-5-2-1"	"0.0-3.0-7.0-9.0-4.0-6.0-8.0-5.0-2.0-7.0-9.0-4.0-6.0-8.0-5.0-2.0-7.0-4.0-2.1-5.0-2.0-1.0"	98	"HG01109#2#JAHEOZ010000047.1_16671232_17151375_0"	199563	208355
"ENST00000414303.7"	1584	4	1583	"+"	"HG01109#2#JAHEOZ010000047.1_16671232_17151375_0"	480143	233718	241981	1571	8263	0	"P"	486	1496	1494	8e-04	0	"HG01109#2#JAHEOZ010000047.1_16671232_17151375_0"	"AMY2A-201"	"2A"	"HG01109"	"0-3-7-9-4-6-8-5-2-7-9-4-6-8-5-2-7-4-2-5-2-1"	"0.0-3.0-7.0-9.0-4.0-6.0-8.0-5.0-2.0-7.0-9.0-4.0-6.0-8.0-5.0-2.0-7.0-4.0-2.1-5.0-2.0-1.0"	98	"HG01109#2#JAHEOZ010000047.1_16671232_17151375_0"	233718	241981
"ENST00000414303.7"	1584	4	1583	"+"	"HG01109#2#JAHEOZ010000047.1_16671232_17151375_0"	480143	161319	169582	1569	8263	0	"S"	486	1494	NA	8e-04	0	"HG01109#2#JAHEOZ010000047.1_16671232_17151375_0"	"AMY2A-201"	"2A"	"HG01109"	"0-3-7-9-4-6-8-5-2-7-9-4-6-8-5-2-7-4-2-5-2-1"	"0.0-3.0-7.0-9.0-4.0-6.0-8.0-5.0-2.0-7.0-9.0-4.0-6.0-8.0-5.0-2.0-7.0-4.0-2.1-5.0-2.0-1.0"	98	"HG01109#2#JAHEOZ010000047.1_16671232_17151375_0"	161319	169582
"ENST00000610648.1"	1736	4	1733	"+"	"HG01109#2#JAHEOZ010000047.1_16671232_17151375_0"	480143	114993	123415	1720	8422	45	"P"	531	1638	1386	1e-04	0	"HG01109#2#JAHEOZ010000047.1_16671232_17151375_0"	"AMY2B-208"	"2B"	"HG01109"	"0-3-7-9-4-6-8-5-2-7-9-4-6-8-5-2-7-4-2-5-2-1"	"0.0-3.0-7.0-9.0-4.0-6.0-8.0-5.0-2.0-7.0-9.0-4.0-6.0-8.0-5.0-2.0-7.0-4.0-2.1-5.0-2.0-1.0"	98	"HG01109#2#JAHEOZ010000047.1_16671232_17151375_0"	114993	123415
"ENST00000370083.9"	1785	2	1784	"-"	"HG01978#2#JAGYVR010000007.1_51532241_51939176_0"	406935	231280	240073	1769	8793	0	"P"	557	1686	1686	1e-04	0	"HG01978#2#JAGYVR010000007.1_51532241_51939176_0"	"AMY1A-201"	"1"	"HG01978"	"0-3-7-9-4-6-8-5-2-4-9-7-2-5-2-1"	"0.0-3.0-7.0-9.0-4.0-6.0-8.0-5.0-2.0-4.1-9.1-7.1-2.1-5.1-2.0-1.0"	99	"HG01978#2#JAGYVR010000007.1_51532241_51939176_0"	231280	240073
"ENST00000370083.9"	1785	2	1784	"+"	"HG01978#2#JAGYVR010000007.1_51532241_51939176_0"	406935	293766	302558	1769	8792	0	"S"	557	1686	NA	1e-04	0	"HG01978#2#JAGYVR010000007.1_51532241_51939176_0"	"AMY1A-201"	"1"	"HG01978"	"0-3-7-9-4-6-8-5-2-4-9-7-2-5-2-1"	"0.0-3.0-7.0-9.0-4.0-6.0-8.0-5.0-2.0-4.1-9.1-7.1-2.1-5.1-2.0-1.0"	99	"HG01978#2#JAGYVR010000007.1_51532241_51939176_0"	293766	302558
"ENST00000370083.9"	1785	2	1784	"+"	"HG01978#2#JAGYVR010000007.1_51532241_51939176_0"	406935	199617	208410	1769	8793	0	"S"	557	1686	NA	1e-04	0	"HG01978#2#JAGYVR010000007.1_51532241_51939176_0"	"AMY1A-201"	"1"	"HG01978"	"0-3-7-9-4-6-8-5-2-4-9-7-2-5-2-1"	"0.0-3.0-7.0-9.0-4.0-6.0-8.0-5.0-2.0-4.1-9.1-7.1-2.1-5.1-2.0-1.0"	99	"HG01978#2#JAGYVR010000007.1_51532241_51939176_0"	199617	208410
"ENST00000414303.7"	1584	4	1583	"+"	"HG01978#2#JAGYVR010000007.1_51532241_51939176_0"	406935	161359	169629	1574	8270	30	"P"	491	1499	1342	1e-04	0	"HG01978#2#JAGYVR010000007.1_51532241_51939176_0"	"AMY2A-201"	"2A"	"HG01978"	"0-3-7-9-4-6-8-5-2-4-9-7-2-5-2-1"	"0.0-3.0-7.0-9.0-4.0-6.0-8.0-5.0-2.0-4.1-9.1-7.1-2.1-5.1-2.0-1.0"	99	"HG01978#2#JAGYVR010000007.1_51532241_51939176_0"	161359	169629
"ENST00000610648.1"	1736	4	1733	"+"	"HG01978#2#JAGYVR010000007.1_51532241_51939176_0"	406935	115029	123449	1720	8420	48	"P"	531	1638	1371	1e-04	0	"HG01978#2#JAGYVR010000007.1_51532241_51939176_0"	"AMY2B-208"	"2B"	"HG01978"	"0-3-7-9-4-6-8-5-2-4-9-7-2-5-2-1"	"0.0-3.0-7.0-9.0-4.0-6.0-8.0-5.0-2.0-4.1-9.1-7.1-2.1-5.1-2.0-1.0"	99	"HG01978#2#JAGYVR010000007.1_51532241_51939176_0"	115029	123449
"ENST00000370083.9"	1785	2	1784	"+"	"HG03516#1#JAGYYT010000012.1_24170958_24578778_1"	407820	199699	208490	1769	8791	0	"P"	557	1686	1686	1e-04	0	"HG03516#1#JAGYYT010000012.1_24170958_24578778_1"	"AMY1A-201"	"1"	"HG03516"	"0-3-7-9-4-6-8-5-2-7-9-4-2-5-2-1"	"0.0-3.0-7.0-9.0-4.0-6.0-8.0-5.0-2.0-7.0-9.0-4.0-2.1-5.1-2.0-1.0"	154	"HG03516#1#JAGYYT010000012.1_24170958_24578778_1"	199699	208490
"ENST00000370083.9"	1785	2	1784	"+"	"HG03516#1#JAGYYT010000012.1_24170958_24578778_1"	407820	293821	302612	1769	8791	0	"S"	557	1686	NA	1e-04	0	"HG03516#1#JAGYYT010000012.1_24170958_24578778_1"	"AMY1A-201"	"1"	"HG03516"	"0-3-7-9-4-6-8-5-2-7-9-4-2-5-2-1"	"0.0-3.0-7.0-9.0-4.0-6.0-8.0-5.0-2.0-7.0-9.0-4.0-2.1-5.1-2.0-1.0"	154	"HG03516#1#JAGYYT010000012.1_24170958_24578778_1"	293821	302612
"ENST00000370083.9"	1785	2	1784	"-"	"HG03516#1#JAGYYT010000012.1_24170958_24578778_1"	407820	231348	240139	1769	8791	0	"S"	557	1686	NA	1e-04	0	"HG03516#1#JAGYYT010000012.1_24170958_24578778_1"	"AMY1A-201"	"1"	"HG03516"	"0-3-7-9-4-6-8-5-2-7-9-4-2-5-2-1"	"0.0-3.0-7.0-9.0-4.0-6.0-8.0-5.0-2.0-7.0-9.0-4.0-2.1-5.1-2.0-1.0"	154	"HG03516#1#JAGYYT010000012.1_24170958_24578778_1"	231348	240139
"ENST00000414303.7"	1584	4	1579	"+"	"HG03516#1#JAGYYT010000012.1_24170958_24578778_1"	407820	161446	169712	1563	8266	28	"P"	484	1488	1342	0.001	0	"HG03516#1#JAGYYT010000012.1_24170958_24578778_1"	"AMY2A-201"	"2A"	"HG03516"	"0-3-7-9-4-6-8-5-2-7-9-4-2-5-2-1"	"0.0-3.0-7.0-9.0-4.0-6.0-8.0-5.0-2.0-7.0-9.0-4.0-2.1-5.1-2.0-1.0"	154	"HG03516#1#JAGYYT010000012.1_24170958_24578778_1"	161446	169712
"ENST00000610648.1"	1736	4	1733	"+"	"HG03516#1#JAGYYT010000012.1_24170958_24578778_1"	407820	115129	123551	1720	8422	48	"P"	531	1638	1371	1e-04	0	"HG03516#1#JAGYYT010000012.1_24170958_24578778_1"	"AMY2B-208"	"2B"	"HG03516"	"0-3-7-9-4-6-8-5-2-7-9-4-2-5-2-1"	"0.0-3.0-7.0-9.0-4.0-6.0-8.0-5.0-2.0-7.0-9.0-4.0-2.1-5.1-2.0-1.0"	154	"HG03516#1#JAGYYT010000012.1_24170958_24578778_1"	115129	123551
"ENST00000370083.9"	1785	2	1784	"+"	"HG02055#2#JAHEPJ010000017.1_24870122_25298560_1"	428438	199653	208433	1769	8780	0	"P"	557	1686	1686	1e-04	0	"HG02055#2#JAHEPJ010000017.1_24870122_25298560_1"	"AMY1A-201"	"1"	"HG02055"	"0-3-7-9-4-6-8-5-2-4-0-3-7-9-4-6-8-5-2-1"	"0.0-3.0-7.0-9.0-4.0-6.0-8.0-5.0-2.0-4.1-0.0-3.0-7.0-9.0-4.0-6.0-8.0-5.0-2.0-1.0"	154	"HG02055#2#JAHEPJ010000017.1_24870122_25298560_1"	199653	208433
"ENST00000370083.9"	1785	2	1784	"+"	"HG02055#2#JAHEPJ010000017.1_24870122_25298560_1"	428438	315399	324194	1769	8795	0	"S"	557	1686	NA	1e-04	0	"HG02055#2#JAHEPJ010000017.1_24870122_25298560_1"	"AMY1A-201"	"1"	"HG02055"	"0-3-7-9-4-6-8-5-2-4-0-3-7-9-4-6-8-5-2-1"	"0.0-3.0-7.0-9.0-4.0-6.0-8.0-5.0-2.0-4.1-0.0-3.0-7.0-9.0-4.0-6.0-8.0-5.0-2.0-1.0"	154	"HG02055#2#JAHEPJ010000017.1_24870122_25298560_1"	315399	324194
"ENST00000414303.7"	1584	4	1583	"+"	"HG02055#2#JAHEPJ010000017.1_24870122_25298560_1"	428438	161393	169663	1563	8270	0	"P"	488	1488	1488	5e-04	0	"HG02055#2#JAHEPJ010000017.1_24870122_25298560_1"	"AMY2A-201"	"2A"	"HG02055"	"0-3-7-9-4-6-8-5-2-4-0-3-7-9-4-6-8-5-2-1"	"0.0-3.0-7.0-9.0-4.0-6.0-8.0-5.0-2.0-4.1-0.0-3.0-7.0-9.0-4.0-6.0-8.0-5.0-2.0-1.0"	154	"HG02055#2#JAHEPJ010000017.1_24870122_25298560_1"	161393	169663
"ENST00000414303.7"	1584	4	1583	"+"	"HG02055#2#JAHEPJ010000017.1_24870122_25298560_1"	428438	277142	285412	1563	8270	0	"S"	488	1488	NA	5e-04	0	"HG02055#2#JAHEPJ010000017.1_24870122_25298560_1"	"AMY2A-201"	"2A"	"HG02055"	"0-3-7-9-4-6-8-5-2-4-0-3-7-9-4-6-8-5-2-1"	"0.0-3.0-7.0-9.0-4.0-6.0-8.0-5.0-2.0-4.1-0.0-3.0-7.0-9.0-4.0-6.0-8.0-5.0-2.0-1.0"	154	"HG02055#2#JAHEPJ010000017.1_24870122_25298560_1"	277142	285412
"ENST00000610648.1"	1736	4	1733	"+"	"HG02055#2#JAHEPJ010000017.1_24870122_25298560_1"	428438	115054	123476	1720	8422	2	"P"	531	1638	1626	1e-04	0	"HG02055#2#JAHEPJ010000017.1_24870122_25298560_1"	"AMY2B-208"	"2B"	"HG02055"	"0-3-7-9-4-6-8-5-2-4-0-3-7-9-4-6-8-5-2-1"	"0.0-3.0-7.0-9.0-4.0-6.0-8.0-5.0-2.0-4.1-0.0-3.0-7.0-9.0-4.0-6.0-8.0-5.0-2.0-1.0"	154	"HG02055#2#JAHEPJ010000017.1_24870122_25298560_1"	115054	123476
"ENST00000610648.1"	1736	4	1733	"+"	"HG02055#2#JAHEPJ010000017.1_24870122_25298560_1"	428438	230803	239225	1708	8422	0	"S"	527	1626	NA	6e-04	0	"HG02055#2#JAHEPJ010000017.1_24870122_25298560_1"	"AMY2B-208"	"2B"	"HG02055"	"0-3-7-9-4-6-8-5-2-4-0-3-7-9-4-6-8-5-2-1"	"0.0-3.0-7.0-9.0-4.0-6.0-8.0-5.0-2.0-4.1-0.0-3.0-7.0-9.0-4.0-6.0-8.0-5.0-2.0-1.0"	154	"HG02055#2#JAHEPJ010000017.1_24870122_25298560_1"	230803	239225
"ENST00000370083.9"	1785	2	1784	"+"	"HG005#2#JAHEPN010000023.1_51542210_51950070_0"	407860	199623	208415	1769	8792	0	"P"	557	1686	1686	1e-04	0	"HG005#2#JAHEPN010000023.1_51542210_51950070_0"	"AMY1A-201"	"1"	"HG005"	"0-3-7-9-4-6-8-5-2-4-9-7-2-5-2-1"	"0.0-3.0-7.0-9.0-4.0-6.0-8.0-5.0-2.0-4.1-9.1-7.1-2.1-5.0-2.0-1.0"	99	"HG005#2#JAHEPN010000023.1_51542210_51950070_0"	199623	208415
"ENST00000370083.9"	1785	2	1784	"+"	"HG005#2#JAHEPN010000023.1_51542210_51950070_0"	407860	293767	302559	1769	8792	0	"S"	557	1686	NA	1e-04	0	"HG005#2#JAHEPN010000023.1_51542210_51950070_0"	"AMY1A-201"	"1"	"HG005"	"0-3-7-9-4-6-8-5-2-4-9-7-2-5-2-1"	"0.0-3.0-7.0-9.0-4.0-6.0-8.0-5.0-2.0-4.1-9.1-7.1-2.1-5.0-2.0-1.0"	99	"HG005#2#JAHEPN010000023.1_51542210_51950070_0"	293767	302559
"ENST00000370083.9"	1785	2	1784	"-"	"HG005#2#JAHEPN010000023.1_51542210_51950070_0"	407860	231275	240068	1769	8793	0	"S"	557	1686	NA	1e-04	0	"HG005#2#JAHEPN010000023.1_51542210_51950070_0"	"AMY1A-201"	"1"	"HG005"	"0-3-7-9-4-6-8-5-2-4-9-7-2-5-2-1"	"0.0-3.0-7.0-9.0-4.0-6.0-8.0-5.0-2.0-4.1-9.1-7.1-2.1-5.0-2.0-1.0"	99	"HG005#2#JAHEPN010000023.1_51542210_51950070_0"	231275	240068
"ENST00000414303.7"	1584	4	1583	"+"	"HG005#2#JAHEPN010000023.1_51542210_51950070_0"	407860	161365	169635	1574	8270	30	"P"	491	1499	1342	1e-04	0	"HG005#2#JAHEPN010000023.1_51542210_51950070_0"	"AMY2A-201"	"2A"	"HG005"	"0-3-7-9-4-6-8-5-2-4-9-7-2-5-2-1"	"0.0-3.0-7.0-9.0-4.0-6.0-8.0-5.0-2.0-4.1-9.1-7.1-2.1-5.0-2.0-1.0"	99	"HG005#2#JAHEPN010000023.1_51542210_51950070_0"	161365	169635
"ENST00000610648.1"	1736	4	1733	"+"	"HG005#2#JAHEPN010000023.1_51542210_51950070_0"	407860	115040	123464	1720	8424	48	"P"	531	1638	1371	1e-04	0	"HG005#2#JAHEPN010000023.1_51542210_51950070_0"	"AMY2B-208"	"2B"	"HG005"	"0-3-7-9-4-6-8-5-2-4-9-7-2-5-2-1"	"0.0-3.0-7.0-9.0-4.0-6.0-8.0-5.0-2.0-4.1-9.1-7.1-2.1-5.0-2.0-1.0"	99	"HG005#2#JAHEPN010000023.1_51542210_51950070_0"	115040	123464
"ENST00000370083.9"	1785	2	1784	"+"	"HG02145#1#JAHKSG010000134.1_2102465_2647653_1"	545188	431198	439988	1769	8790	0	"P"	557	1686	1686	1e-04	0	"HG02145#1#JAHKSG010000134.1_2102465_2647653_1"	"AMY1A-201"	"1"	"HG02145"	"0-3-7-9-4-6-8-5-2-4-0-3-7-9-4-6-8-5-2-4-0-3-7-9-4-6-8-5-2-1"	"0.0-3.0-7.0-9.0-4.0-6.0-8.0-5.0-2.0-4.1-0.0-3.0-7.0-9.0-4.0-6.0-8.0-5.0-2.0-4.1-0.0-3.0-7.0-9.0-4.0-6.0-8.0-5.0-2.0-1.0"	154	"HG02145#1#JAHKSG010000134.1_2102465_2647653_1"	431198	439988
"ENST00000370083.9"	1785	2	1784	"+"	"HG02145#1#JAHKSG010000134.1_2102465_2647653_1"	545188	315448	324228	1769	8780	0	"S"	557	1686	NA	1e-04	0	"HG02145#1#JAHKSG010000134.1_2102465_2647653_1"	"AMY1A-201"	"1"	"HG02145"	"0-3-7-9-4-6-8-5-2-4-0-3-7-9-4-6-8-5-2-4-0-3-7-9-4-6-8-5-2-1"	"0.0-3.0-7.0-9.0-4.0-6.0-8.0-5.0-2.0-4.1-0.0-3.0-7.0-9.0-4.0-6.0-8.0-5.0-2.0-4.1-0.0-3.0-7.0-9.0-4.0-6.0-8.0-5.0-2.0-1.0"	154	"HG02145#1#JAHKSG010000134.1_2102465_2647653_1"	315448	324228
"ENST00000370083.9"	1785	2	1784	"+"	"HG02145#1#JAHKSG010000134.1_2102465_2647653_1"	545188	199706	208485	1769	8779	0	"S"	557	1686	NA	1e-04	0	"HG02145#1#JAHKSG010000134.1_2102465_2647653_1"	"AMY1A-201"	"1"	"HG02145"	"0-3-7-9-4-6-8-5-2-4-0-3-7-9-4-6-8-5-2-4-0-3-7-9-4-6-8-5-2-1"	"0.0-3.0-7.0-9.0-4.0-6.0-8.0-5.0-2.0-4.1-0.0-3.0-7.0-9.0-4.0-6.0-8.0-5.0-2.0-4.1-0.0-3.0-7.0-9.0-4.0-6.0-8.0-5.0-2.0-1.0"	154	"HG02145#1#JAHKSG010000134.1_2102465_2647653_1"	199706	208485
"ENST00000414303.7"	1584	4	1583	"+"	"HG02145#1#JAHKSG010000134.1_2102465_2647653_1"	545188	277194	285464	1563	8270	0	"P"	488	1488	1488	5e-04	0	"HG02145#1#JAHKSG010000134.1_2102465_2647653_1"	"AMY2A-201"	"2A"	"HG02145"	"0-3-7-9-4-6-8-5-2-4-0-3-7-9-4-6-8-5-2-4-0-3-7-9-4-6-8-5-2-1"	"0.0-3.0-7.0-9.0-4.0-6.0-8.0-5.0-2.0-4.1-0.0-3.0-7.0-9.0-4.0-6.0-8.0-5.0-2.0-4.1-0.0-3.0-7.0-9.0-4.0-6.0-8.0-5.0-2.0-1.0"	154	"HG02145#1#JAHKSG010000134.1_2102465_2647653_1"	277194	285464
"ENST00000414303.7"	1584	4	1583	"+"	"HG02145#1#JAHKSG010000134.1_2102465_2647653_1"	545188	161447	169717	1563	8270	0	"S"	488	1488	NA	5e-04	0	"HG02145#1#JAHKSG010000134.1_2102465_2647653_1"	"AMY2A-201"	"2A"	"HG02145"	"0-3-7-9-4-6-8-5-2-4-0-3-7-9-4-6-8-5-2-4-0-3-7-9-4-6-8-5-2-1"	"0.0-3.0-7.0-9.0-4.0-6.0-8.0-5.0-2.0-4.1-0.0-3.0-7.0-9.0-4.0-6.0-8.0-5.0-2.0-4.1-0.0-3.0-7.0-9.0-4.0-6.0-8.0-5.0-2.0-1.0"	154	"HG02145#1#JAHKSG010000134.1_2102465_2647653_1"	161447	169717
"ENST00000414303.7"	1584	4	1583	"+"	"HG02145#1#JAHKSG010000134.1_2102465_2647653_1"	545188	392939	401209	1563	8270	0	"S"	488	1488	NA	5e-04	0	"HG02145#1#JAHKSG010000134.1_2102465_2647653_1"	"AMY2A-201"	"2A"	"HG02145"	"0-3-7-9-4-6-8-5-2-4-0-3-7-9-4-6-8-5-2-4-0-3-7-9-4-6-8-5-2-1"	"0.0-3.0-7.0-9.0-4.0-6.0-8.0-5.0-2.0-4.1-0.0-3.0-7.0-9.0-4.0-6.0-8.0-5.0-2.0-4.1-0.0-3.0-7.0-9.0-4.0-6.0-8.0-5.0-2.0-1.0"	154	"HG02145#1#JAHKSG010000134.1_2102465_2647653_1"	392939	401209
"ENST00000610648.1"	1736	4	1733	"+"	"HG02145#1#JAHKSG010000134.1_2102465_2647653_1"	545188	346601	355023	1720	8422	0	"P"	531	1638	1638	1e-04	0	"HG02145#1#JAHKSG010000134.1_2102465_2647653_1"	"AMY2B-208"	"2B"	"HG02145"	"0-3-7-9-4-6-8-5-2-4-0-3-7-9-4-6-8-5-2-4-0-3-7-9-4-6-8-5-2-1"	"0.0-3.0-7.0-9.0-4.0-6.0-8.0-5.0-2.0-4.1-0.0-3.0-7.0-9.0-4.0-6.0-8.0-5.0-2.0-4.1-0.0-3.0-7.0-9.0-4.0-6.0-8.0-5.0-2.0-1.0"	154	"HG02145#1#JAHKSG010000134.1_2102465_2647653_1"	346601	355023
"ENST00000610648.1"	1736	4	1733	"+"	"HG02145#1#JAHKSG010000134.1_2102465_2647653_1"	545188	230856	239278	1720	8422	0	"S"	531	1638	NA	1e-04	0	"HG02145#1#JAHKSG010000134.1_2102465_2647653_1"	"AMY2B-208"	"2B"	"HG02145"	"0-3-7-9-4-6-8-5-2-4-0-3-7-9-4-6-8-5-2-4-0-3-7-9-4-6-8-5-2-1"	"0.0-3.0-7.0-9.0-4.0-6.0-8.0-5.0-2.0-4.1-0.0-3.0-7.0-9.0-4.0-6.0-8.0-5.0-2.0-4.1-0.0-3.0-7.0-9.0-4.0-6.0-8.0-5.0-2.0-1.0"	154	"HG02145#1#JAHKSG010000134.1_2102465_2647653_1"	230856	239278
"ENST00000610648.1"	1736	4	1733	"+"	"HG02145#1#JAHKSG010000134.1_2102465_2647653_1"	545188	115109	123531	1720	8422	0	"S"	531	1638	NA	1e-04	0	"HG02145#1#JAHKSG010000134.1_2102465_2647653_1"	"AMY2B-208"	"2B"	"HG02145"	"0-3-7-9-4-6-8-5-2-4-0-3-7-9-4-6-8-5-2-4-0-3-7-9-4-6-8-5-2-1"	"0.0-3.0-7.0-9.0-4.0-6.0-8.0-5.0-2.0-4.1-0.0-3.0-7.0-9.0-4.0-6.0-8.0-5.0-2.0-4.1-0.0-3.0-7.0-9.0-4.0-6.0-8.0-5.0-2.0-1.0"	154	"HG02145#1#JAHKSG010000134.1_2102465_2647653_1"	115109	123531
"ENST00000370083.9"	1785	2	1784	"+"	"HG03540#1#JAGYVY010000208.1_95187_596142_0"	500955	293744	302536	1769	8792	0	"P"	557	1686	1686	1e-04	0	"HG03540#1#JAGYVY010000208.1_95187_596142_0"	"AMY1A-201"	"1"	"HG03540"	"0-3-7-9-4-6-8-5-2-4-9-7-2-5-2-4-9-7-2-5-2-1"	"0.0-3.0-7.0-9.0-4.0-6.0-8.0-5.0-2.0-4.1-9.1-7.1-2.1-5.0-2.0-4.1-9.1-7.1-2.1-5.1-2.0-1.0"	98	"HG03540#1#JAGYVY010000208.1_95187_596142_0"	293744	302536
"ENST00000370083.9"	1785	2	1784	"+"	"HG03540#1#JAGYVY010000208.1_95187_596142_0"	500955	199606	208399	1769	8793	0	"S"	557	1686	NA	1e-04	0	"HG03540#1#JAGYVY010000208.1_95187_596142_0"	"AMY1A-201"	"1"	"HG03540"	"0-3-7-9-4-6-8-5-2-4-9-7-2-5-2-4-9-7-2-5-2-1"	"0.0-3.0-7.0-9.0-4.0-6.0-8.0-5.0-2.0-4.1-9.1-7.1-2.1-5.0-2.0-4.1-9.1-7.1-2.1-5.1-2.0-1.0"	98	"HG03540#1#JAGYVY010000208.1_95187_596142_0"	199606	208399
"ENST00000370083.9"	1785	2	1784	"+"	"HG03540#1#JAGYVY010000208.1_95187_596142_0"	500955	387871	396662	1769	8791	0	"S"	557	1686	NA	1e-04	0	"HG03540#1#JAGYVY010000208.1_95187_596142_0"	"AMY1A-201"	"1"	"HG03540"	"0-3-7-9-4-6-8-5-2-4-9-7-2-5-2-4-9-7-2-5-2-1"	"0.0-3.0-7.0-9.0-4.0-6.0-8.0-5.0-2.0-4.1-9.1-7.1-2.1-5.0-2.0-4.1-9.1-7.1-2.1-5.1-2.0-1.0"	98	"HG03540#1#JAGYVY010000208.1_95187_596142_0"	387871	396662
"ENST00000370083.9"	1785	2	1784	"-"	"HG03540#1#JAGYVY010000208.1_95187_596142_0"	500955	325397	334189	1769	8792	0	"S"	557	1686	NA	1e-04	0	"HG03540#1#JAGYVY010000208.1_95187_596142_0"	"AMY1A-201"	"1"	"HG03540"	"0-3-7-9-4-6-8-5-2-4-9-7-2-5-2-4-9-7-2-5-2-1"	"0.0-3.0-7.0-9.0-4.0-6.0-8.0-5.0-2.0-4.1-9.1-7.1-2.1-5.0-2.0-4.1-9.1-7.1-2.1-5.1-2.0-1.0"	98	"HG03540#1#JAGYVY010000208.1_95187_596142_0"	325397	334189
"ENST00000370083.9"	1785	2	1784	"-"	"HG03540#1#JAGYVY010000208.1_95187_596142_0"	500955	231262	240054	1769	8792	0	"S"	557	1686	NA	1e-04	0	"HG03540#1#JAGYVY010000208.1_95187_596142_0"	"AMY1A-201"	"1"	"HG03540"	"0-3-7-9-4-6-8-5-2-4-9-7-2-5-2-4-9-7-2-5-2-1"	"0.0-3.0-7.0-9.0-4.0-6.0-8.0-5.0-2.0-4.1-9.1-7.1-2.1-5.0-2.0-4.1-9.1-7.1-2.1-5.1-2.0-1.0"	98	"HG03540#1#JAGYVY010000208.1_95187_596142_0"	231262	240054
"ENST00000414303.7"	1584	4	1583	"+"	"HG03540#1#JAGYVY010000208.1_95187_596142_0"	500955	161341	169611	1563	8270	28	"P"	488	1488	1342	5e-04	0	"HG03540#1#JAGYVY010000208.1_95187_596142_0"	"AMY2A-201"	"2A"	"HG03540"	"0-3-7-9-4-6-8-5-2-4-9-7-2-5-2-4-9-7-2-5-2-1"	"0.0-3.0-7.0-9.0-4.0-6.0-8.0-5.0-2.0-4.1-9.1-7.1-2.1-5.0-2.0-4.1-9.1-7.1-2.1-5.1-2.0-1.0"	98	"HG03540#1#JAGYVY010000208.1_95187_596142_0"	161341	169611
"ENST00000610648.1"	1736	4	1733	"+"	"HG03540#1#JAGYVY010000208.1_95187_596142_0"	500955	115011	123435	1720	8424	48	"P"	531	1638	1371	1e-04	0	"HG03540#1#JAGYVY010000208.1_95187_596142_0"	"AMY2B-208"	"2B"	"HG03540"	"0-3-7-9-4-6-8-5-2-4-9-7-2-5-2-4-9-7-2-5-2-1"	"0.0-3.0-7.0-9.0-4.0-6.0-8.0-5.0-2.0-4.1-9.1-7.1-2.1-5.0-2.0-4.1-9.1-7.1-2.1-5.1-2.0-1.0"	98	"HG03540#1#JAGYVY010000208.1_95187_596142_0"	115011	123435
"ENST00000370083.9"	1785	2	1784	"-"	"NA18906#2#JAHEON010000009.1_93748295_94249275_0"	500980	325356	334149	1769	8793	0	"P"	557	1686	1686	1e-04	0	"NA18906#2#JAHEON010000009.1_93748295_94249275_0"	"AMY1A-201"	"1"	"NA18906"	"0-3-7-9-4-6-8-5-2-4-9-7-2-5-2-4-9-7-2-5-2-1"	"0.0-3.0-7.0-9.0-4.0-6.0-8.0-5.0-2.0-4.1-9.1-7.1-2.1-5.0-2.0-4.1-9.1-7.1-2.1-5.1-2.0-1.0"	98	"NA18906#2#JAHEON010000009.1_93748295_94249275_0"	325356	334149
"ENST00000370083.9"	1785	2	1784	"+"	"NA18906#2#JAHEON010000009.1_93748295_94249275_0"	500980	199586	208378	1769	8792	0	"S"	557	1686	NA	1e-04	0	"NA18906#2#JAHEON010000009.1_93748295_94249275_0"	"AMY1A-201"	"1"	"NA18906"	"0-3-7-9-4-6-8-5-2-4-9-7-2-5-2-4-9-7-2-5-2-1"	"0.0-3.0-7.0-9.0-4.0-6.0-8.0-5.0-2.0-4.1-9.1-7.1-2.1-5.0-2.0-4.1-9.1-7.1-2.1-5.1-2.0-1.0"	98	"NA18906#2#JAHEON010000009.1_93748295_94249275_0"	199586	208378
"ENST00000370083.9"	1785	2	1784	"+"	"NA18906#2#JAHEON010000009.1_93748295_94249275_0"	500980	293700	302492	1769	8792	0	"S"	557	1686	NA	1e-04	0	"NA18906#2#JAHEON010000009.1_93748295_94249275_0"	"AMY1A-201"	"1"	"NA18906"	"0-3-7-9-4-6-8-5-2-4-9-7-2-5-2-4-9-7-2-5-2-1"	"0.0-3.0-7.0-9.0-4.0-6.0-8.0-5.0-2.0-4.1-9.1-7.1-2.1-5.0-2.0-4.1-9.1-7.1-2.1-5.1-2.0-1.0"	98	"NA18906#2#JAHEON010000009.1_93748295_94249275_0"	293700	302492
"ENST00000370083.9"	1785	2	1784	"+"	"NA18906#2#JAHEON010000009.1_93748295_94249275_0"	500980	387830	396622	1769	8792	0	"S"	557	1686	NA	1e-04	0	"NA18906#2#JAHEON010000009.1_93748295_94249275_0"	"AMY1A-201"	"1"	"NA18906"	"0-3-7-9-4-6-8-5-2-4-9-7-2-5-2-4-9-7-2-5-2-1"	"0.0-3.0-7.0-9.0-4.0-6.0-8.0-5.0-2.0-4.1-9.1-7.1-2.1-5.0-2.0-4.1-9.1-7.1-2.1-5.1-2.0-1.0"	98	"NA18906#2#JAHEON010000009.1_93748295_94249275_0"	387830	396622
"ENST00000370083.9"	1785	2	1784	"-"	"NA18906#2#JAHEON010000009.1_93748295_94249275_0"	500980	231242	240034	1769	8792	0	"S"	557	1686	NA	1e-04	0	"NA18906#2#JAHEON010000009.1_93748295_94249275_0"	"AMY1A-201"	"1"	"NA18906"	"0-3-7-9-4-6-8-5-2-4-9-7-2-5-2-4-9-7-2-5-2-1"	"0.0-3.0-7.0-9.0-4.0-6.0-8.0-5.0-2.0-4.1-9.1-7.1-2.1-5.0-2.0-4.1-9.1-7.1-2.1-5.1-2.0-1.0"	98	"NA18906#2#JAHEON010000009.1_93748295_94249275_0"	231242	240034
"ENST00000414303.7"	1584	4	1583	"+"	"NA18906#2#JAHEON010000009.1_93748295_94249275_0"	500980	161333	169596	1569	8263	29	"P"	486	1494	1342	8e-04	0	"NA18906#2#JAHEON010000009.1_93748295_94249275_0"	"AMY2A-201"	"2A"	"NA18906"	"0-3-7-9-4-6-8-5-2-4-9-7-2-5-2-4-9-7-2-5-2-1"	"0.0-3.0-7.0-9.0-4.0-6.0-8.0-5.0-2.0-4.1-9.1-7.1-2.1-5.0-2.0-4.1-9.1-7.1-2.1-5.1-2.0-1.0"	98	"NA18906#2#JAHEON010000009.1_93748295_94249275_0"	161333	169596
"ENST00000610648.1"	1736	4	1733	"+"	"NA18906#2#JAHEON010000009.1_93748295_94249275_0"	500980	115014	123434	1720	8420	48	"P"	531	1638	1371	1e-04	0	"NA18906#2#JAHEON010000009.1_93748295_94249275_0"	"AMY2B-208"	"2B"	"NA18906"	"0-3-7-9-4-6-8-5-2-4-9-7-2-5-2-4-9-7-2-5-2-1"	"0.0-3.0-7.0-9.0-4.0-6.0-8.0-5.0-2.0-4.1-9.1-7.1-2.1-5.0-2.0-4.1-9.1-7.1-2.1-5.1-2.0-1.0"	98	"NA18906#2#JAHEON010000009.1_93748295_94249275_0"	115014	123434
"ENST00000370083.9"	1785	2	1784	"-"	"HG02486#1#JAGYVM010000007.1_28868414_29370339_1"	501925	231363	240155	1769	8792	0	"P"	557	1686	1686	1e-04	0	"HG02486#1#JAGYVM010000007.1_28868414_29370339_1"	"AMY1A-201"	"1"	"HG02486"	"0-3-7-9-4-6-8-5-2-4-9-7-2-5-2-7-9-4-2-5-2-1"	"0.0-3.0-7.0-9.0-4.0-6.0-8.0-5.0-2.0-4.1-9.1-7.1-2.1-5.1-2.0-7.0-9.0-4.0-2.1-5.0-2.0-1.0"	154	"HG02486#1#JAGYVM010000007.1_28868414_29370339_1"	231363	240155
"ENST00000370083.9"	1785	2	1784	"+"	"HG02486#1#JAGYVM010000007.1_28868414_29370339_1"	501925	199695	208496	1769	8801	0	"S"	557	1686	NA	1e-04	0	"HG02486#1#JAGYVM010000007.1_28868414_29370339_1"	"AMY1A-201"	"1"	"HG02486"	"0-3-7-9-4-6-8-5-2-4-9-7-2-5-2-7-9-4-2-5-2-1"	"0.0-3.0-7.0-9.0-4.0-6.0-8.0-5.0-2.0-4.1-9.1-7.1-2.1-5.1-2.0-7.0-9.0-4.0-2.1-5.0-2.0-1.0"	154	"HG02486#1#JAGYVM010000007.1_28868414_29370339_1"	199695	208496
"ENST00000370083.9"	1785	2	1784	"+"	"HG02486#1#JAGYVM010000007.1_28868414_29370339_1"	501925	387943	396733	1767	8790	0	"S"	552	1684	NA	7e-04	0	"HG02486#1#JAGYVM010000007.1_28868414_29370339_1"	"AMY1A-201"	"1"	"HG02486"	"0-3-7-9-4-6-8-5-2-4-9-7-2-5-2-7-9-4-2-5-2-1"	"0.0-3.0-7.0-9.0-4.0-6.0-8.0-5.0-2.0-4.1-9.1-7.1-2.1-5.1-2.0-7.0-9.0-4.0-2.1-5.0-2.0-1.0"	154	"HG02486#1#JAGYVM010000007.1_28868414_29370339_1"	387943	396733
"ENST00000370083.9"	1785	2	1784	"+"	"HG02486#1#JAGYVM010000007.1_28868414_29370339_1"	501925	293837	302617	1765	8780	0	"S"	553	1682	NA	6e-04	0	"HG02486#1#JAGYVM010000007.1_28868414_29370339_1"	"AMY1A-201"	"1"	"HG02486"	"0-3-7-9-4-6-8-5-2-4-9-7-2-5-2-7-9-4-2-5-2-1"	"0.0-3.0-7.0-9.0-4.0-6.0-8.0-5.0-2.0-4.1-9.1-7.1-2.1-5.1-2.0-7.0-9.0-4.0-2.1-5.0-2.0-1.0"	154	"HG02486#1#JAGYVM010000007.1_28868414_29370339_1"	293837	302617
"ENST00000370083.9"	1785	2	1784	"-"	"HG02486#1#JAGYVM010000007.1_28868414_29370339_1"	501925	325479	334259	1763	8780	0	"S"	548	1680	NA	0.0012	0	"HG02486#1#JAGYVM010000007.1_28868414_29370339_1"	"AMY1A-201"	"1"	"HG02486"	"0-3-7-9-4-6-8-5-2-4-9-7-2-5-2-7-9-4-2-5-2-1"	"0.0-3.0-7.0-9.0-4.0-6.0-8.0-5.0-2.0-4.1-9.1-7.1-2.1-5.1-2.0-7.0-9.0-4.0-2.1-5.0-2.0-1.0"	154	"HG02486#1#JAGYVM010000007.1_28868414_29370339_1"	325479	334259
"ENST00000414303.7"	1584	4	1583	"+"	"HG02486#1#JAGYVM010000007.1_28868414_29370339_1"	501925	161440	169710	1563	8270	11	"P"	488	1488	1428	5e-04	0	"HG02486#1#JAGYVM010000007.1_28868414_29370339_1"	"AMY2A-201"	"2A"	"HG02486"	"0-3-7-9-4-6-8-5-2-4-9-7-2-5-2-7-9-4-2-5-2-1"	"0.0-3.0-7.0-9.0-4.0-6.0-8.0-5.0-2.0-4.1-9.1-7.1-2.1-5.1-2.0-7.0-9.0-4.0-2.1-5.0-2.0-1.0"	154	"HG02486#1#JAGYVM010000007.1_28868414_29370339_1"	161440	169710
"ENST00000610648.1"	1736	4	1733	"+"	"HG02486#1#JAGYVM010000007.1_28868414_29370339_1"	501925	115098	123521	1720	8423	47	"P"	531	1638	1373	1e-04	0	"HG02486#1#JAGYVM010000007.1_28868414_29370339_1"	"AMY2B-208"	"2B"	"HG02486"	"0-3-7-9-4-6-8-5-2-4-9-7-2-5-2-7-9-4-2-5-2-1"	"0.0-3.0-7.0-9.0-4.0-6.0-8.0-5.0-2.0-4.1-9.1-7.1-2.1-5.1-2.0-7.0-9.0-4.0-2.1-5.0-2.0-1.0"	154	"HG02486#1#JAGYVM010000007.1_28868414_29370339_1"	115098	123521
"ENST00000370083.9"	1785	2	1784	"-"	"HG01258#2#JAGYYU010000072.1_51562603_51970395_0"	407792	231288	240081	1769	8793	0	"P"	557	1686	1686	1e-04	0	"HG01258#2#JAGYYU010000072.1_51562603_51970395_0"	"AMY1A-201"	"1"	"HG01258"	"0-3-7-9-4-6-8-5-2-7-9-4-2-5-2-1"	"0.0-3.0-7.0-9.0-4.0-6.0-8.0-5.0-2.0-7.0-9.0-4.0-2.1-5.1-2.0-1.0"	98	"HG01258#2#JAGYYU010000072.1_51562603_51970395_0"	231288	240081
"ENST00000370083.9"	1785	2	1784	"+"	"HG01258#2#JAGYYU010000072.1_51562603_51970395_0"	407792	199634	208425	1769	8791	0	"S"	557	1686	NA	1e-04	0	"HG01258#2#JAGYYU010000072.1_51562603_51970395_0"	"AMY1A-201"	"1"	"HG01258"	"0-3-7-9-4-6-8-5-2-7-9-4-2-5-2-1"	"0.0-3.0-7.0-9.0-4.0-6.0-8.0-5.0-2.0-7.0-9.0-4.0-2.1-5.1-2.0-1.0"	98	"HG01258#2#JAGYYU010000072.1_51562603_51970395_0"	199634	208425
"ENST00000370083.9"	1785	2	1784	"+"	"HG01258#2#JAGYYU010000072.1_51562603_51970395_0"	407792	293767	302561	1769	8794	0	"S"	557	1686	NA	1e-04	0	"HG01258#2#JAGYYU010000072.1_51562603_51970395_0"	"AMY1A-201"	"1"	"HG01258"	"0-3-7-9-4-6-8-5-2-7-9-4-2-5-2-1"	"0.0-3.0-7.0-9.0-4.0-6.0-8.0-5.0-2.0-7.0-9.0-4.0-2.1-5.1-2.0-1.0"	98	"HG01258#2#JAGYYU010000072.1_51562603_51970395_0"	293767	302561
"ENST00000414303.7"	1584	4	1583	"+"	"HG01258#2#JAGYYU010000072.1_51562603_51970395_0"	407792	161380	169650	1574	8270	30	"P"	491	1499	1342	1e-04	0	"HG01258#2#JAGYYU010000072.1_51562603_51970395_0"	"AMY2A-201"	"2A"	"HG01258"	"0-3-7-9-4-6-8-5-2-7-9-4-2-5-2-1"	"0.0-3.0-7.0-9.0-4.0-6.0-8.0-5.0-2.0-7.0-9.0-4.0-2.1-5.1-2.0-1.0"	98	"HG01258#2#JAGYYU010000072.1_51562603_51970395_0"	161380	169650
"ENST00000610648.1"	1736	4	1733	"+"	"HG01258#2#JAGYYU010000072.1_51562603_51970395_0"	407792	115043	123465	1720	8422	48	"P"	531	1638	1371	1e-04	0	"HG01258#2#JAGYYU010000072.1_51562603_51970395_0"	"AMY2B-208"	"2B"	"HG01258"	"0-3-7-9-4-6-8-5-2-7-9-4-2-5-2-1"	"0.0-3.0-7.0-9.0-4.0-6.0-8.0-5.0-2.0-7.0-9.0-4.0-2.1-5.1-2.0-1.0"	98	"HG01258#2#JAGYYU010000072.1_51562603_51970395_0"	115043	123465
"ENST00000370083.9"	1785	2	1784	"+"	"HG00741#2#JAHALX010000013.1_51574319_51981226_0"	406907	293796	302586	1769	8790	0	"P"	557	1686	1686	1e-04	0	"HG00741#2#JAHALX010000013.1_51574319_51981226_0"	"AMY1A-201"	"1"	"HG00741"	"0-3-7-9-4-6-8-5-2-7-9-4-2-5-2-1"	"0.0-3.0-7.0-9.0-4.0-6.0-8.0-5.0-2.0-7.0-9.0-4.0-2.1-5.1-2.0-1.0"	98	"HG00741#2#JAHALX010000013.1_51574319_51981226_0"	293796	302586
"ENST00000370083.9"	1785	2	1784	"-"	"HG00741#2#JAHALX010000013.1_51574319_51981226_0"	406907	231318	240111	1769	8793	0	"S"	557	1686	NA	1e-04	0	"HG00741#2#JAHALX010000013.1_51574319_51981226_0"	"AMY1A-201"	"1"	"HG00741"	"0-3-7-9-4-6-8-5-2-7-9-4-2-5-2-1"	"0.0-3.0-7.0-9.0-4.0-6.0-8.0-5.0-2.0-7.0-9.0-4.0-2.1-5.1-2.0-1.0"	98	"HG00741#2#JAHALX010000013.1_51574319_51981226_0"	231318	240111
"ENST00000370083.9"	1785	2	1784	"+"	"HG00741#2#JAHALX010000013.1_51574319_51981226_0"	406907	199664	208457	1767	8793	0	"S"	552	1684	NA	7e-04	0	"HG00741#2#JAHALX010000013.1_51574319_51981226_0"	"AMY1A-201"	"1"	"HG00741"	"0-3-7-9-4-6-8-5-2-7-9-4-2-5-2-1"	"0.0-3.0-7.0-9.0-4.0-6.0-8.0-5.0-2.0-7.0-9.0-4.0-2.1-5.1-2.0-1.0"	98	"HG00741#2#JAHALX010000013.1_51574319_51981226_0"	199664	208457
"ENST00000414303.7"	1584	4	1583	"+"	"HG00741#2#JAHALX010000013.1_51574319_51981226_0"	406907	161399	169669	1574	8270	30	"P"	491	1499	1342	1e-04	0	"HG00741#2#JAHALX010000013.1_51574319_51981226_0"	"AMY2A-201"	"2A"	"HG00741"	"0-3-7-9-4-6-8-5-2-7-9-4-2-5-2-1"	"0.0-3.0-7.0-9.0-4.0-6.0-8.0-5.0-2.0-7.0-9.0-4.0-2.1-5.1-2.0-1.0"	98	"HG00741#2#JAHALX010000013.1_51574319_51981226_0"	161399	169669
"ENST00000610648.1"	1736	4	1733	"+"	"HG00741#2#JAHALX010000013.1_51574319_51981226_0"	406907	115083	123505	1720	8422	48	"P"	531	1638	1371	1e-04	0	"HG00741#2#JAHALX010000013.1_51574319_51981226_0"	"AMY2B-208"	"2B"	"HG00741"	"0-3-7-9-4-6-8-5-2-7-9-4-2-5-2-1"	"0.0-3.0-7.0-9.0-4.0-6.0-8.0-5.0-2.0-7.0-9.0-4.0-2.1-5.1-2.0-1.0"	98	"HG00741#2#JAHALX010000013.1_51574319_51981226_0"	115083	123505
"ENST00000370083.9"	1785	2	1784	"+"	"NA19240#1#JAHEOM010000047.1_30103390_30511199_1"	407809	199725	208517	1769	8792	0	"P"	557	1686	1686	1e-04	0	"NA19240#1#JAHEOM010000047.1_30103390_30511199_1"	"AMY1A-201"	"1"	"NA19240"	"0-3-7-9-4-6-8-5-2-4-9-7-2-5-2-1"	"0.0-3.0-7.0-9.0-4.0-6.0-8.0-5.0-2.0-4.1-9.1-7.1-2.1-5.1-2.0-1.0"	154	"NA19240#1#JAHEOM010000047.1_30103390_30511199_1"	199725	208517
"ENST00000370083.9"	1785	2	1784	"+"	"NA19240#1#JAHEOM010000047.1_30103390_30511199_1"	407809	293861	302652	1769	8791	0	"S"	557	1686	NA	1e-04	0	"NA19240#1#JAHEOM010000047.1_30103390_30511199_1"	"AMY1A-201"	"1"	"NA19240"	"0-3-7-9-4-6-8-5-2-4-9-7-2-5-2-1"	"0.0-3.0-7.0-9.0-4.0-6.0-8.0-5.0-2.0-4.1-9.1-7.1-2.1-5.1-2.0-1.0"	154	"NA19240#1#JAHEOM010000047.1_30103390_30511199_1"	293861	302652
"ENST00000370083.9"	1785	2	1784	"-"	"NA19240#1#JAHEOM010000047.1_30103390_30511199_1"	407809	231382	240174	1769	8792	0	"S"	557	1686	NA	1e-04	0	"NA19240#1#JAHEOM010000047.1_30103390_30511199_1"	"AMY1A-201"	"1"	"NA19240"	"0-3-7-9-4-6-8-5-2-4-9-7-2-5-2-1"	"0.0-3.0-7.0-9.0-4.0-6.0-8.0-5.0-2.0-4.1-9.1-7.1-2.1-5.1-2.0-1.0"	154	"NA19240#1#JAHEOM010000047.1_30103390_30511199_1"	231382	240174
"ENST00000414303.7"	1584	4	1583	"+"	"NA19240#1#JAHEOM010000047.1_30103390_30511199_1"	407809	161463	169734	1574	8271	30	"P"	491	1499	1342	1e-04	0	"NA19240#1#JAHEOM010000047.1_30103390_30511199_1"	"AMY2A-201"	"2A"	"NA19240"	"0-3-7-9-4-6-8-5-2-4-9-7-2-5-2-1"	"0.0-3.0-7.0-9.0-4.0-6.0-8.0-5.0-2.0-4.1-9.1-7.1-2.1-5.1-2.0-1.0"	154	"NA19240#1#JAHEOM010000047.1_30103390_30511199_1"	161463	169734
"ENST00000610648.1"	1736	4	1733	"+"	"NA19240#1#JAHEOM010000047.1_30103390_30511199_1"	407809	115135	123559	1720	8424	48	"P"	531	1638	1371	1e-04	0	"NA19240#1#JAHEOM010000047.1_30103390_30511199_1"	"AMY2B-208"	"2B"	"NA19240"	"0-3-7-9-4-6-8-5-2-4-9-7-2-5-2-1"	"0.0-3.0-7.0-9.0-4.0-6.0-8.0-5.0-2.0-4.1-9.1-7.1-2.1-5.1-2.0-1.0"	154	"NA19240#1#JAHEOM010000047.1_30103390_30511199_1"	115135	123559
"ENST00000370083.9"	1785	2	1784	"+"	"HG03516#2#JAGYYS010000004.1_24452130_24859892_1"	407762	293812	302603	1769	8791	0	"P"	557	1686	1686	1e-04	0	"HG03516#2#JAGYYS010000004.1_24452130_24859892_1"	"AMY1A-201"	"1"	"HG03516"	"0-3-7-9-4-6-8-5-2-4-9-7-2-5-2-1"	"0.0-3.0-7.0-9.0-4.0-6.0-8.0-5.0-2.0-4.1-9.1-7.1-2.1-5.1-2.0-1.0"	154	"HG03516#2#JAGYYS010000004.1_24452130_24859892_1"	293812	302603
"ENST00000370083.9"	1785	2	1784	"+"	"HG03516#2#JAGYYS010000004.1_24452130_24859892_1"	407762	199690	208482	1769	8792	0	"S"	557	1686	NA	1e-04	0	"HG03516#2#JAGYYS010000004.1_24452130_24859892_1"	"AMY1A-201"	"1"	"HG03516"	"0-3-7-9-4-6-8-5-2-4-9-7-2-5-2-1"	"0.0-3.0-7.0-9.0-4.0-6.0-8.0-5.0-2.0-4.1-9.1-7.1-2.1-5.1-2.0-1.0"	154	"HG03516#2#JAGYYS010000004.1_24452130_24859892_1"	199690	208482
"ENST00000370083.9"	1785	2	1784	"-"	"HG03516#2#JAGYYS010000004.1_24452130_24859892_1"	407762	231342	240134	1769	8792	0	"S"	557	1686	NA	1e-04	0	"HG03516#2#JAGYYS010000004.1_24452130_24859892_1"	"AMY1A-201"	"1"	"HG03516"	"0-3-7-9-4-6-8-5-2-4-9-7-2-5-2-1"	"0.0-3.0-7.0-9.0-4.0-6.0-8.0-5.0-2.0-4.1-9.1-7.1-2.1-5.1-2.0-1.0"	154	"HG03516#2#JAGYYS010000004.1_24452130_24859892_1"	231342	240134
"ENST00000414303.7"	1584	4	1583	"+"	"HG03516#2#JAGYYS010000004.1_24452130_24859892_1"	407762	161429	169699	1563	8270	29	"P"	488	1488	1336	5e-04	0	"HG03516#2#JAGYYS010000004.1_24452130_24859892_1"	"AMY2A-201"	"2A"	"HG03516"	"0-3-7-9-4-6-8-5-2-4-9-7-2-5-2-1"	"0.0-3.0-7.0-9.0-4.0-6.0-8.0-5.0-2.0-4.1-9.1-7.1-2.1-5.1-2.0-1.0"	154	"HG03516#2#JAGYYS010000004.1_24452130_24859892_1"	161429	169699
"ENST00000610648.1"	1736	4	1733	"+"	"HG03516#2#JAGYYS010000004.1_24452130_24859892_1"	407762	115101	123523	1714	8422	47	"P"	525	1632	1371	9e-04	0	"HG03516#2#JAGYYS010000004.1_24452130_24859892_1"	"AMY2B-208"	"2B"	"HG03516"	"0-3-7-9-4-6-8-5-2-4-9-7-2-5-2-1"	"0.0-3.0-7.0-9.0-4.0-6.0-8.0-5.0-2.0-4.1-9.1-7.1-2.1-5.1-2.0-1.0"	154	"HG03516#2#JAGYYS010000004.1_24452130_24859892_1"	115101	123523
"ENST00000370083.9"	1785	2	1784	"+"	"HG02109#2#JAHEPF010000078.1_16678387_16991144_0"	312757	199639	208429	1769	8790	51	"P"	557	1686	1393	1e-04	0	"HG02109#2#JAHEPF010000078.1_16678387_16991144_0"	"AMY1A-201"	"1"	"HG02109"	"0-3-7-9-4-6-8-5-2-1"	"0.0-3.0-7.0-9.0-4.0-6.0-8.0-5.0-2.0-1.0"	98	"HG02109#2#JAHEPF010000078.1_16678387_16991144_0"	199639	208429
"ENST00000414303.7"	1584	4	1583	"+"	"HG02109#2#JAHEPF010000078.1_16678387_16991144_0"	312757	161385	169655	1563	8270	28	"P"	488	1488	1342	5e-04	0	"HG02109#2#JAHEPF010000078.1_16678387_16991144_0"	"AMY2A-201"	"2A"	"HG02109"	"0-3-7-9-4-6-8-5-2-1"	"0.0-3.0-7.0-9.0-4.0-6.0-8.0-5.0-2.0-1.0"	98	"HG02109#2#JAHEPF010000078.1_16678387_16991144_0"	161385	169655
"ENST00000610648.1"	1736	4	1733	"+"	"HG02109#2#JAHEPF010000078.1_16678387_16991144_0"	312757	115051	123475	1720	8424	52	"P"	531	1638	1347	1e-04	0	"HG02109#2#JAHEPF010000078.1_16678387_16991144_0"	"AMY2B-208"	"2B"	"HG02109"	"0-3-7-9-4-6-8-5-2-1"	"0.0-3.0-7.0-9.0-4.0-6.0-8.0-5.0-2.0-1.0"	98	"HG02109#2#JAHEPF010000078.1_16678387_16991144_0"	115051	123475
"ENST00000370083.9"	1785	2	1784	"+"	"chr1_chm13_103304997_103901127_0"	596130	387907	396697	1769	8790	0	"P"	557	1686	1686	1e-04	0	"chr1_chm13_103304997_103901127_0"	"AMY1A-201"	"1"	"chr1_chm13_103304997_103901127_0"	"0-3-7-9-4-6-8-5-2-4-9-7-2-5-2-4-9-7-2-5-2-4-9-7-2-5-2-1"	"0.0-3.0-7.0-9.0-4.0-6.0-8.0-5.0-2.0-4.1-9.1-7.1-2.1-5.1-2.0-4.1-9.1-7.1-2.1-5.0-2.0-4.1-9.1-7.1-2.1-5.0-2.0-1.0"	99	"chr1_chm13_103304997_103901127_0"	387907	396697
"ENST00000370083.9"	1785	2	1784	"+"	"chr1_chm13_103304997_103901127_0"	596130	482041	490833	1769	8792	0	"S"	557	1686	NA	1e-04	0	"chr1_chm13_103304997_103901127_0"	"AMY1A-201"	"1"	"chr1_chm13_103304997_103901127_0"	"0-3-7-9-4-6-8-5-2-4-9-7-2-5-2-4-9-7-2-5-2-4-9-7-2-5-2-1"	"0.0-3.0-7.0-9.0-4.0-6.0-8.0-5.0-2.0-4.1-9.1-7.1-2.1-5.1-2.0-4.1-9.1-7.1-2.1-5.0-2.0-4.1-9.1-7.1-2.1-5.0-2.0-1.0"	99	"chr1_chm13_103304997_103901127_0"	482041	490833
"ENST00000370083.9"	1785	2	1784	"-"	"chr1_chm13_103304997_103901127_0"	596130	231284	240077	1769	8793	0	"S"	557	1686	NA	1e-04	0	"chr1_chm13_103304997_103901127_0"	"AMY1A-201"	"1"	"chr1_chm13_103304997_103901127_0"	"0-3-7-9-4-6-8-5-2-4-9-7-2-5-2-4-9-7-2-5-2-4-9-7-2-5-2-1"	"0.0-3.0-7.0-9.0-4.0-6.0-8.0-5.0-2.0-4.1-9.1-7.1-2.1-5.1-2.0-4.1-9.1-7.1-2.1-5.0-2.0-4.1-9.1-7.1-2.1-5.0-2.0-1.0"	99	"chr1_chm13_103304997_103901127_0"	231284	240077
"ENST00000370083.9"	1785	2	1784	"-"	"chr1_chm13_103304997_103901127_0"	596130	419562	428353	1769	8791	0	"S"	557	1686	NA	1e-04	0	"chr1_chm13_103304997_103901127_0"	"AMY1A-201"	"1"	"chr1_chm13_103304997_103901127_0"	"0-3-7-9-4-6-8-5-2-4-9-7-2-5-2-4-9-7-2-5-2-4-9-7-2-5-2-1"	"0.0-3.0-7.0-9.0-4.0-6.0-8.0-5.0-2.0-4.1-9.1-7.1-2.1-5.1-2.0-4.1-9.1-7.1-2.1-5.0-2.0-4.1-9.1-7.1-2.1-5.0-2.0-1.0"	99	"chr1_chm13_103304997_103901127_0"	419562	428353
"ENST00000370083.9"	1785	2	1784	"+"	"chr1_chm13_103304997_103901127_0"	596130	293773	302564	1769	8791	0	"S"	557	1686	NA	1e-04	0	"chr1_chm13_103304997_103901127_0"	"AMY1A-201"	"1"	"chr1_chm13_103304997_103901127_0"	"0-3-7-9-4-6-8-5-2-4-9-7-2-5-2-4-9-7-2-5-2-4-9-7-2-5-2-1"	"0.0-3.0-7.0-9.0-4.0-6.0-8.0-5.0-2.0-4.1-9.1-7.1-2.1-5.1-2.0-4.1-9.1-7.1-2.1-5.0-2.0-4.1-9.1-7.1-2.1-5.0-2.0-1.0"	99	"chr1_chm13_103304997_103901127_0"	293773	302564
"ENST00000370083.9"	1785	2	1784	"+"	"chr1_chm13_103304997_103901127_0"	596130	199630	208423	1769	8793	0	"S"	557	1686	NA	1e-04	0	"chr1_chm13_103304997_103901127_0"	"AMY1A-201"	"1"	"chr1_chm13_103304997_103901127_0"	"0-3-7-9-4-6-8-5-2-4-9-7-2-5-2-4-9-7-2-5-2-4-9-7-2-5-2-1"	"0.0-3.0-7.0-9.0-4.0-6.0-8.0-5.0-2.0-4.1-9.1-7.1-2.1-5.1-2.0-4.1-9.1-7.1-2.1-5.0-2.0-4.1-9.1-7.1-2.1-5.0-2.0-1.0"	99	"chr1_chm13_103304997_103901127_0"	199630	208423
"ENST00000370083.9"	1785	2	1784	"-"	"chr1_chm13_103304997_103901127_0"	596130	325430	334221	1769	8791	0	"S"	557	1686	NA	1e-04	0	"chr1_chm13_103304997_103901127_0"	"AMY1A-201"	"1"	"chr1_chm13_103304997_103901127_0"	"0-3-7-9-4-6-8-5-2-4-9-7-2-5-2-4-9-7-2-5-2-4-9-7-2-5-2-1"	"0.0-3.0-7.0-9.0-4.0-6.0-8.0-5.0-2.0-4.1-9.1-7.1-2.1-5.1-2.0-4.1-9.1-7.1-2.1-5.0-2.0-4.1-9.1-7.1-2.1-5.0-2.0-1.0"	99	"chr1_chm13_103304997_103901127_0"	325430	334221
"ENST00000414303.7"	1584	4	1583	"+"	"chr1_chm13_103304997_103901127_0"	596130	161379	169649	1574	8270	15	"P"	491	1499	1420	1e-04	0	"chr1_chm13_103304997_103901127_0"	"AMY2A-201"	"2A"	"chr1_chm13_103304997_103901127_0"	"0-3-7-9-4-6-8-5-2-4-9-7-2-5-2-4-9-7-2-5-2-4-9-7-2-5-2-1"	"0.0-3.0-7.0-9.0-4.0-6.0-8.0-5.0-2.0-4.1-9.1-7.1-2.1-5.1-2.0-4.1-9.1-7.1-2.1-5.0-2.0-4.1-9.1-7.1-2.1-5.0-2.0-1.0"	99	"chr1_chm13_103304997_103901127_0"	161379	169649
"ENST00000610648.1"	1736	4	1733	"+"	"chr1_chm13_103304997_103901127_0"	596130	115049	123473	1720	8424	44	"P"	531	1638	1394	1e-04	0	"chr1_chm13_103304997_103901127_0"	"AMY2B-208"	"2B"	"chr1_chm13_103304997_103901127_0"	"0-3-7-9-4-6-8-5-2-4-9-7-2-5-2-4-9-7-2-5-2-4-9-7-2-5-2-1"	"0.0-3.0-7.0-9.0-4.0-6.0-8.0-5.0-2.0-4.1-9.1-7.1-2.1-5.1-2.0-4.1-9.1-7.1-2.1-5.0-2.0-4.1-9.1-7.1-2.1-5.0-2.0-1.0"	99	"chr1_chm13_103304997_103901127_0"	115049	123473
"ENST00000370083.9"	1785	2	1784	"+"	"HG02486#2#JAGYVL010000029.1_94163344_94570162_0"	406818	199588	208379	1769	8791	0	"P"	557	1686	1686	1e-04	0	"HG02486#2#JAGYVL010000029.1_94163344_94570162_0"	"AMY1A-201"	"1"	"HG02486"	"0-3-7-9-4-6-8-5-2-7-9-4-2-5-2-1"	"0.0-3.0-7.0-9.0-4.0-6.0-8.0-5.0-2.0-7.0-9.0-4.0-2.1-5.1-2.0-1.0"	98	"HG02486#2#JAGYVL010000029.1_94163344_94570162_0"	199588	208379
"ENST00000370083.9"	1785	2	1784	"-"	"HG02486#2#JAGYVL010000029.1_94163344_94570162_0"	406818	231246	240038	1769	8792	0	"S"	557	1686	NA	1e-04	0	"HG02486#2#JAGYVL010000029.1_94163344_94570162_0"	"AMY1A-201"	"1"	"HG02486"	"0-3-7-9-4-6-8-5-2-7-9-4-2-5-2-1"	"0.0-3.0-7.0-9.0-4.0-6.0-8.0-5.0-2.0-7.0-9.0-4.0-2.1-5.1-2.0-1.0"	98	"HG02486#2#JAGYVL010000029.1_94163344_94570162_0"	231246	240038
"ENST00000370083.9"	1785	2	1784	"+"	"HG02486#2#JAGYVL010000029.1_94163344_94570162_0"	406818	293712	302503	1769	8791	0	"S"	557	1686	NA	1e-04	0	"HG02486#2#JAGYVL010000029.1_94163344_94570162_0"	"AMY1A-201"	"1"	"HG02486"	"0-3-7-9-4-6-8-5-2-7-9-4-2-5-2-1"	"0.0-3.0-7.0-9.0-4.0-6.0-8.0-5.0-2.0-7.0-9.0-4.0-2.1-5.1-2.0-1.0"	98	"HG02486#2#JAGYVL010000029.1_94163344_94570162_0"	293712	302503
"ENST00000414303.7"	1584	4	1583	"+"	"HG02486#2#JAGYVL010000029.1_94163344_94570162_0"	406818	161333	169603	1563	8270	28	"P"	488	1488	1342	5e-04	0	"HG02486#2#JAGYVL010000029.1_94163344_94570162_0"	"AMY2A-201"	"2A"	"HG02486"	"0-3-7-9-4-6-8-5-2-7-9-4-2-5-2-1"	"0.0-3.0-7.0-9.0-4.0-6.0-8.0-5.0-2.0-7.0-9.0-4.0-2.1-5.1-2.0-1.0"	98	"HG02486#2#JAGYVL010000029.1_94163344_94570162_0"	161333	169603
"ENST00000610648.1"	1736	4	1733	"+"	"HG02486#2#JAGYVL010000029.1_94163344_94570162_0"	406818	114991	123414	1720	8423	48	"P"	531	1638	1371	1e-04	0	"HG02486#2#JAGYVL010000029.1_94163344_94570162_0"	"AMY2B-208"	"2B"	"HG02486"	"0-3-7-9-4-6-8-5-2-7-9-4-2-5-2-1"	"0.0-3.0-7.0-9.0-4.0-6.0-8.0-5.0-2.0-7.0-9.0-4.0-2.1-5.1-2.0-1.0"	98	"HG02486#2#JAGYVL010000029.1_94163344_94570162_0"	114991	123414
"ENST00000370083.9"	1785	2	1784	"+"	"HG01358#1#JAGYZB010000020.1_27445742_27855492_1"	409750	199685	208464	1769	8779	0	"P"	557	1686	1686	1e-04	0	"HG01358#1#JAGYZB010000020.1_27445742_27855492_1"	"AMY1A-201"	"1"	"HG01358"	"0-3-7-9-4-6-8-5-2-4-4-2-5-2-1"	"0.0-3.0-7.0-9.0-4.0-6.0-8.0-5.0-2.0-4.1-4.0-2.1-5.1-2.0-1.0"	154	"HG01358#1#JAGYZB010000020.1_27445742_27855492_1"	199685	208464
"ENST00000370083.9"	1785	2	1784	"+"	"HG01358#1#JAGYZB010000020.1_27445742_27855492_1"	409750	296696	305486	1769	8790	0	"S"	557	1686	NA	1e-04	0	"HG01358#1#JAGYZB010000020.1_27445742_27855492_1"	"AMY1A-201"	"1"	"HG01358"	"0-3-7-9-4-6-8-5-2-4-4-2-5-2-1"	"0.0-3.0-7.0-9.0-4.0-6.0-8.0-5.0-2.0-4.1-4.0-2.1-5.1-2.0-1.0"	154	"HG01358#1#JAGYZB010000020.1_27445742_27855492_1"	296696	305486
"ENST00000370083.9"	1785	2	1784	"-"	"HG01358#1#JAGYZB010000020.1_27445742_27855492_1"	409750	234224	243014	1769	8790	0	"S"	557	1686	NA	1e-04	0	"HG01358#1#JAGYZB010000020.1_27445742_27855492_1"	"AMY1A-201"	"1"	"HG01358"	"0-3-7-9-4-6-8-5-2-4-4-2-5-2-1"	"0.0-3.0-7.0-9.0-4.0-6.0-8.0-5.0-2.0-4.1-4.0-2.1-5.1-2.0-1.0"	154	"HG01358#1#JAGYZB010000020.1_27445742_27855492_1"	234224	243014
"ENST00000414303.7"	1584	4	1583	"+"	"HG01358#1#JAGYZB010000020.1_27445742_27855492_1"	409750	161430	169700	1563	8270	32	"P"	488	1488	1324	5e-04	0	"HG01358#1#JAGYZB010000020.1_27445742_27855492_1"	"AMY2A-201"	"2A"	"HG01358"	"0-3-7-9-4-6-8-5-2-4-4-2-5-2-1"	"0.0-3.0-7.0-9.0-4.0-6.0-8.0-5.0-2.0-4.1-4.0-2.1-5.1-2.0-1.0"	154	"HG01358#1#JAGYZB010000020.1_27445742_27855492_1"	161430	169700
"ENST00000610648.1"	1736	4	1733	"+"	"HG01358#1#JAGYZB010000020.1_27445742_27855492_1"	409750	115094	123516	1711	8422	46	"P"	518	1629	1371	0.0018	0	"HG01358#1#JAGYZB010000020.1_27445742_27855492_1"	"AMY2B-208"	"2B"	"HG01358"	"0-3-7-9-4-6-8-5-2-4-4-2-5-2-1"	"0.0-3.0-7.0-9.0-4.0-6.0-8.0-5.0-2.0-4.1-4.0-2.1-5.1-2.0-1.0"	154	"HG01358#1#JAGYZB010000020.1_27445742_27855492_1"	115094	123516
"ENST00000370083.9"	1785	2	1784	"+"	"HG00733#1#JAHEPQ010000019.1_46106835_46420495_0"	313660	199565	208357	1769	8792	49	"P"	557	1686	1404	1e-04	0	"HG00733#1#JAHEPQ010000019.1_46106835_46420495_0"	"AMY1A-201"	"1"	"HG00733"	"0-3-7-9-4-6-8-5-2-1"	"0.0-3.0-7.0-9.0-4.0-6.0-8.0-5.0-2.0-1.0"	99	"HG00733#1#JAHEPQ010000019.1_46106835_46420495_0"	199565	208357
"ENST00000414303.7"	1584	4	1583	"+"	"HG00733#1#JAHEPQ010000019.1_46106835_46420495_0"	313660	161311	169581	1574	8270	30	"P"	491	1499	1342	1e-04	0	"HG00733#1#JAHEPQ010000019.1_46106835_46420495_0"	"AMY2A-201"	"2A"	"HG00733"	"0-3-7-9-4-6-8-5-2-1"	"0.0-3.0-7.0-9.0-4.0-6.0-8.0-5.0-2.0-1.0"	99	"HG00733#1#JAHEPQ010000019.1_46106835_46420495_0"	161311	169581
"ENST00000610648.1"	1736	4	1733	"+"	"HG00733#1#JAHEPQ010000019.1_46106835_46420495_0"	313660	114984	123406	1720	8422	50	"P"	531	1638	1358	1e-04	0	"HG00733#1#JAHEPQ010000019.1_46106835_46420495_0"	"AMY2B-208"	"2B"	"HG00733"	"0-3-7-9-4-6-8-5-2-1"	"0.0-3.0-7.0-9.0-4.0-6.0-8.0-5.0-2.0-1.0"	99	"HG00733#1#JAHEPQ010000019.1_46106835_46420495_0"	114984	123406
"ENST00000370083.9"	1785	2	1784	"+"	"HG02818#1#JAHEOS010000101.1_89626_496613_0"	406987	199738	208528	1769	8790	0	"P"	557	1686	1686	1e-04	0	"HG02818#1#JAHEOS010000101.1_89626_496613_0"	"AMY1A-201"	"1"	"HG02818"	"0-3-7-9-4-6-8-5-2-4-9-7-2-5-2-1"	"0.0-3.0-7.0-9.0-4.0-6.0-8.0-5.0-2.0-4.1-9.1-7.1-2.1-5.0-2.0-1.0"	98	"HG02818#1#JAHEOS010000101.1_89626_496613_0"	199738	208528
"ENST00000370083.9"	1785	2	1784	"+"	"HG02818#1#JAHEOS010000101.1_89626_496613_0"	406987	293852	302643	1769	8791	0	"S"	557	1686	NA	1e-04	0	"HG02818#1#JAHEOS010000101.1_89626_496613_0"	"AMY1A-201"	"1"	"HG02818"	"0-3-7-9-4-6-8-5-2-4-9-7-2-5-2-1"	"0.0-3.0-7.0-9.0-4.0-6.0-8.0-5.0-2.0-4.1-9.1-7.1-2.1-5.0-2.0-1.0"	98	"HG02818#1#JAHEOS010000101.1_89626_496613_0"	293852	302643
"ENST00000370083.9"	1785	2	1784	"-"	"HG02818#1#JAHEOS010000101.1_89626_496613_0"	406987	231387	240178	1769	8791	0	"S"	557	1686	NA	1e-04	0	"HG02818#1#JAHEOS010000101.1_89626_496613_0"	"AMY1A-201"	"1"	"HG02818"	"0-3-7-9-4-6-8-5-2-4-9-7-2-5-2-1"	"0.0-3.0-7.0-9.0-4.0-6.0-8.0-5.0-2.0-4.1-9.1-7.1-2.1-5.0-2.0-1.0"	98	"HG02818#1#JAHEOS010000101.1_89626_496613_0"	231387	240178
"ENST00000414303.7"	1584	4	1583	"+"	"HG02818#1#JAHEOS010000101.1_89626_496613_0"	406987	161417	169722	1568	8305	29	"P"	486	1493	1342	8e-04	0	"HG02818#1#JAHEOS010000101.1_89626_496613_0"	"AMY2A-201"	"2A"	"HG02818"	"0-3-7-9-4-6-8-5-2-4-9-7-2-5-2-1"	"0.0-3.0-7.0-9.0-4.0-6.0-8.0-5.0-2.0-4.1-9.1-7.1-2.1-5.0-2.0-1.0"	98	"HG02818#1#JAHEOS010000101.1_89626_496613_0"	161417	169722
"ENST00000610648.1"	1736	4	1733	"+"	"HG02818#1#JAHEOS010000101.1_89626_496613_0"	406987	115063	123485	1720	8422	48	"P"	531	1638	1371	1e-04	0	"HG02818#1#JAHEOS010000101.1_89626_496613_0"	"AMY2B-208"	"2B"	"HG02818"	"0-3-7-9-4-6-8-5-2-4-9-7-2-5-2-1"	"0.0-3.0-7.0-9.0-4.0-6.0-8.0-5.0-2.0-4.1-9.1-7.1-2.1-5.0-2.0-1.0"	98	"HG02818#1#JAHEOS010000101.1_89626_496613_0"	115063	123485
"ENST00000370083.9"	1785	2	1784	"-"	"HG03579#1#JAGYVU010000029.1_91404_499180_0"	407776	231299	240091	1769	8792	0	"P"	557	1686	1686	1e-04	0	"HG03579#1#JAGYVU010000029.1_91404_499180_0"	"AMY1A-201"	"1"	"HG03579"	"0-3-7-9-4-6-8-5-2-7-9-4-2-5-2-1"	"0.0-3.0-7.0-9.0-4.0-6.0-8.0-5.0-2.0-7.0-9.0-4.0-2.1-5.1-2.0-1.0"	98	"HG03579#1#JAGYVU010000029.1_91404_499180_0"	231299	240091
"ENST00000370083.9"	1785	2	1784	"+"	"HG03579#1#JAGYVU010000029.1_91404_499180_0"	407776	293777	302568	1769	8791	0	"S"	557	1686	NA	1e-04	0	"HG03579#1#JAGYVU010000029.1_91404_499180_0"	"AMY1A-201"	"1"	"HG03579"	"0-3-7-9-4-6-8-5-2-7-9-4-2-5-2-1"	"0.0-3.0-7.0-9.0-4.0-6.0-8.0-5.0-2.0-7.0-9.0-4.0-2.1-5.1-2.0-1.0"	98	"HG03579#1#JAGYVU010000029.1_91404_499180_0"	293777	302568
"ENST00000370083.9"	1785	2	1784	"+"	"HG03579#1#JAGYVU010000029.1_91404_499180_0"	407776	199645	208437	1769	8792	0	"S"	557	1686	NA	1e-04	0	"HG03579#1#JAGYVU010000029.1_91404_499180_0"	"AMY1A-201"	"1"	"HG03579"	"0-3-7-9-4-6-8-5-2-7-9-4-2-5-2-1"	"0.0-3.0-7.0-9.0-4.0-6.0-8.0-5.0-2.0-7.0-9.0-4.0-2.1-5.1-2.0-1.0"	98	"HG03579#1#JAGYVU010000029.1_91404_499180_0"	199645	208437
"ENST00000414303.7"	1584	4	1583	"+"	"HG03579#1#JAGYVU010000029.1_91404_499180_0"	407776	161386	169656	1563	8270	29	"P"	488	1488	1336	5e-04	0	"HG03579#1#JAGYVU010000029.1_91404_499180_0"	"AMY2A-201"	"2A"	"HG03579"	"0-3-7-9-4-6-8-5-2-7-9-4-2-5-2-1"	"0.0-3.0-7.0-9.0-4.0-6.0-8.0-5.0-2.0-7.0-9.0-4.0-2.1-5.1-2.0-1.0"	98	"HG03579#1#JAGYVU010000029.1_91404_499180_0"	161386	169656
"ENST00000610648.1"	1736	4	1733	"+"	"HG03579#1#JAGYVU010000029.1_91404_499180_0"	407776	115060	123482	1714	8422	47	"P"	525	1632	1371	9e-04	0	"HG03579#1#JAGYVU010000029.1_91404_499180_0"	"AMY2B-208"	"2B"	"HG03579"	"0-3-7-9-4-6-8-5-2-7-9-4-2-5-2-1"	"0.0-3.0-7.0-9.0-4.0-6.0-8.0-5.0-2.0-7.0-9.0-4.0-2.1-5.1-2.0-1.0"	98	"HG03579#1#JAGYVU010000029.1_91404_499180_0"	115060	123482
"ENST00000370083.9"	1785	2	1784	"+"	"HG02717#2#JAHAOR010000006.1_19663827_20070693_1"	406866	293816	302606	1769	8790	0	"P"	557	1686	1686	1e-04	0	"HG02717#2#JAHAOR010000006.1_19663827_20070693_1"	"AMY1A-201"	"1"	"HG02717"	"0-3-7-9-4-6-8-5-2-7-9-4-2-5-2-1"	"0.0-3.0-7.0-9.0-4.0-6.0-8.0-5.0-2.0-7.0-9.0-4.0-2.1-5.1-2.0-1.0"	154	"HG02717#2#JAHAOR010000006.1_19663827_20070693_1"	293816	302606
"ENST00000370083.9"	1785	2	1784	"-"	"HG02717#2#JAHAOR010000006.1_19663827_20070693_1"	406866	231342	240135	1769	8793	0	"S"	557	1686	NA	1e-04	0	"HG02717#2#JAHAOR010000006.1_19663827_20070693_1"	"AMY1A-201"	"1"	"HG02717"	"0-3-7-9-4-6-8-5-2-7-9-4-2-5-2-1"	"0.0-3.0-7.0-9.0-4.0-6.0-8.0-5.0-2.0-7.0-9.0-4.0-2.1-5.1-2.0-1.0"	154	"HG02717#2#JAHAOR010000006.1_19663827_20070693_1"	231342	240135
"ENST00000370083.9"	1785	2	1784	"+"	"HG02717#2#JAHAOR010000006.1_19663827_20070693_1"	406866	199689	208480	1769	8791	0	"S"	557	1686	NA	1e-04	0	"HG02717#2#JAHAOR010000006.1_19663827_20070693_1"	"AMY1A-201"	"1"	"HG02717"	"0-3-7-9-4-6-8-5-2-7-9-4-2-5-2-1"	"0.0-3.0-7.0-9.0-4.0-6.0-8.0-5.0-2.0-7.0-9.0-4.0-2.1-5.1-2.0-1.0"	154	"HG02717#2#JAHAOR010000006.1_19663827_20070693_1"	199689	208480
"ENST00000414303.7"	1584	4	1583	"+"	"HG02717#2#JAHAOR010000006.1_19663827_20070693_1"	406866	161431	169701	1563	8270	28	"P"	488	1488	1342	5e-04	0	"HG02717#2#JAHAOR010000006.1_19663827_20070693_1"	"AMY2A-201"	"2A"	"HG02717"	"0-3-7-9-4-6-8-5-2-7-9-4-2-5-2-1"	"0.0-3.0-7.0-9.0-4.0-6.0-8.0-5.0-2.0-7.0-9.0-4.0-2.1-5.1-2.0-1.0"	154	"HG02717#2#JAHAOR010000006.1_19663827_20070693_1"	161431	169701
"ENST00000610648.1"	1736	4	1733	"+"	"HG02717#2#JAHAOR010000006.1_19663827_20070693_1"	406866	115094	123516	1720	8422	48	"P"	531	1638	1371	1e-04	0	"HG02717#2#JAHAOR010000006.1_19663827_20070693_1"	"AMY2B-208"	"2B"	"HG02717"	"0-3-7-9-4-6-8-5-2-7-9-4-2-5-2-1"	"0.0-3.0-7.0-9.0-4.0-6.0-8.0-5.0-2.0-7.0-9.0-4.0-2.1-5.1-2.0-1.0"	154	"HG02717#2#JAHAOR010000006.1_19663827_20070693_1"	115094	123516
"ENST00000370083.9"	1785	2	1784	"+"	"NA19240#2#JAHEOL010000010.1_37445323_37853017_0"	407694	293642	302433	1769	8791	0	"P"	557	1686	1686	1e-04	0	"NA19240#2#JAHEOL010000010.1_37445323_37853017_0"	"AMY1A-201"	"1"	"NA19240"	"0-3-7-9-4-6-8-5-2-7-9-4-2-5-2-1"	"0.0-3.0-7.0-9.0-4.0-6.0-8.0-5.0-2.0-7.0-9.0-4.0-2.1-5.1-2.0-1.0"	98	"NA19240#2#JAHEOL010000010.1_37445323_37853017_0"	293642	302433
"ENST00000370083.9"	1785	2	1784	"+"	"NA19240#2#JAHEOL010000010.1_37445323_37853017_0"	407694	199559	208350	1769	8791	0	"S"	557	1686	NA	1e-04	0	"NA19240#2#JAHEOL010000010.1_37445323_37853017_0"	"AMY1A-201"	"1"	"NA19240"	"0-3-7-9-4-6-8-5-2-7-9-4-2-5-2-1"	"0.0-3.0-7.0-9.0-4.0-6.0-8.0-5.0-2.0-7.0-9.0-4.0-2.1-5.1-2.0-1.0"	98	"NA19240#2#JAHEOL010000010.1_37445323_37853017_0"	199559	208350
"ENST00000370083.9"	1785	2	1784	"-"	"NA19240#2#JAHEOL010000010.1_37445323_37853017_0"	407694	231208	239999	1769	8791	0	"S"	557	1686	NA	1e-04	0	"NA19240#2#JAHEOL010000010.1_37445323_37853017_0"	"AMY1A-201"	"1"	"NA19240"	"0-3-7-9-4-6-8-5-2-7-9-4-2-5-2-1"	"0.0-3.0-7.0-9.0-4.0-6.0-8.0-5.0-2.0-7.0-9.0-4.0-2.1-5.1-2.0-1.0"	98	"NA19240#2#JAHEOL010000010.1_37445323_37853017_0"	231208	239999
"ENST00000414303.7"	1584	4	1579	"+"	"NA19240#2#JAHEOL010000010.1_37445323_37853017_0"	407694	161309	169575	1552	8266	26	"P"	481	1477	1342	0.0014	0	"NA19240#2#JAHEOL010000010.1_37445323_37853017_0"	"AMY2A-201"	"2A"	"NA19240"	"0-3-7-9-4-6-8-5-2-7-9-4-2-5-2-1"	"0.0-3.0-7.0-9.0-4.0-6.0-8.0-5.0-2.0-7.0-9.0-4.0-2.1-5.1-2.0-1.0"	98	"NA19240#2#JAHEOL010000010.1_37445323_37853017_0"	161309	169575
"ENST00000610648.1"	1736	4	1733	"+"	"NA19240#2#JAHEOL010000010.1_37445323_37853017_0"	407694	114993	123415	1720	8422	48	"P"	531	1638	1371	1e-04	0	"NA19240#2#JAHEOL010000010.1_37445323_37853017_0"	"AMY2B-208"	"2B"	"NA19240"	"0-3-7-9-4-6-8-5-2-7-9-4-2-5-2-1"	"0.0-3.0-7.0-9.0-4.0-6.0-8.0-5.0-2.0-7.0-9.0-4.0-2.1-5.1-2.0-1.0"	98	"NA19240#2#JAHEOL010000010.1_37445323_37853017_0"	114993	123415
"ENST00000370083.9"	1785	2	1784	"+"	"HG01891#1#JAGYVO010000014.1_22855818_23168577_1"	312759	199682	208472	1769	8790	47	"P"	557	1686	1415	1e-04	0	"HG01891#1#JAGYVO010000014.1_22855818_23168577_1"	"AMY1A-201"	"1"	"HG01891"	"0-3-7-9-4-6-8-5-2-1"	"0.0-3.0-7.0-9.0-4.0-6.0-8.0-5.0-2.0-1.0"	154	"HG01891#1#JAGYVO010000014.1_22855818_23168577_1"	199682	208472
"ENST00000414303.7"	1584	4	1583	"+"	"HG01891#1#JAGYVO010000014.1_22855818_23168577_1"	312759	161430	169693	1569	8263	29	"P"	486	1494	1342	1e-04	0	"HG01891#1#JAGYVO010000014.1_22855818_23168577_1"	"AMY2A-201"	"2A"	"HG01891"	"0-3-7-9-4-6-8-5-2-1"	"0.0-3.0-7.0-9.0-4.0-6.0-8.0-5.0-2.0-1.0"	154	"HG01891#1#JAGYVO010000014.1_22855818_23168577_1"	161430	169693
"ENST00000610648.1"	1736	4	1733	"+"	"HG01891#1#JAGYVO010000014.1_22855818_23168577_1"	312759	115095	123517	1720	8422	50	"P"	531	1638	1360	1e-04	0	"HG01891#1#JAGYVO010000014.1_22855818_23168577_1"	"AMY2B-208"	"2B"	"HG01891"	"0-3-7-9-4-6-8-5-2-1"	"0.0-3.0-7.0-9.0-4.0-6.0-8.0-5.0-2.0-1.0"	154	"HG01891#1#JAGYVO010000014.1_22855818_23168577_1"	115095	123517
"ENST00000370083.9"	1785	2	1784	"+"	"HG04228.verkko_filt_pat.fa:haplotype2-0000600_103806749_104119491_0"	312742	199627	208418	1769	8791	49	"P"	557	1686	1404	1e-04	0	"HG04228.verkko_filt_pat.fa:haplotype2-0000600_103806749_104119491_0"	"AMY1A-201"	"1"	"HG04228"	"0-3-7-9-4-6-8-5-2-1"	"0.0-3.0-7.0-9.0-4.0-6.0-8.0-5.0-2.0-1.0"	99	"HG04228.verkko_filt_pat.fa:haplotype2-0000600_103806749_104119491_0"	199627	208418
"ENST00000414303.7"	1584	4	1583	"+"	"HG04228.verkko_filt_pat.fa:haplotype2-0000600_103806749_104119491_0"	312742	161375	169645	1574	8270	30	"P"	491	1499	1342	1e-04	0	"HG04228.verkko_filt_pat.fa:haplotype2-0000600_103806749_104119491_0"	"AMY2A-201"	"2A"	"HG04228"	"0-3-7-9-4-6-8-5-2-1"	"0.0-3.0-7.0-9.0-4.0-6.0-8.0-5.0-2.0-1.0"	99	"HG04228.verkko_filt_pat.fa:haplotype2-0000600_103806749_104119491_0"	161375	169645
"ENST00000610648.1"	1736	4	1733	"+"	"HG04228.verkko_filt_pat.fa:haplotype2-0000600_103806749_104119491_0"	312742	115050	123472	1720	8422	50	"P"	531	1638	1358	1e-04	0	"HG04228.verkko_filt_pat.fa:haplotype2-0000600_103806749_104119491_0"	"AMY2B-208"	"2B"	"HG04228"	"0-3-7-9-4-6-8-5-2-1"	"0.0-3.0-7.0-9.0-4.0-6.0-8.0-5.0-2.0-1.0"	99	"HG04228.verkko_filt_pat.fa:haplotype2-0000600_103806749_104119491_0"	115050	123472
"ENST00000370083.9"	1785	2	1784	"+"	"HG04228.verkko_filt_mat.fa:haplotype1-0000023_103429213_103930285_0"	501072	199607	208400	1769	8793	0	"P"	557	1686	1686	1e-04	0	"HG04228.verkko_filt_mat.fa:haplotype1-0000023_103429213_103930285_0"	"AMY1A-201"	"1"	"HG04228"	"0-3-7-9-4-6-8-5-2-7-9-4-2-5-2-4-9-7-2-5-2-1"	"0.0-3.0-7.0-9.0-4.0-6.0-8.0-5.0-2.0-7.0-9.0-4.0-2.1-5.1-2.0-4.1-9.1-7.1-2.1-5.0-2.0-1.0"	99	"HG04228.verkko_filt_mat.fa:haplotype1-0000023_103429213_103930285_0"	199607	208400
"ENST00000370083.9"	1785	2	1784	"-"	"HG04228.verkko_filt_mat.fa:haplotype1-0000023_103429213_103930285_0"	501072	231256	240049	1769	8793	0	"S"	557	1686	NA	1e-04	0	"HG04228.verkko_filt_mat.fa:haplotype1-0000023_103429213_103930285_0"	"AMY1A-201"	"1"	"HG04228"	"0-3-7-9-4-6-8-5-2-7-9-4-2-5-2-4-9-7-2-5-2-1"	"0.0-3.0-7.0-9.0-4.0-6.0-8.0-5.0-2.0-7.0-9.0-4.0-2.1-5.1-2.0-4.1-9.1-7.1-2.1-5.0-2.0-1.0"	99	"HG04228.verkko_filt_mat.fa:haplotype1-0000023_103429213_103930285_0"	231256	240049
"ENST00000370083.9"	1785	2	1784	"-"	"HG04228.verkko_filt_mat.fa:haplotype1-0000023_103429213_103930285_0"	501072	325410	334202	1769	8792	0	"S"	557	1686	NA	1e-04	0	"HG04228.verkko_filt_mat.fa:haplotype1-0000023_103429213_103930285_0"	"AMY1A-201"	"1"	"HG04228"	"0-3-7-9-4-6-8-5-2-7-9-4-2-5-2-4-9-7-2-5-2-1"	"0.0-3.0-7.0-9.0-4.0-6.0-8.0-5.0-2.0-7.0-9.0-4.0-2.1-5.1-2.0-4.1-9.1-7.1-2.1-5.0-2.0-1.0"	99	"HG04228.verkko_filt_mat.fa:haplotype1-0000023_103429213_103930285_0"	325410	334202
"ENST00000370083.9"	1785	2	1784	"+"	"HG04228.verkko_filt_mat.fa:haplotype1-0000023_103429213_103930285_0"	501072	387885	396677	1769	8792	0	"S"	557	1686	NA	1e-04	0	"HG04228.verkko_filt_mat.fa:haplotype1-0000023_103429213_103930285_0"	"AMY1A-201"	"1"	"HG04228"	"0-3-7-9-4-6-8-5-2-7-9-4-2-5-2-4-9-7-2-5-2-1"	"0.0-3.0-7.0-9.0-4.0-6.0-8.0-5.0-2.0-7.0-9.0-4.0-2.1-5.1-2.0-4.1-9.1-7.1-2.1-5.0-2.0-1.0"	99	"HG04228.verkko_filt_mat.fa:haplotype1-0000023_103429213_103930285_0"	387885	396677
"ENST00000370083.9"	1785	2	1784	"+"	"HG04228.verkko_filt_mat.fa:haplotype1-0000023_103429213_103930285_0"	501072	293755	302547	1769	8792	0	"S"	557	1686	NA	1e-04	0	"HG04228.verkko_filt_mat.fa:haplotype1-0000023_103429213_103930285_0"	"AMY1A-201"	"1"	"HG04228"	"0-3-7-9-4-6-8-5-2-7-9-4-2-5-2-4-9-7-2-5-2-1"	"0.0-3.0-7.0-9.0-4.0-6.0-8.0-5.0-2.0-7.0-9.0-4.0-2.1-5.1-2.0-4.1-9.1-7.1-2.1-5.0-2.0-1.0"	99	"HG04228.verkko_filt_mat.fa:haplotype1-0000023_103429213_103930285_0"	293755	302547
"ENST00000414303.7"	1584	4	1583	"+"	"HG04228.verkko_filt_mat.fa:haplotype1-0000023_103429213_103930285_0"	501072	161347	169615	1574	8268	16	"P"	491	1499	1417	1e-04	0	"HG04228.verkko_filt_mat.fa:haplotype1-0000023_103429213_103930285_0"	"AMY2A-201"	"2A"	"HG04228"	"0-3-7-9-4-6-8-5-2-7-9-4-2-5-2-4-9-7-2-5-2-1"	"0.0-3.0-7.0-9.0-4.0-6.0-8.0-5.0-2.0-7.0-9.0-4.0-2.1-5.1-2.0-4.1-9.1-7.1-2.1-5.0-2.0-1.0"	99	"HG04228.verkko_filt_mat.fa:haplotype1-0000023_103429213_103930285_0"	161347	169615
"ENST00000610648.1"	1736	4	1733	"+"	"HG04228.verkko_filt_mat.fa:haplotype1-0000023_103429213_103930285_0"	501072	115019	123443	1720	8424	48	"P"	531	1638	1371	1e-04	0	"HG04228.verkko_filt_mat.fa:haplotype1-0000023_103429213_103930285_0"	"AMY2B-208"	"2B"	"HG04228"	"0-3-7-9-4-6-8-5-2-7-9-4-2-5-2-4-9-7-2-5-2-1"	"0.0-3.0-7.0-9.0-4.0-6.0-8.0-5.0-2.0-7.0-9.0-4.0-2.1-5.1-2.0-4.1-9.1-7.1-2.1-5.0-2.0-1.0"	99	"HG04228.verkko_filt_mat.fa:haplotype1-0000023_103429213_103930285_0"	115019	123443
"ENST00000370083.9"	1785	2	1784	"+"	"HG02004.verkko_filt_pat.fa:haplotype2-0000813_139386576_140076845_1"	690269	293842	302636	1769	8794	0	"P"	557	1686	1686	1e-04	0	"HG02004.verkko_filt_pat.fa:haplotype2-0000813_139386576_140076845_1"	"AMY1A-201"	"1"	"HG02004"	"0-3-7-9-4-6-8-5-2-4-9-7-2-5-2-4-9-7-2-5-2-4-9-7-2-5-2-4-9-7-2-5-2-1"	"0.0-3.0-7.0-9.0-4.0-6.0-8.0-5.0-2.0-4.1-9.1-7.1-2.1-5.1-2.0-4.1-9.1-7.1-2.1-5.1-2.0-4.1-9.1-7.1-2.1-5.1-2.0-4.1-9.1-7.1-2.1-5.0-2.0-1.0"	154	"HG02004.verkko_filt_pat.fa:haplotype2-0000813_139386576_140076845_1"	293842	302636
"ENST00000370083.9"	1785	2	1784	"-"	"HG02004.verkko_filt_pat.fa:haplotype2-0000813_139386576_140076845_1"	690269	513764	522557	1769	8793	0	"S"	557	1686	NA	1e-04	0	"HG02004.verkko_filt_pat.fa:haplotype2-0000813_139386576_140076845_1"	"AMY1A-201"	"1"	"HG02004"	"0-3-7-9-4-6-8-5-2-4-9-7-2-5-2-4-9-7-2-5-2-4-9-7-2-5-2-4-9-7-2-5-2-1"	"0.0-3.0-7.0-9.0-4.0-6.0-8.0-5.0-2.0-4.1-9.1-7.1-2.1-5.1-2.0-4.1-9.1-7.1-2.1-5.1-2.0-4.1-9.1-7.1-2.1-5.1-2.0-4.1-9.1-7.1-2.1-5.0-2.0-1.0"	154	"HG02004.verkko_filt_pat.fa:haplotype2-0000813_139386576_140076845_1"	513764	522557
"ENST00000370083.9"	1785	2	1784	"-"	"HG02004.verkko_filt_pat.fa:haplotype2-0000813_139386576_140076845_1"	690269	419634	428428	1769	8794	0	"S"	557	1686	NA	1e-04	0	"HG02004.verkko_filt_pat.fa:haplotype2-0000813_139386576_140076845_1"	"AMY1A-201"	"1"	"HG02004"	"0-3-7-9-4-6-8-5-2-4-9-7-2-5-2-4-9-7-2-5-2-4-9-7-2-5-2-4-9-7-2-5-2-1"	"0.0-3.0-7.0-9.0-4.0-6.0-8.0-5.0-2.0-4.1-9.1-7.1-2.1-5.1-2.0-4.1-9.1-7.1-2.1-5.1-2.0-4.1-9.1-7.1-2.1-5.1-2.0-4.1-9.1-7.1-2.1-5.0-2.0-1.0"	154	"HG02004.verkko_filt_pat.fa:haplotype2-0000813_139386576_140076845_1"	419634	428428
"ENST00000370083.9"	1785	2	1784	"-"	"HG02004.verkko_filt_pat.fa:haplotype2-0000813_139386576_140076845_1"	690269	325502	334295	1769	8793	0	"S"	557	1686	NA	1e-04	0	"HG02004.verkko_filt_pat.fa:haplotype2-0000813_139386576_140076845_1"	"AMY1A-201"	"1"	"HG02004"	"0-3-7-9-4-6-8-5-2-4-9-7-2-5-2-4-9-7-2-5-2-4-9-7-2-5-2-4-9-7-2-5-2-1"	"0.0-3.0-7.0-9.0-4.0-6.0-8.0-5.0-2.0-4.1-9.1-7.1-2.1-5.1-2.0-4.1-9.1-7.1-2.1-5.1-2.0-4.1-9.1-7.1-2.1-5.1-2.0-4.1-9.1-7.1-2.1-5.0-2.0-1.0"	154	"HG02004.verkko_filt_pat.fa:haplotype2-0000813_139386576_140076845_1"	325502	334295
"ENST00000370083.9"	1785	2	1784	"-"	"HG02004.verkko_filt_pat.fa:haplotype2-0000813_139386576_140076845_1"	690269	231365	240158	1769	8793	0	"S"	557	1686	NA	1e-04	0	"HG02004.verkko_filt_pat.fa:haplotype2-0000813_139386576_140076845_1"	"AMY1A-201"	"1"	"HG02004"	"0-3-7-9-4-6-8-5-2-4-9-7-2-5-2-4-9-7-2-5-2-4-9-7-2-5-2-4-9-7-2-5-2-1"	"0.0-3.0-7.0-9.0-4.0-6.0-8.0-5.0-2.0-4.1-9.1-7.1-2.1-5.1-2.0-4.1-9.1-7.1-2.1-5.1-2.0-4.1-9.1-7.1-2.1-5.1-2.0-4.1-9.1-7.1-2.1-5.0-2.0-1.0"	154	"HG02004.verkko_filt_pat.fa:haplotype2-0000813_139386576_140076845_1"	231365	240158
"ENST00000370083.9"	1785	2	1784	"+"	"HG02004.verkko_filt_pat.fa:haplotype2-0000813_139386576_140076845_1"	690269	482107	490899	1769	8792	0	"S"	557	1686	NA	1e-04	0	"HG02004.verkko_filt_pat.fa:haplotype2-0000813_139386576_140076845_1"	"AMY1A-201"	"1"	"HG02004"	"0-3-7-9-4-6-8-5-2-4-9-7-2-5-2-4-9-7-2-5-2-4-9-7-2-5-2-4-9-7-2-5-2-1"	"0.0-3.0-7.0-9.0-4.0-6.0-8.0-5.0-2.0-4.1-9.1-7.1-2.1-5.1-2.0-4.1-9.1-7.1-2.1-5.1-2.0-4.1-9.1-7.1-2.1-5.1-2.0-4.1-9.1-7.1-2.1-5.0-2.0-1.0"	154	"HG02004.verkko_filt_pat.fa:haplotype2-0000813_139386576_140076845_1"	482107	490899
"ENST00000370083.9"	1785	2	1784	"+"	"HG02004.verkko_filt_pat.fa:haplotype2-0000813_139386576_140076845_1"	690269	576231	585023	1769	8792	0	"S"	557	1686	NA	1e-04	0	"HG02004.verkko_filt_pat.fa:haplotype2-0000813_139386576_140076845_1"	"AMY1A-201"	"1"	"HG02004"	"0-3-7-9-4-6-8-5-2-4-9-7-2-5-2-4-9-7-2-5-2-4-9-7-2-5-2-4-9-7-2-5-2-1"	"0.0-3.0-7.0-9.0-4.0-6.0-8.0-5.0-2.0-4.1-9.1-7.1-2.1-5.1-2.0-4.1-9.1-7.1-2.1-5.1-2.0-4.1-9.1-7.1-2.1-5.1-2.0-4.1-9.1-7.1-2.1-5.0-2.0-1.0"	154	"HG02004.verkko_filt_pat.fa:haplotype2-0000813_139386576_140076845_1"	576231	585023
"ENST00000370083.9"	1785	2	1784	"+"	"HG02004.verkko_filt_pat.fa:haplotype2-0000813_139386576_140076845_1"	690269	199710	208504	1769	8794	0	"S"	557	1686	NA	1e-04	0	"HG02004.verkko_filt_pat.fa:haplotype2-0000813_139386576_140076845_1"	"AMY1A-201"	"1"	"HG02004"	"0-3-7-9-4-6-8-5-2-4-9-7-2-5-2-4-9-7-2-5-2-4-9-7-2-5-2-4-9-7-2-5-2-1"	"0.0-3.0-7.0-9.0-4.0-6.0-8.0-5.0-2.0-4.1-9.1-7.1-2.1-5.1-2.0-4.1-9.1-7.1-2.1-5.1-2.0-4.1-9.1-7.1-2.1-5.1-2.0-4.1-9.1-7.1-2.1-5.0-2.0-1.0"	154	"HG02004.verkko_filt_pat.fa:haplotype2-0000813_139386576_140076845_1"	199710	208504
"ENST00000370083.9"	1785	2	1784	"+"	"HG02004.verkko_filt_pat.fa:haplotype2-0000813_139386576_140076845_1"	690269	387979	396772	1769	8793	0	"S"	557	1686	NA	1e-04	0	"HG02004.verkko_filt_pat.fa:haplotype2-0000813_139386576_140076845_1"	"AMY1A-201"	"1"	"HG02004"	"0-3-7-9-4-6-8-5-2-4-9-7-2-5-2-4-9-7-2-5-2-4-9-7-2-5-2-4-9-7-2-5-2-1"	"0.0-3.0-7.0-9.0-4.0-6.0-8.0-5.0-2.0-4.1-9.1-7.1-2.1-5.1-2.0-4.1-9.1-7.1-2.1-5.1-2.0-4.1-9.1-7.1-2.1-5.1-2.0-4.1-9.1-7.1-2.1-5.0-2.0-1.0"	154	"HG02004.verkko_filt_pat.fa:haplotype2-0000813_139386576_140076845_1"	387979	396772
"ENST00000414303.7"	1584	4	1583	"+"	"HG02004.verkko_filt_pat.fa:haplotype2-0000813_139386576_140076845_1"	690269	161452	169722	1574	8270	16	"P"	491	1499	1417	1e-04	0	"HG02004.verkko_filt_pat.fa:haplotype2-0000813_139386576_140076845_1"	"AMY2A-201"	"2A"	"HG02004"	"0-3-7-9-4-6-8-5-2-4-9-7-2-5-2-4-9-7-2-5-2-4-9-7-2-5-2-4-9-7-2-5-2-1"	"0.0-3.0-7.0-9.0-4.0-6.0-8.0-5.0-2.0-4.1-9.1-7.1-2.1-5.1-2.0-4.1-9.1-7.1-2.1-5.1-2.0-4.1-9.1-7.1-2.1-5.1-2.0-4.1-9.1-7.1-2.1-5.0-2.0-1.0"	154	"HG02004.verkko_filt_pat.fa:haplotype2-0000813_139386576_140076845_1"	161452	169722
"ENST00000610648.1"	1736	4	1733	"+"	"HG02004.verkko_filt_pat.fa:haplotype2-0000813_139386576_140076845_1"	690269	115125	123547	1720	8422	44	"P"	531	1638	1391	1e-04	0	"HG02004.verkko_filt_pat.fa:haplotype2-0000813_139386576_140076845_1"	"AMY2B-208"	"2B"	"HG02004"	"0-3-7-9-4-6-8-5-2-4-9-7-2-5-2-4-9-7-2-5-2-4-9-7-2-5-2-4-9-7-2-5-2-1"	"0.0-3.0-7.0-9.0-4.0-6.0-8.0-5.0-2.0-4.1-9.1-7.1-2.1-5.1-2.0-4.1-9.1-7.1-2.1-5.1-2.0-4.1-9.1-7.1-2.1-5.1-2.0-4.1-9.1-7.1-2.1-5.0-2.0-1.0"	154	"HG02004.verkko_filt_pat.fa:haplotype2-0000813_139386576_140076845_1"	115125	123547
"ENST00000370083.9"	1785	2	1784	"+"	"HG02071.verkko_filt_mat.fa:haplotype1-0000041_103610513_104018399_0"	407886	293774	302566	1769	8792	0	"P"	557	1686	1686	1e-04	0	"HG02071.verkko_filt_mat.fa:haplotype1-0000041_103610513_104018399_0"	"AMY1A-201"	"1"	"HG02071"	"0-3-7-9-4-6-8-5-2-4-9-7-2-5-2-1"	"0.0-3.0-7.0-9.0-4.0-6.0-8.0-5.0-2.0-4.1-9.1-7.1-2.1-5.0-2.0-1.0"	99	"HG02071.verkko_filt_mat.fa:haplotype1-0000041_103610513_104018399_0"	293774	302566
"ENST00000370083.9"	1785	2	1784	"-"	"HG02071.verkko_filt_mat.fa:haplotype1-0000041_103610513_104018399_0"	407886	231301	240094	1769	8793	0	"S"	557	1686	NA	1e-04	0	"HG02071.verkko_filt_mat.fa:haplotype1-0000041_103610513_104018399_0"	"AMY1A-201"	"1"	"HG02071"	"0-3-7-9-4-6-8-5-2-4-9-7-2-5-2-1"	"0.0-3.0-7.0-9.0-4.0-6.0-8.0-5.0-2.0-4.1-9.1-7.1-2.1-5.0-2.0-1.0"	99	"HG02071.verkko_filt_mat.fa:haplotype1-0000041_103610513_104018399_0"	231301	240094
"ENST00000370083.9"	1785	2	1784	"+"	"HG02071.verkko_filt_mat.fa:haplotype1-0000041_103610513_104018399_0"	407886	199645	208437	1769	8792	0	"S"	557	1686	NA	1e-04	0	"HG02071.verkko_filt_mat.fa:haplotype1-0000041_103610513_104018399_0"	"AMY1A-201"	"1"	"HG02071"	"0-3-7-9-4-6-8-5-2-4-9-7-2-5-2-1"	"0.0-3.0-7.0-9.0-4.0-6.0-8.0-5.0-2.0-4.1-9.1-7.1-2.1-5.0-2.0-1.0"	99	"HG02071.verkko_filt_mat.fa:haplotype1-0000041_103610513_104018399_0"	199645	208437
"ENST00000414303.7"	1584	4	1583	"+"	"HG02071.verkko_filt_mat.fa:haplotype1-0000041_103610513_104018399_0"	407886	161391	169661	1572	8270	30	"P"	486	1497	1342	8e-04	0	"HG02071.verkko_filt_mat.fa:haplotype1-0000041_103610513_104018399_0"	"AMY2A-201"	"2A"	"HG02071"	"0-3-7-9-4-6-8-5-2-4-9-7-2-5-2-1"	"0.0-3.0-7.0-9.0-4.0-6.0-8.0-5.0-2.0-4.1-9.1-7.1-2.1-5.0-2.0-1.0"	99	"HG02071.verkko_filt_mat.fa:haplotype1-0000041_103610513_104018399_0"	161391	169661
"ENST00000610648.1"	1736	4	1733	"+"	"HG02071.verkko_filt_mat.fa:haplotype1-0000041_103610513_104018399_0"	407886	115063	123487	1720	8424	48	"P"	531	1638	1371	1e-04	0	"HG02071.verkko_filt_mat.fa:haplotype1-0000041_103610513_104018399_0"	"AMY2B-208"	"2B"	"HG02071"	"0-3-7-9-4-6-8-5-2-4-9-7-2-5-2-1"	"0.0-3.0-7.0-9.0-4.0-6.0-8.0-5.0-2.0-4.1-9.1-7.1-2.1-5.0-2.0-1.0"	99	"HG02071.verkko_filt_mat.fa:haplotype1-0000041_103610513_104018399_0"	115063	123487
"ENST00000370083.9"	1785	2	1784	"+"	"HG02004.verkko_filt_mat.fa:haplotype1-0000022_97828542_98235483_0"	406941	293765	302557	1769	8792	0	"P"	557	1686	1686	1e-04	0	"HG02004.verkko_filt_mat.fa:haplotype1-0000022_97828542_98235483_0"	"AMY1A-201"	"1"	"HG02004"	"0-3-7-9-4-6-8-5-2-4-9-7-2-5-2-1"	"0.0-3.0-7.0-9.0-4.0-6.0-8.0-5.0-2.0-4.1-9.1-7.1-2.1-5.1-2.0-1.0"	99	"HG02004.verkko_filt_mat.fa:haplotype1-0000022_97828542_98235483_0"	293765	302557
"ENST00000370083.9"	1785	2	1784	"+"	"HG02004.verkko_filt_mat.fa:haplotype1-0000022_97828542_98235483_0"	406941	199617	208410	1769	8793	0	"S"	557	1686	NA	1e-04	0	"HG02004.verkko_filt_mat.fa:haplotype1-0000022_97828542_98235483_0"	"AMY1A-201"	"1"	"HG02004"	"0-3-7-9-4-6-8-5-2-4-9-7-2-5-2-1"	"0.0-3.0-7.0-9.0-4.0-6.0-8.0-5.0-2.0-4.1-9.1-7.1-2.1-5.1-2.0-1.0"	99	"HG02004.verkko_filt_mat.fa:haplotype1-0000022_97828542_98235483_0"	199617	208410
"ENST00000370083.9"	1785	2	1784	"-"	"HG02004.verkko_filt_mat.fa:haplotype1-0000022_97828542_98235483_0"	406941	231279	240072	1769	8793	0	"S"	557	1686	NA	1e-04	0	"HG02004.verkko_filt_mat.fa:haplotype1-0000022_97828542_98235483_0"	"AMY1A-201"	"1"	"HG02004"	"0-3-7-9-4-6-8-5-2-4-9-7-2-5-2-1"	"0.0-3.0-7.0-9.0-4.0-6.0-8.0-5.0-2.0-4.1-9.1-7.1-2.1-5.1-2.0-1.0"	99	"HG02004.verkko_filt_mat.fa:haplotype1-0000022_97828542_98235483_0"	231279	240072
"ENST00000414303.7"	1584	4	1583	"+"	"HG02004.verkko_filt_mat.fa:haplotype1-0000022_97828542_98235483_0"	406941	161361	169631	1574	8270	30	"P"	491	1499	1342	1e-04	0	"HG02004.verkko_filt_mat.fa:haplotype1-0000022_97828542_98235483_0"	"AMY2A-201"	"2A"	"HG02004"	"0-3-7-9-4-6-8-5-2-4-9-7-2-5-2-1"	"0.0-3.0-7.0-9.0-4.0-6.0-8.0-5.0-2.0-4.1-9.1-7.1-2.1-5.1-2.0-1.0"	99	"HG02004.verkko_filt_mat.fa:haplotype1-0000022_97828542_98235483_0"	161361	169631
"ENST00000610648.1"	1736	4	1733	"+"	"HG02004.verkko_filt_mat.fa:haplotype1-0000022_97828542_98235483_0"	406941	115030	123450	1720	8420	48	"P"	531	1638	1371	1e-04	0	"HG02004.verkko_filt_mat.fa:haplotype1-0000022_97828542_98235483_0"	"AMY2B-208"	"2B"	"HG02004"	"0-3-7-9-4-6-8-5-2-4-9-7-2-5-2-1"	"0.0-3.0-7.0-9.0-4.0-6.0-8.0-5.0-2.0-4.1-9.1-7.1-2.1-5.1-2.0-1.0"	99	"HG02004.verkko_filt_mat.fa:haplotype1-0000022_97828542_98235483_0"	115030	123450
"ENST00000370083.9"	1785	2	1779	"+"	"HG03710.verkko_filt_mat.fa:haplotype1-0000029_102593394_102907063_0"	313669	199592	208377	1761	8785	50	"P"	551	1678	1393	7e-04	0	"HG03710.verkko_filt_mat.fa:haplotype1-0000029_102593394_102907063_0"	"AMY1A-201"	"1"	"HG03710"	"0-3-7-9-4-6-8-5-2-1"	"0.0-3.0-7.0-9.0-4.0-6.0-8.0-5.0-2.0-1.0"	98	"HG03710.verkko_filt_mat.fa:haplotype1-0000029_102593394_102907063_0"	199592	208377
"ENST00000414303.7"	1584	4	1583	"+"	"HG03710.verkko_filt_mat.fa:haplotype1-0000029_102593394_102907063_0"	313669	161336	169606	1563	8270	28	"P"	488	1488	1342	5e-04	0	"HG03710.verkko_filt_mat.fa:haplotype1-0000029_102593394_102907063_0"	"AMY2A-201"	"2A"	"HG03710"	"0-3-7-9-4-6-8-5-2-1"	"0.0-3.0-7.0-9.0-4.0-6.0-8.0-5.0-2.0-1.0"	98	"HG03710.verkko_filt_mat.fa:haplotype1-0000029_102593394_102907063_0"	161336	169606
"ENST00000610648.1"	1736	4	1733	"+"	"HG03710.verkko_filt_mat.fa:haplotype1-0000029_102593394_102907063_0"	313669	115005	123427	1720	8422	52	"P"	531	1638	1347	1e-04	0	"HG03710.verkko_filt_mat.fa:haplotype1-0000029_102593394_102907063_0"	"AMY2B-208"	"2B"	"HG03710"	"0-3-7-9-4-6-8-5-2-1"	"0.0-3.0-7.0-9.0-4.0-6.0-8.0-5.0-2.0-1.0"	98	"HG03710.verkko_filt_mat.fa:haplotype1-0000029_102593394_102907063_0"	115005	123427
"ENST00000370083.9"	1785	2	1784	"+"	"HG03710.verkko_filt_pat.fa:haplotype2-0000488_101614437_102218208_0"	603771	490680	499459	1769	8779	0	"P"	557	1686	1686	1e-04	0	"HG03710.verkko_filt_pat.fa:haplotype2-0000488_101614437_102218208_0"	"AMY1A-201"	"1"	"HG03710"	"0-3-7-9-4-6-8-5-2-4-4-2-5-2-4-4-2-5-2-4-4-2-5-2-1"	"0.0-3.0-7.0-9.0-4.0-6.0-8.0-5.0-2.0-4.1-4.0-2.1-5.0-2.0-4.1-4.0-2.1-5.1-2.0-4.1-4.0-2.1-5.0-2.0-1.0"	98	"HG03710.verkko_filt_pat.fa:haplotype2-0000488_101614437_102218208_0"	490680	499459
"ENST00000370083.9"	1785	2	1784	"-"	"HG03710.verkko_filt_pat.fa:haplotype2-0000488_101614437_102218208_0"	603771	331159	339949	1769	8790	0	"S"	557	1686	NA	1e-04	0	"HG03710.verkko_filt_pat.fa:haplotype2-0000488_101614437_102218208_0"	"AMY1A-201"	"1"	"HG03710"	"0-3-7-9-4-6-8-5-2-4-4-2-5-2-4-4-2-5-2-4-4-2-5-2-1"	"0.0-3.0-7.0-9.0-4.0-6.0-8.0-5.0-2.0-4.1-4.0-2.1-5.0-2.0-4.1-4.0-2.1-5.1-2.0-4.1-4.0-2.1-5.0-2.0-1.0"	98	"HG03710.verkko_filt_pat.fa:haplotype2-0000488_101614437_102218208_0"	331159	339949
"ENST00000370083.9"	1785	2	1784	"+"	"HG03710.verkko_filt_pat.fa:haplotype2-0000488_101614437_102218208_0"	603771	199577	208367	1769	8790	0	"S"	557	1686	NA	1e-04	0	"HG03710.verkko_filt_pat.fa:haplotype2-0000488_101614437_102218208_0"	"AMY1A-201"	"1"	"HG03710"	"0-3-7-9-4-6-8-5-2-4-4-2-5-2-4-4-2-5-2-4-4-2-5-2-1"	"0.0-3.0-7.0-9.0-4.0-6.0-8.0-5.0-2.0-4.1-4.0-2.1-5.0-2.0-4.1-4.0-2.1-5.1-2.0-4.1-4.0-2.1-5.0-2.0-1.0"	98	"HG03710.verkko_filt_pat.fa:haplotype2-0000488_101614437_102218208_0"	199577	208367
"ENST00000370083.9"	1785	2	1784	"+"	"HG03710.verkko_filt_pat.fa:haplotype2-0000488_101614437_102218208_0"	603771	393642	402433	1769	8791	0	"S"	557	1686	NA	1e-04	0	"HG03710.verkko_filt_pat.fa:haplotype2-0000488_101614437_102218208_0"	"AMY1A-201"	"1"	"HG03710"	"0-3-7-9-4-6-8-5-2-4-4-2-5-2-4-4-2-5-2-4-4-2-5-2-1"	"0.0-3.0-7.0-9.0-4.0-6.0-8.0-5.0-2.0-4.1-4.0-2.1-5.0-2.0-4.1-4.0-2.1-5.1-2.0-4.1-4.0-2.1-5.0-2.0-1.0"	98	"HG03710.verkko_filt_pat.fa:haplotype2-0000488_101614437_102218208_0"	393642	402433
"ENST00000370083.9"	1785	2	1784	"+"	"HG03710.verkko_filt_pat.fa:haplotype2-0000488_101614437_102218208_0"	603771	296595	305396	1767	8801	0	"S"	552	1684	NA	7e-04	0	"HG03710.verkko_filt_pat.fa:haplotype2-0000488_101614437_102218208_0"	"AMY1A-201"	"1"	"HG03710"	"0-3-7-9-4-6-8-5-2-4-4-2-5-2-4-4-2-5-2-4-4-2-5-2-1"	"0.0-3.0-7.0-9.0-4.0-6.0-8.0-5.0-2.0-4.1-4.0-2.1-5.0-2.0-4.1-4.0-2.1-5.1-2.0-4.1-4.0-2.1-5.0-2.0-1.0"	98	"HG03710.verkko_filt_pat.fa:haplotype2-0000488_101614437_102218208_0"	296595	305396
"ENST00000370083.9"	1785	2	1784	"-"	"HG03710.verkko_filt_pat.fa:haplotype2-0000488_101614437_102218208_0"	603771	234129	242909	1765	8780	0	"S"	553	1682	NA	6e-04	0	"HG03710.verkko_filt_pat.fa:haplotype2-0000488_101614437_102218208_0"	"AMY1A-201"	"1"	"HG03710"	"0-3-7-9-4-6-8-5-2-4-4-2-5-2-4-4-2-5-2-4-4-2-5-2-1"	"0.0-3.0-7.0-9.0-4.0-6.0-8.0-5.0-2.0-4.1-4.0-2.1-5.0-2.0-4.1-4.0-2.1-5.1-2.0-4.1-4.0-2.1-5.0-2.0-1.0"	98	"HG03710.verkko_filt_pat.fa:haplotype2-0000488_101614437_102218208_0"	234129	242909
"ENST00000370083.9"	1785	2	1784	"-"	"HG03710.verkko_filt_pat.fa:haplotype2-0000488_101614437_102218208_0"	603771	428192	436982	1763	8790	0	"S"	546	1680	NA	0.0014	0	"HG03710.verkko_filt_pat.fa:haplotype2-0000488_101614437_102218208_0"	"AMY1A-201"	"1"	"HG03710"	"0-3-7-9-4-6-8-5-2-4-4-2-5-2-4-4-2-5-2-4-4-2-5-2-1"	"0.0-3.0-7.0-9.0-4.0-6.0-8.0-5.0-2.0-4.1-4.0-2.1-5.0-2.0-4.1-4.0-2.1-5.1-2.0-4.1-4.0-2.1-5.0-2.0-1.0"	98	"HG03710.verkko_filt_pat.fa:haplotype2-0000488_101614437_102218208_0"	428192	436982
"ENST00000414303.7"	1584	4	1583	"+"	"HG03710.verkko_filt_pat.fa:haplotype2-0000488_101614437_102218208_0"	603771	161315	169585	1563	8270	11	"P"	488	1488	1431	5e-04	0	"HG03710.verkko_filt_pat.fa:haplotype2-0000488_101614437_102218208_0"	"AMY2A-201"	"2A"	"HG03710"	"0-3-7-9-4-6-8-5-2-4-4-2-5-2-4-4-2-5-2-4-4-2-5-2-1"	"0.0-3.0-7.0-9.0-4.0-6.0-8.0-5.0-2.0-4.1-4.0-2.1-5.0-2.0-4.1-4.0-2.1-5.1-2.0-4.1-4.0-2.1-5.0-2.0-1.0"	98	"HG03710.verkko_filt_pat.fa:haplotype2-0000488_101614437_102218208_0"	161315	169585
"ENST00000610648.1"	1736	4	1733	"+"	"HG03710.verkko_filt_pat.fa:haplotype2-0000488_101614437_102218208_0"	603771	114977	123399	1718	8422	45	"P"	527	1636	1386	1e-04	0	"HG03710.verkko_filt_pat.fa:haplotype2-0000488_101614437_102218208_0"	"AMY2B-208"	"2B"	"HG03710"	"0-3-7-9-4-6-8-5-2-4-4-2-5-2-4-4-2-5-2-4-4-2-5-2-1"	"0.0-3.0-7.0-9.0-4.0-6.0-8.0-5.0-2.0-4.1-4.0-2.1-5.0-2.0-4.1-4.0-2.1-5.1-2.0-4.1-4.0-2.1-5.0-2.0-1.0"	98	"HG03710.verkko_filt_pat.fa:haplotype2-0000488_101614437_102218208_0"	114977	123399
"ENST00000370083.9"	1785	2	1784	"+"	"HG03927.verkko_filt_mat.fa:haplotype1-0000009_134765170_135173010_1"	407840	293840	302631	1769	8791	0	"P"	557	1686	1686	1e-04	0	"HG03927.verkko_filt_mat.fa:haplotype1-0000009_134765170_135173010_1"	"AMY1A-201"	"1"	"HG03927"	"0-3-7-9-4-6-8-5-2-7-9-4-2-5-2-1"	"0.0-3.0-7.0-9.0-4.0-6.0-8.0-5.0-2.0-7.0-9.0-4.0-2.1-5.1-2.0-1.0"	154	"HG03927.verkko_filt_mat.fa:haplotype1-0000009_134765170_135173010_1"	293840	302631
"ENST00000370083.9"	1785	2	1784	"+"	"HG03927.verkko_filt_mat.fa:haplotype1-0000009_134765170_135173010_1"	407840	199712	208503	1769	8791	0	"S"	557	1686	NA	1e-04	0	"HG03927.verkko_filt_mat.fa:haplotype1-0000009_134765170_135173010_1"	"AMY1A-201"	"1"	"HG03927"	"0-3-7-9-4-6-8-5-2-7-9-4-2-5-2-1"	"0.0-3.0-7.0-9.0-4.0-6.0-8.0-5.0-2.0-7.0-9.0-4.0-2.1-5.1-2.0-1.0"	154	"HG03927.verkko_filt_mat.fa:haplotype1-0000009_134765170_135173010_1"	199712	208503
"ENST00000370083.9"	1785	2	1784	"-"	"HG03927.verkko_filt_mat.fa:haplotype1-0000009_134765170_135173010_1"	407840	231365	240158	1769	8793	0	"S"	557	1686	NA	1e-04	0	"HG03927.verkko_filt_mat.fa:haplotype1-0000009_134765170_135173010_1"	"AMY1A-201"	"1"	"HG03927"	"0-3-7-9-4-6-8-5-2-7-9-4-2-5-2-1"	"0.0-3.0-7.0-9.0-4.0-6.0-8.0-5.0-2.0-7.0-9.0-4.0-2.1-5.1-2.0-1.0"	154	"HG03927.verkko_filt_mat.fa:haplotype1-0000009_134765170_135173010_1"	231365	240158
"ENST00000414303.7"	1584	4	1583	"+"	"HG03927.verkko_filt_mat.fa:haplotype1-0000009_134765170_135173010_1"	407840	161458	169728	1574	8270	30	"P"	491	1499	1342	1e-04	0	"HG03927.verkko_filt_mat.fa:haplotype1-0000009_134765170_135173010_1"	"AMY2A-201"	"2A"	"HG03927"	"0-3-7-9-4-6-8-5-2-7-9-4-2-5-2-1"	"0.0-3.0-7.0-9.0-4.0-6.0-8.0-5.0-2.0-7.0-9.0-4.0-2.1-5.1-2.0-1.0"	154	"HG03927.verkko_filt_mat.fa:haplotype1-0000009_134765170_135173010_1"	161458	169728
"ENST00000610648.1"	1736	4	1733	"+"	"HG03927.verkko_filt_mat.fa:haplotype1-0000009_134765170_135173010_1"	407840	115122	123544	1720	8422	48	"P"	531	1638	1371	1e-04	0	"HG03927.verkko_filt_mat.fa:haplotype1-0000009_134765170_135173010_1"	"AMY2B-208"	"2B"	"HG03927"	"0-3-7-9-4-6-8-5-2-7-9-4-2-5-2-1"	"0.0-3.0-7.0-9.0-4.0-6.0-8.0-5.0-2.0-7.0-9.0-4.0-2.1-5.1-2.0-1.0"	154	"HG03927.verkko_filt_mat.fa:haplotype1-0000009_134765170_135173010_1"	115122	123544
"ENST00000370083.9"	1785	2	1784	"+"	"HG01099.verkko_filt_mat.fa:haplotype1-0000034_142513097_142920876_1"	407779	199675	208466	1769	8791	0	"P"	557	1686	1686	1e-04	0	"HG01099.verkko_filt_mat.fa:haplotype1-0000034_142513097_142920876_1"	"AMY1A-201"	"1"	"HG01099"	"0-3-7-9-4-6-8-5-2-4-9-7-2-5-2-1"	"0.0-3.0-7.0-9.0-4.0-6.0-8.0-5.0-2.0-4.1-9.1-7.1-2.1-5.1-2.0-1.0"	154	"HG01099.verkko_filt_mat.fa:haplotype1-0000034_142513097_142920876_1"	199675	208466
"ENST00000370083.9"	1785	2	1784	"+"	"HG01099.verkko_filt_mat.fa:haplotype1-0000034_142513097_142920876_1"	407779	293781	302572	1769	8791	0	"S"	557	1686	NA	1e-04	0	"HG01099.verkko_filt_mat.fa:haplotype1-0000034_142513097_142920876_1"	"AMY1A-201"	"1"	"HG01099"	"0-3-7-9-4-6-8-5-2-4-9-7-2-5-2-1"	"0.0-3.0-7.0-9.0-4.0-6.0-8.0-5.0-2.0-4.1-9.1-7.1-2.1-5.1-2.0-1.0"	154	"HG01099.verkko_filt_mat.fa:haplotype1-0000034_142513097_142920876_1"	293781	302572
"ENST00000370083.9"	1785	2	1784	"-"	"HG01099.verkko_filt_mat.fa:haplotype1-0000034_142513097_142920876_1"	407779	231320	240111	1769	8791	0	"S"	557	1686	NA	1e-04	0	"HG01099.verkko_filt_mat.fa:haplotype1-0000034_142513097_142920876_1"	"AMY1A-201"	"1"	"HG01099"	"0-3-7-9-4-6-8-5-2-4-9-7-2-5-2-1"	"0.0-3.0-7.0-9.0-4.0-6.0-8.0-5.0-2.0-4.1-9.1-7.1-2.1-5.1-2.0-1.0"	154	"HG01099.verkko_filt_mat.fa:haplotype1-0000034_142513097_142920876_1"	231320	240111
"ENST00000414303.7"	1584	4	1579	"+"	"HG01099.verkko_filt_mat.fa:haplotype1-0000034_142513097_142920876_1"	407779	161420	169686	1559	8266	27	"P"	483	1484	1342	0.0011	0	"HG01099.verkko_filt_mat.fa:haplotype1-0000034_142513097_142920876_1"	"AMY2A-201"	"2A"	"HG01099"	"0-3-7-9-4-6-8-5-2-4-9-7-2-5-2-1"	"0.0-3.0-7.0-9.0-4.0-6.0-8.0-5.0-2.0-4.1-9.1-7.1-2.1-5.1-2.0-1.0"	154	"HG01099.verkko_filt_mat.fa:haplotype1-0000034_142513097_142920876_1"	161420	169686
"ENST00000610648.1"	1736	4	1733	"+"	"HG01099.verkko_filt_mat.fa:haplotype1-0000034_142513097_142920876_1"	407779	115100	123522	1720	8422	48	"P"	531	1638	1371	1e-04	0	"HG01099.verkko_filt_mat.fa:haplotype1-0000034_142513097_142920876_1"	"AMY2B-208"	"2B"	"HG01099"	"0-3-7-9-4-6-8-5-2-4-9-7-2-5-2-1"	"0.0-3.0-7.0-9.0-4.0-6.0-8.0-5.0-2.0-4.1-9.1-7.1-2.1-5.1-2.0-1.0"	154	"HG01099.verkko_filt_mat.fa:haplotype1-0000034_142513097_142920876_1"	115100	123522
"ENST00000370083.9"	1785	2	1784	"+"	"HG02647.verkko_filt_pat.fa:haplotype2-0000857_103738150_104051769_0"	313619	199570	208360	1753	8790	45	"P"	553	1670	1415	6e-04	0	"HG02647.verkko_filt_pat.fa:haplotype2-0000857_103738150_104051769_0"	"AMY1A-201"	"1"	"HG02647"	"0-3-7-9-4-6-8-5-2-1"	"0.0-3.0-7.0-9.0-4.0-6.0-8.0-5.0-2.0-1.0"	98	"HG02647.verkko_filt_pat.fa:haplotype2-0000857_103738150_104051769_0"	199570	208360
"ENST00000414303.7"	1584	4	1583	"+"	"HG02647.verkko_filt_pat.fa:haplotype2-0000857_103738150_104051769_0"	313619	161311	169581	1569	8270	29	"P"	486	1494	1342	1e-04	0	"HG02647.verkko_filt_pat.fa:haplotype2-0000857_103738150_104051769_0"	"AMY2A-201"	"2A"	"HG02647"	"0-3-7-9-4-6-8-5-2-1"	"0.0-3.0-7.0-9.0-4.0-6.0-8.0-5.0-2.0-1.0"	98	"HG02647.verkko_filt_pat.fa:haplotype2-0000857_103738150_104051769_0"	161311	169581
"ENST00000610648.1"	1736	4	1733	"+"	"HG02647.verkko_filt_pat.fa:haplotype2-0000857_103738150_104051769_0"	313619	114987	123408	1720	8421	50	"P"	531	1638	1360	1e-04	0	"HG02647.verkko_filt_pat.fa:haplotype2-0000857_103738150_104051769_0"	"AMY2B-208"	"2B"	"HG02647"	"0-3-7-9-4-6-8-5-2-1"	"0.0-3.0-7.0-9.0-4.0-6.0-8.0-5.0-2.0-1.0"	98	"HG02647.verkko_filt_pat.fa:haplotype2-0000857_103738150_104051769_0"	114987	123408
"ENST00000370083.9"	1785	2	1784	"+"	"HG02293.verkko_filt_mat.fa:haplotype1-0000039_30204405_30517145_1"	312740	199651	208441	1769	8790	49	"P"	557	1686	1404	1e-04	0	"HG02293.verkko_filt_mat.fa:haplotype1-0000039_30204405_30517145_1"	"AMY1A-201"	"1"	"HG02293"	"0-3-7-9-4-6-8-5-2-1"	"0.0-3.0-7.0-9.0-4.0-6.0-8.0-5.0-2.0-1.0"	155	"HG02293.verkko_filt_mat.fa:haplotype1-0000039_30204405_30517145_1"	199651	208441
"ENST00000414303.7"	1584	4	1583	"+"	"HG02293.verkko_filt_mat.fa:haplotype1-0000039_30204405_30517145_1"	312740	161400	169670	1574	8270	30	"P"	491	1499	1342	1e-04	0	"HG02293.verkko_filt_mat.fa:haplotype1-0000039_30204405_30517145_1"	"AMY2A-201"	"2A"	"HG02293"	"0-3-7-9-4-6-8-5-2-1"	"0.0-3.0-7.0-9.0-4.0-6.0-8.0-5.0-2.0-1.0"	155	"HG02293.verkko_filt_mat.fa:haplotype1-0000039_30204405_30517145_1"	161400	169670
"ENST00000610648.1"	1736	4	1733	"+"	"HG02293.verkko_filt_mat.fa:haplotype1-0000039_30204405_30517145_1"	312740	115070	123490	1720	8420	50	"P"	531	1638	1358	1e-04	0	"HG02293.verkko_filt_mat.fa:haplotype1-0000039_30204405_30517145_1"	"AMY2B-208"	"2B"	"HG02293"	"0-3-7-9-4-6-8-5-2-1"	"0.0-3.0-7.0-9.0-4.0-6.0-8.0-5.0-2.0-1.0"	155	"HG02293.verkko_filt_mat.fa:haplotype1-0000039_30204405_30517145_1"	115070	123490
"ENST00000370083.9"	1785	2	1784	"+"	"HG02300.verkko_filt_mat.fa:haplotype1-0000028_144052837_144460586_1"	407749	293752	302543	1769	8791	0	"P"	557	1686	1686	1e-04	0	"HG02300.verkko_filt_mat.fa:haplotype1-0000028_144052837_144460586_1"	"AMY1A-201"	"1"	"HG02300"	"0-3-7-9-4-6-8-5-2-4-9-7-2-5-2-1"	"0.0-3.0-7.0-9.0-4.0-6.0-8.0-5.0-2.0-4.1-9.1-7.1-2.1-5.1-2.0-1.0"	154	"HG02300.verkko_filt_mat.fa:haplotype1-0000028_144052837_144460586_1"	293752	302543
"ENST00000370083.9"	1785	2	1784	"+"	"HG02300.verkko_filt_mat.fa:haplotype1-0000028_144052837_144460586_1"	407749	199640	208431	1769	8791	0	"S"	557	1686	NA	1e-04	0	"HG02300.verkko_filt_mat.fa:haplotype1-0000028_144052837_144460586_1"	"AMY1A-201"	"1"	"HG02300"	"0-3-7-9-4-6-8-5-2-4-9-7-2-5-2-1"	"0.0-3.0-7.0-9.0-4.0-6.0-8.0-5.0-2.0-4.1-9.1-7.1-2.1-5.1-2.0-1.0"	154	"HG02300.verkko_filt_mat.fa:haplotype1-0000028_144052837_144460586_1"	199640	208431
"ENST00000370083.9"	1785	2	1784	"-"	"HG02300.verkko_filt_mat.fa:haplotype1-0000028_144052837_144460586_1"	407749	231290	240081	1769	8791	0	"S"	557	1686	NA	1e-04	0	"HG02300.verkko_filt_mat.fa:haplotype1-0000028_144052837_144460586_1"	"AMY1A-201"	"1"	"HG02300"	"0-3-7-9-4-6-8-5-2-4-9-7-2-5-2-1"	"0.0-3.0-7.0-9.0-4.0-6.0-8.0-5.0-2.0-4.1-9.1-7.1-2.1-5.1-2.0-1.0"	154	"HG02300.verkko_filt_mat.fa:haplotype1-0000028_144052837_144460586_1"	231290	240081
"ENST00000414303.7"	1584	4	1579	"+"	"HG02300.verkko_filt_mat.fa:haplotype1-0000028_144052837_144460586_1"	407749	161385	169651	1559	8266	27	"P"	483	1484	1342	0.0011	0	"HG02300.verkko_filt_mat.fa:haplotype1-0000028_144052837_144460586_1"	"AMY2A-201"	"2A"	"HG02300"	"0-3-7-9-4-6-8-5-2-4-9-7-2-5-2-1"	"0.0-3.0-7.0-9.0-4.0-6.0-8.0-5.0-2.0-4.1-9.1-7.1-2.1-5.1-2.0-1.0"	154	"HG02300.verkko_filt_mat.fa:haplotype1-0000028_144052837_144460586_1"	161385	169651
"ENST00000610648.1"	1736	4	1733	"+"	"HG02300.verkko_filt_mat.fa:haplotype1-0000028_144052837_144460586_1"	407749	115067	123489	1720	8422	48	"P"	531	1638	1371	1e-04	0	"HG02300.verkko_filt_mat.fa:haplotype1-0000028_144052837_144460586_1"	"AMY2B-208"	"2B"	"HG02300"	"0-3-7-9-4-6-8-5-2-4-9-7-2-5-2-1"	"0.0-3.0-7.0-9.0-4.0-6.0-8.0-5.0-2.0-4.1-9.1-7.1-2.1-5.1-2.0-1.0"	154	"HG02300.verkko_filt_mat.fa:haplotype1-0000028_144052837_144460586_1"	115067	123489
"ENST00000370083.9"	1785	2	1784	"+"	"HG02809.verkko_filt_mat.fa:haplotype1-0000023_94161320_94589755_0"	428435	199598	208378	1769	8780	0	"P"	557	1686	1686	1e-04	0	"HG02809.verkko_filt_mat.fa:haplotype1-0000023_94161320_94589755_0"	"AMY1A-201"	"1"	"HG02809"	"0-3-7-9-4-6-8-5-2-4-0-3-7-9-4-6-8-5-2-1"	"0.0-3.0-7.0-9.0-4.0-6.0-8.0-5.0-2.0-4.1-0.0-3.0-7.0-9.0-4.0-6.0-8.0-5.0-2.0-1.0"	98	"HG02809.verkko_filt_mat.fa:haplotype1-0000023_94161320_94589755_0"	199598	208378
"ENST00000370083.9"	1785	2	1784	"+"	"HG02809.verkko_filt_mat.fa:haplotype1-0000023_94161320_94589755_0"	428435	315342	324122	1769	8780	0	"S"	557	1686	NA	1e-04	0	"HG02809.verkko_filt_mat.fa:haplotype1-0000023_94161320_94589755_0"	"AMY1A-201"	"1"	"HG02809"	"0-3-7-9-4-6-8-5-2-4-0-3-7-9-4-6-8-5-2-1"	"0.0-3.0-7.0-9.0-4.0-6.0-8.0-5.0-2.0-4.1-0.0-3.0-7.0-9.0-4.0-6.0-8.0-5.0-2.0-1.0"	98	"HG02809.verkko_filt_mat.fa:haplotype1-0000023_94161320_94589755_0"	315342	324122
"ENST00000414303.7"	1584	4	1583	"+"	"HG02809.verkko_filt_mat.fa:haplotype1-0000023_94161320_94589755_0"	428435	277087	285357	1563	8270	0	"P"	488	1488	1488	5e-04	0	"HG02809.verkko_filt_mat.fa:haplotype1-0000023_94161320_94589755_0"	"AMY2A-201"	"2A"	"HG02809"	"0-3-7-9-4-6-8-5-2-4-0-3-7-9-4-6-8-5-2-1"	"0.0-3.0-7.0-9.0-4.0-6.0-8.0-5.0-2.0-4.1-0.0-3.0-7.0-9.0-4.0-6.0-8.0-5.0-2.0-1.0"	98	"HG02809.verkko_filt_mat.fa:haplotype1-0000023_94161320_94589755_0"	277087	285357
"ENST00000414303.7"	1584	4	1583	"+"	"HG02809.verkko_filt_mat.fa:haplotype1-0000023_94161320_94589755_0"	428435	161334	169609	1563	8275	0	"S"	488	1488	NA	5e-04	0	"HG02809.verkko_filt_mat.fa:haplotype1-0000023_94161320_94589755_0"	"AMY2A-201"	"2A"	"HG02809"	"0-3-7-9-4-6-8-5-2-4-0-3-7-9-4-6-8-5-2-1"	"0.0-3.0-7.0-9.0-4.0-6.0-8.0-5.0-2.0-4.1-0.0-3.0-7.0-9.0-4.0-6.0-8.0-5.0-2.0-1.0"	98	"HG02809.verkko_filt_mat.fa:haplotype1-0000023_94161320_94589755_0"	161334	169609
"ENST00000610648.1"	1736	4	1733	"+"	"HG02809.verkko_filt_mat.fa:haplotype1-0000023_94161320_94589755_0"	428435	114994	123416	1720	8422	0	"P"	531	1638	1636	1e-04	0	"HG02809.verkko_filt_mat.fa:haplotype1-0000023_94161320_94589755_0"	"AMY2B-208"	"2B"	"HG02809"	"0-3-7-9-4-6-8-5-2-4-0-3-7-9-4-6-8-5-2-1"	"0.0-3.0-7.0-9.0-4.0-6.0-8.0-5.0-2.0-4.1-0.0-3.0-7.0-9.0-4.0-6.0-8.0-5.0-2.0-1.0"	98	"HG02809.verkko_filt_mat.fa:haplotype1-0000023_94161320_94589755_0"	114994	123416
"ENST00000610648.1"	1736	4	1733	"+"	"HG02809.verkko_filt_mat.fa:haplotype1-0000023_94161320_94589755_0"	428435	230755	239177	1718	8422	0	"S"	524	1636	NA	0.001	0	"HG02809.verkko_filt_mat.fa:haplotype1-0000023_94161320_94589755_0"	"AMY2B-208"	"2B"	"HG02809"	"0-3-7-9-4-6-8-5-2-4-0-3-7-9-4-6-8-5-2-1"	"0.0-3.0-7.0-9.0-4.0-6.0-8.0-5.0-2.0-4.1-0.0-3.0-7.0-9.0-4.0-6.0-8.0-5.0-2.0-1.0"	98	"HG02809.verkko_filt_mat.fa:haplotype1-0000023_94161320_94589755_0"	230755	239177
"ENST00000370083.9"	1785	2	1784	"-"	"HG002.verkko_filt_mat.fa:haplotype1-0000005_138228497_138636354_1"	407857	231347	240140	1769	8793	0	"P"	557	1686	1686	2e-04	0	"HG002.verkko_filt_mat.fa:haplotype1-0000005_138228497_138636354_1"	"AMY1A-201"	"1"	"HG002"	"0-3-7-9-4-6-8-5-2-4-9-7-2-5-2-1"	"0.0-3.0-7.0-9.0-4.0-6.0-8.0-5.0-2.0-4.1-9.1-7.1-2.1-5.0-2.0-1.0"	154	"HG002.verkko_filt_mat.fa:haplotype1-0000005_138228497_138636354_1"	231347	240140
"ENST00000370083.9"	1785	2	1784	"+"	"HG002.verkko_filt_mat.fa:haplotype1-0000005_138228497_138636354_1"	407857	293818	302609	1769	8791	0	"S"	558	1686	NA	1e-04	0	"HG002.verkko_filt_mat.fa:haplotype1-0000005_138228497_138636354_1"	"AMY1A-201"	"1"	"HG002"	"0-3-7-9-4-6-8-5-2-4-9-7-2-5-2-1"	"0.0-3.0-7.0-9.0-4.0-6.0-8.0-5.0-2.0-4.1-9.1-7.1-2.1-5.0-2.0-1.0"	154	"HG002.verkko_filt_mat.fa:haplotype1-0000005_138228497_138636354_1"	293818	302609
"ENST00000370083.9"	1785	2	1784	"+"	"HG002.verkko_filt_mat.fa:haplotype1-0000005_138228497_138636354_1"	407857	199682	208475	1769	8793	0	"S"	557	1686	NA	2e-04	0	"HG002.verkko_filt_mat.fa:haplotype1-0000005_138228497_138636354_1"	"AMY1A-201"	"1"	"HG002"	"0-3-7-9-4-6-8-5-2-4-9-7-2-5-2-1"	"0.0-3.0-7.0-9.0-4.0-6.0-8.0-5.0-2.0-4.1-9.1-7.1-2.1-5.0-2.0-1.0"	154	"HG002.verkko_filt_mat.fa:haplotype1-0000005_138228497_138636354_1"	199682	208475
"ENST00000414303.7"	1584	4	1583	"+"	"HG002.verkko_filt_mat.fa:haplotype1-0000005_138228497_138636354_1"	407857	161432	169702	1574	8270	30	"P"	491	1499	1342	3e-04	0	"HG002.verkko_filt_mat.fa:haplotype1-0000005_138228497_138636354_1"	"AMY2A-201"	"2A"	"HG002"	"0-3-7-9-4-6-8-5-2-4-9-7-2-5-2-1"	"0.0-3.0-7.0-9.0-4.0-6.0-8.0-5.0-2.0-4.1-9.1-7.1-2.1-5.0-2.0-1.0"	154	"HG002.verkko_filt_mat.fa:haplotype1-0000005_138228497_138636354_1"	161432	169702
"ENST00000610648.1"	1736	4	1733	"+"	"HG002.verkko_filt_mat.fa:haplotype1-0000005_138228497_138636354_1"	407857	115106	123528	1720	8422	48	"P"	531	1638	1371	3e-04	0	"HG002.verkko_filt_mat.fa:haplotype1-0000005_138228497_138636354_1"	"AMY2B-208"	"2B"	"HG002"	"0-3-7-9-4-6-8-5-2-4-9-7-2-5-2-1"	"0.0-3.0-7.0-9.0-4.0-6.0-8.0-5.0-2.0-4.1-9.1-7.1-2.1-5.0-2.0-1.0"	154	"HG002.verkko_filt_mat.fa:haplotype1-0000005_138228497_138636354_1"	115106	123528
"ENST00000370083.9"	1785	2	1784	"+"	"HG02300.verkko_filt_pat.fa:haplotype2-0000620_143362344_143769323_1"	406979	293838	302630	1769	8792	0	"P"	557	1686	1686	1e-04	0	"HG02300.verkko_filt_pat.fa:haplotype2-0000620_143362344_143769323_1"	"AMY1A-201"	"1"	"HG02300"	"0-3-7-9-4-6-8-5-2-4-9-7-2-5-2-1"	"0.0-3.0-7.0-9.0-4.0-6.0-8.0-5.0-2.0-4.1-9.1-7.1-2.1-5.0-2.0-1.0"	155	"HG02300.verkko_filt_pat.fa:haplotype2-0000620_143362344_143769323_1"	293838	302630
"ENST00000370083.9"	1785	2	1784	"+"	"HG02300.verkko_filt_pat.fa:haplotype2-0000620_143362344_143769323_1"	406979	199721	208513	1769	8792	0	"S"	557	1686	NA	1e-04	0	"HG02300.verkko_filt_pat.fa:haplotype2-0000620_143362344_143769323_1"	"AMY1A-201"	"1"	"HG02300"	"0-3-7-9-4-6-8-5-2-4-9-7-2-5-2-1"	"0.0-3.0-7.0-9.0-4.0-6.0-8.0-5.0-2.0-4.1-9.1-7.1-2.1-5.0-2.0-1.0"	155	"HG02300.verkko_filt_pat.fa:haplotype2-0000620_143362344_143769323_1"	199721	208513
"ENST00000370083.9"	1785	2	1784	"-"	"HG02300.verkko_filt_pat.fa:haplotype2-0000620_143362344_143769323_1"	406979	231376	240168	1769	8792	0	"S"	557	1686	NA	1e-04	0	"HG02300.verkko_filt_pat.fa:haplotype2-0000620_143362344_143769323_1"	"AMY1A-201"	"1"	"HG02300"	"0-3-7-9-4-6-8-5-2-4-9-7-2-5-2-1"	"0.0-3.0-7.0-9.0-4.0-6.0-8.0-5.0-2.0-4.1-9.1-7.1-2.1-5.0-2.0-1.0"	155	"HG02300.verkko_filt_pat.fa:haplotype2-0000620_143362344_143769323_1"	231376	240168
"ENST00000414303.7"	1584	4	1583	"+"	"HG02300.verkko_filt_pat.fa:haplotype2-0000620_143362344_143769323_1"	406979	161468	169738	1574	8270	30	"P"	491	1499	1342	1e-04	0	"HG02300.verkko_filt_pat.fa:haplotype2-0000620_143362344_143769323_1"	"AMY2A-201"	"2A"	"HG02300"	"0-3-7-9-4-6-8-5-2-4-9-7-2-5-2-1"	"0.0-3.0-7.0-9.0-4.0-6.0-8.0-5.0-2.0-4.1-9.1-7.1-2.1-5.0-2.0-1.0"	155	"HG02300.verkko_filt_pat.fa:haplotype2-0000620_143362344_143769323_1"	161468	169738
"ENST00000610648.1"	1736	4	1733	"+"	"HG02300.verkko_filt_pat.fa:haplotype2-0000620_143362344_143769323_1"	406979	115144	123566	1720	8422	48	"P"	531	1638	1371	1e-04	0	"HG02300.verkko_filt_pat.fa:haplotype2-0000620_143362344_143769323_1"	"AMY2B-208"	"2B"	"HG02300"	"0-3-7-9-4-6-8-5-2-4-9-7-2-5-2-1"	"0.0-3.0-7.0-9.0-4.0-6.0-8.0-5.0-2.0-4.1-9.1-7.1-2.1-5.0-2.0-1.0"	155	"HG02300.verkko_filt_pat.fa:haplotype2-0000620_143362344_143769323_1"	115144	123566
"ENST00000370083.9"	1785	2	1784	"+"	"HG02647.verkko_filt_mat.fa:haplotype1-0000002_103892584_104321036_0"	428452	199618	208398	1769	8780	0	"P"	557	1686	1686	1e-04	0	"HG02647.verkko_filt_mat.fa:haplotype1-0000002_103892584_104321036_0"	"AMY1A-201"	"1"	"HG02647"	"0-3-7-9-4-6-8-5-2-4-0-3-7-9-4-6-8-5-2-1"	"0.0-3.0-7.0-9.0-4.0-6.0-8.0-5.0-2.0-4.1-0.0-3.0-7.0-9.0-4.0-6.0-8.0-5.0-2.0-1.0"	98	"HG02647.verkko_filt_mat.fa:haplotype1-0000002_103892584_104321036_0"	199618	208398
"ENST00000370083.9"	1785	2	1784	"+"	"HG02647.verkko_filt_mat.fa:haplotype1-0000002_103892584_104321036_0"	428452	315357	324151	1769	8794	0	"S"	557	1686	NA	1e-04	0	"HG02647.verkko_filt_mat.fa:haplotype1-0000002_103892584_104321036_0"	"AMY1A-201"	"1"	"HG02647"	"0-3-7-9-4-6-8-5-2-4-0-3-7-9-4-6-8-5-2-1"	"0.0-3.0-7.0-9.0-4.0-6.0-8.0-5.0-2.0-4.1-0.0-3.0-7.0-9.0-4.0-6.0-8.0-5.0-2.0-1.0"	98	"HG02647.verkko_filt_mat.fa:haplotype1-0000002_103892584_104321036_0"	315357	324151
"ENST00000414303.7"	1584	4	1583	"+"	"HG02647.verkko_filt_mat.fa:haplotype1-0000002_103892584_104321036_0"	428452	277101	285371	1563	8270	0	"P"	488	1488	1488	5e-04	0	"HG02647.verkko_filt_mat.fa:haplotype1-0000002_103892584_104321036_0"	"AMY2A-201"	"2A"	"HG02647"	"0-3-7-9-4-6-8-5-2-4-0-3-7-9-4-6-8-5-2-1"	"0.0-3.0-7.0-9.0-4.0-6.0-8.0-5.0-2.0-4.1-0.0-3.0-7.0-9.0-4.0-6.0-8.0-5.0-2.0-1.0"	98	"HG02647.verkko_filt_mat.fa:haplotype1-0000002_103892584_104321036_0"	277101	285371
"ENST00000414303.7"	1584	4	1583	"+"	"HG02647.verkko_filt_mat.fa:haplotype1-0000002_103892584_104321036_0"	428452	161364	169634	1563	8270	0	"S"	488	1488	NA	5e-04	0	"HG02647.verkko_filt_mat.fa:haplotype1-0000002_103892584_104321036_0"	"AMY2A-201"	"2A"	"HG02647"	"0-3-7-9-4-6-8-5-2-4-0-3-7-9-4-6-8-5-2-1"	"0.0-3.0-7.0-9.0-4.0-6.0-8.0-5.0-2.0-4.1-0.0-3.0-7.0-9.0-4.0-6.0-8.0-5.0-2.0-1.0"	98	"HG02647.verkko_filt_mat.fa:haplotype1-0000002_103892584_104321036_0"	161364	169634
"ENST00000610648.1"	1736	4	1733	"+"	"HG02647.verkko_filt_mat.fa:haplotype1-0000002_103892584_104321036_0"	428452	115025	123447	1720	8422	2	"P"	531	1638	1626	1e-04	0	"HG02647.verkko_filt_mat.fa:haplotype1-0000002_103892584_104321036_0"	"AMY2B-208"	"2B"	"HG02647"	"0-3-7-9-4-6-8-5-2-4-0-3-7-9-4-6-8-5-2-1"	"0.0-3.0-7.0-9.0-4.0-6.0-8.0-5.0-2.0-4.1-0.0-3.0-7.0-9.0-4.0-6.0-8.0-5.0-2.0-1.0"	98	"HG02647.verkko_filt_mat.fa:haplotype1-0000002_103892584_104321036_0"	115025	123447
"ENST00000610648.1"	1736	4	1733	"+"	"HG02647.verkko_filt_mat.fa:haplotype1-0000002_103892584_104321036_0"	428452	230768	239190	1708	8422	0	"S"	527	1626	NA	6e-04	0	"HG02647.verkko_filt_mat.fa:haplotype1-0000002_103892584_104321036_0"	"AMY2B-208"	"2B"	"HG02647"	"0-3-7-9-4-6-8-5-2-4-0-3-7-9-4-6-8-5-2-1"	"0.0-3.0-7.0-9.0-4.0-6.0-8.0-5.0-2.0-4.1-0.0-3.0-7.0-9.0-4.0-6.0-8.0-5.0-2.0-1.0"	98	"HG02647.verkko_filt_mat.fa:haplotype1-0000002_103892584_104321036_0"	230768	239190
"ENST00000370083.9"	1785	2	1784	"+"	"HG02071.verkko_filt_pat.fa:haplotype2-0000736_102745972_103248026_0"	502054	387969	396761	1769	8792	0	"P"	557	1686	1686	1e-04	0	"HG02071.verkko_filt_pat.fa:haplotype2-0000736_102745972_103248026_0"	"AMY1A-201"	"1"	"HG02071"	"0-3-7-9-4-6-8-5-2-4-9-7-2-5-2-4-9-7-2-5-2-1"	"0.0-3.0-7.0-9.0-4.0-6.0-8.0-5.0-2.0-4.1-9.1-7.1-2.1-5.1-2.0-4.1-9.1-7.1-2.1-5.1-2.0-1.0"	99	"HG02071.verkko_filt_pat.fa:haplotype2-0000736_102745972_103248026_0"	387969	396761
"ENST00000370083.9"	1785	2	1784	"-"	"HG02071.verkko_filt_pat.fa:haplotype2-0000736_102745972_103248026_0"	502054	325471	334264	1769	8793	0	"S"	557	1686	NA	1e-04	0	"HG02071.verkko_filt_pat.fa:haplotype2-0000736_102745972_103248026_0"	"AMY1A-201"	"1"	"HG02071"	"0-3-7-9-4-6-8-5-2-4-9-7-2-5-2-4-9-7-2-5-2-1"	"0.0-3.0-7.0-9.0-4.0-6.0-8.0-5.0-2.0-4.1-9.1-7.1-2.1-5.1-2.0-4.1-9.1-7.1-2.1-5.1-2.0-1.0"	99	"HG02071.verkko_filt_pat.fa:haplotype2-0000736_102745972_103248026_0"	325471	334264
"ENST00000370083.9"	1785	2	1784	"-"	"HG02071.verkko_filt_pat.fa:haplotype2-0000736_102745972_103248026_0"	502054	231309	240102	1769	8793	0	"S"	557	1686	NA	1e-04	0	"HG02071.verkko_filt_pat.fa:haplotype2-0000736_102745972_103248026_0"	"AMY1A-201"	"1"	"HG02071"	"0-3-7-9-4-6-8-5-2-4-9-7-2-5-2-4-9-7-2-5-2-1"	"0.0-3.0-7.0-9.0-4.0-6.0-8.0-5.0-2.0-4.1-9.1-7.1-2.1-5.1-2.0-4.1-9.1-7.1-2.1-5.1-2.0-1.0"	99	"HG02071.verkko_filt_pat.fa:haplotype2-0000736_102745972_103248026_0"	231309	240102
"ENST00000370083.9"	1785	2	1784	"+"	"HG02071.verkko_filt_pat.fa:haplotype2-0000736_102745972_103248026_0"	502054	199654	208448	1769	8794	0	"S"	557	1686	NA	1e-04	0	"HG02071.verkko_filt_pat.fa:haplotype2-0000736_102745972_103248026_0"	"AMY1A-201"	"1"	"HG02071"	"0-3-7-9-4-6-8-5-2-4-9-7-2-5-2-4-9-7-2-5-2-1"	"0.0-3.0-7.0-9.0-4.0-6.0-8.0-5.0-2.0-4.1-9.1-7.1-2.1-5.1-2.0-4.1-9.1-7.1-2.1-5.1-2.0-1.0"	99	"HG02071.verkko_filt_pat.fa:haplotype2-0000736_102745972_103248026_0"	199654	208448
"ENST00000370083.9"	1785	2	1784	"+"	"HG02071.verkko_filt_pat.fa:haplotype2-0000736_102745972_103248026_0"	502054	293802	302594	1769	8792	0	"S"	557	1686	NA	1e-04	0	"HG02071.verkko_filt_pat.fa:haplotype2-0000736_102745972_103248026_0"	"AMY1A-201"	"1"	"HG02071"	"0-3-7-9-4-6-8-5-2-4-9-7-2-5-2-4-9-7-2-5-2-1"	"0.0-3.0-7.0-9.0-4.0-6.0-8.0-5.0-2.0-4.1-9.1-7.1-2.1-5.1-2.0-4.1-9.1-7.1-2.1-5.1-2.0-1.0"	99	"HG02071.verkko_filt_pat.fa:haplotype2-0000736_102745972_103248026_0"	293802	302594
"ENST00000414303.7"	1584	4	1583	"+"	"HG02071.verkko_filt_pat.fa:haplotype2-0000736_102745972_103248026_0"	502054	161398	169668	1574	8270	30	"P"	491	1499	1342	1e-04	0	"HG02071.verkko_filt_pat.fa:haplotype2-0000736_102745972_103248026_0"	"AMY2A-201"	"2A"	"HG02071"	"0-3-7-9-4-6-8-5-2-4-9-7-2-5-2-4-9-7-2-5-2-1"	"0.0-3.0-7.0-9.0-4.0-6.0-8.0-5.0-2.0-4.1-9.1-7.1-2.1-5.1-2.0-4.1-9.1-7.1-2.1-5.1-2.0-1.0"	99	"HG02071.verkko_filt_pat.fa:haplotype2-0000736_102745972_103248026_0"	161398	169668
"ENST00000610648.1"	1736	4	1733	"+"	"HG02071.verkko_filt_pat.fa:haplotype2-0000736_102745972_103248026_0"	502054	115070	123494	1720	8424	48	"P"	531	1638	1371	1e-04	0	"HG02071.verkko_filt_pat.fa:haplotype2-0000736_102745972_103248026_0"	"AMY2B-208"	"2B"	"HG02071"	"0-3-7-9-4-6-8-5-2-4-9-7-2-5-2-4-9-7-2-5-2-1"	"0.0-3.0-7.0-9.0-4.0-6.0-8.0-5.0-2.0-4.1-9.1-7.1-2.1-5.1-2.0-4.1-9.1-7.1-2.1-5.1-2.0-1.0"	99	"HG02071.verkko_filt_pat.fa:haplotype2-0000736_102745972_103248026_0"	115070	123494
"ENST00000370083.9"	1785	2	1784	"-"	"HG02293.verkko_filt_pat.fa:haplotype2-0000836_148310532_148812524_1"	501992	325482	334275	1769	8793	0	"P"	557	1686	1686	1e-04	0	"HG02293.verkko_filt_pat.fa:haplotype2-0000836_148310532_148812524_1"	"AMY1A-201"	"1"	"HG02293"	"0-3-7-9-4-6-8-5-2-4-9-7-2-5-2-4-9-7-2-5-2-1"	"0.0-3.0-7.0-9.0-4.0-6.0-8.0-5.0-2.0-4.1-9.1-7.1-2.1-5.1-2.0-4.1-9.1-7.1-2.1-5.1-2.0-1.0"	155	"HG02293.verkko_filt_pat.fa:haplotype2-0000836_148310532_148812524_1"	325482	334275
"ENST00000370083.9"	1785	2	1784	"+"	"HG02293.verkko_filt_pat.fa:haplotype2-0000836_148310532_148812524_1"	501992	199697	208490	1769	8793	0	"S"	557	1686	NA	1e-04	0	"HG02293.verkko_filt_pat.fa:haplotype2-0000836_148310532_148812524_1"	"AMY1A-201"	"1"	"HG02293"	"0-3-7-9-4-6-8-5-2-4-9-7-2-5-2-4-9-7-2-5-2-1"	"0.0-3.0-7.0-9.0-4.0-6.0-8.0-5.0-2.0-4.1-9.1-7.1-2.1-5.1-2.0-4.1-9.1-7.1-2.1-5.1-2.0-1.0"	155	"HG02293.verkko_filt_pat.fa:haplotype2-0000836_148310532_148812524_1"	199697	208490
"ENST00000370083.9"	1785	2	1784	"-"	"HG02293.verkko_filt_pat.fa:haplotype2-0000836_148310532_148812524_1"	501992	231351	240145	1769	8794	0	"S"	557	1686	NA	1e-04	0	"HG02293.verkko_filt_pat.fa:haplotype2-0000836_148310532_148812524_1"	"AMY1A-201"	"1"	"HG02293"	"0-3-7-9-4-6-8-5-2-4-9-7-2-5-2-4-9-7-2-5-2-1"	"0.0-3.0-7.0-9.0-4.0-6.0-8.0-5.0-2.0-4.1-9.1-7.1-2.1-5.1-2.0-4.1-9.1-7.1-2.1-5.1-2.0-1.0"	155	"HG02293.verkko_filt_pat.fa:haplotype2-0000836_148310532_148812524_1"	231351	240145
"ENST00000370083.9"	1785	2	1784	"+"	"HG02293.verkko_filt_pat.fa:haplotype2-0000836_148310532_148812524_1"	501992	387957	396749	1769	8792	0	"S"	557	1686	NA	1e-04	0	"HG02293.verkko_filt_pat.fa:haplotype2-0000836_148310532_148812524_1"	"AMY1A-201"	"1"	"HG02293"	"0-3-7-9-4-6-8-5-2-4-9-7-2-5-2-4-9-7-2-5-2-1"	"0.0-3.0-7.0-9.0-4.0-6.0-8.0-5.0-2.0-4.1-9.1-7.1-2.1-5.1-2.0-4.1-9.1-7.1-2.1-5.1-2.0-1.0"	155	"HG02293.verkko_filt_pat.fa:haplotype2-0000836_148310532_148812524_1"	387957	396749
"ENST00000370083.9"	1785	2	1784	"+"	"HG02293.verkko_filt_pat.fa:haplotype2-0000836_148310532_148812524_1"	501992	293827	302619	1769	8792	0	"S"	557	1686	NA	1e-04	0	"HG02293.verkko_filt_pat.fa:haplotype2-0000836_148310532_148812524_1"	"AMY1A-201"	"1"	"HG02293"	"0-3-7-9-4-6-8-5-2-4-9-7-2-5-2-4-9-7-2-5-2-1"	"0.0-3.0-7.0-9.0-4.0-6.0-8.0-5.0-2.0-4.1-9.1-7.1-2.1-5.1-2.0-4.1-9.1-7.1-2.1-5.1-2.0-1.0"	155	"HG02293.verkko_filt_pat.fa:haplotype2-0000836_148310532_148812524_1"	293827	302619
"ENST00000414303.7"	1584	4	1583	"+"	"HG02293.verkko_filt_pat.fa:haplotype2-0000836_148310532_148812524_1"	501992	161443	169713	1574	8270	30	"P"	491	1499	1342	1e-04	0	"HG02293.verkko_filt_pat.fa:haplotype2-0000836_148310532_148812524_1"	"AMY2A-201"	"2A"	"HG02293"	"0-3-7-9-4-6-8-5-2-4-9-7-2-5-2-4-9-7-2-5-2-1"	"0.0-3.0-7.0-9.0-4.0-6.0-8.0-5.0-2.0-4.1-9.1-7.1-2.1-5.1-2.0-4.1-9.1-7.1-2.1-5.1-2.0-1.0"	155	"HG02293.verkko_filt_pat.fa:haplotype2-0000836_148310532_148812524_1"	161443	169713
"ENST00000610648.1"	1736	4	1733	"+"	"HG02293.verkko_filt_pat.fa:haplotype2-0000836_148310532_148812524_1"	501992	115113	123535	1720	8422	48	"P"	531	1638	1371	1e-04	0	"HG02293.verkko_filt_pat.fa:haplotype2-0000836_148310532_148812524_1"	"AMY2B-208"	"2B"	"HG02293"	"0-3-7-9-4-6-8-5-2-4-9-7-2-5-2-4-9-7-2-5-2-1"	"0.0-3.0-7.0-9.0-4.0-6.0-8.0-5.0-2.0-4.1-9.1-7.1-2.1-5.1-2.0-4.1-9.1-7.1-2.1-5.1-2.0-1.0"	155	"HG02293.verkko_filt_pat.fa:haplotype2-0000836_148310532_148812524_1"	115113	123535
"ENST00000370083.9"	1785	2	1784	"+"	"HG02809.verkko_filt_pat.fa:haplotype2-0001251_103421111_103827972_0"	406861	293759	302549	1769	8790	0	"P"	557	1686	1686	1e-04	0	"HG02809.verkko_filt_pat.fa:haplotype2-0001251_103421111_103827972_0"	"AMY1A-201"	"1"	"HG02809"	"0-3-7-9-4-6-8-5-2-7-9-4-2-5-2-1"	"0.0-3.0-7.0-9.0-4.0-6.0-8.0-5.0-2.0-7.0-9.0-4.0-2.1-5.1-2.0-1.0"	98	"HG02809.verkko_filt_pat.fa:haplotype2-0001251_103421111_103827972_0"	293759	302549
"ENST00000370083.9"	1785	2	1784	"+"	"HG02809.verkko_filt_pat.fa:haplotype2-0001251_103421111_103827972_0"	406861	199637	208429	1769	8792	0	"S"	557	1686	NA	1e-04	0	"HG02809.verkko_filt_pat.fa:haplotype2-0001251_103421111_103827972_0"	"AMY1A-201"	"1"	"HG02809"	"0-3-7-9-4-6-8-5-2-7-9-4-2-5-2-1"	"0.0-3.0-7.0-9.0-4.0-6.0-8.0-5.0-2.0-7.0-9.0-4.0-2.1-5.1-2.0-1.0"	98	"HG02809.verkko_filt_pat.fa:haplotype2-0001251_103421111_103827972_0"	199637	208429
"ENST00000370083.9"	1785	2	1784	"-"	"HG02809.verkko_filt_pat.fa:haplotype2-0001251_103421111_103827972_0"	406861	231290	240080	1769	8790	0	"S"	557	1686	NA	1e-04	0	"HG02809.verkko_filt_pat.fa:haplotype2-0001251_103421111_103827972_0"	"AMY1A-201"	"1"	"HG02809"	"0-3-7-9-4-6-8-5-2-7-9-4-2-5-2-1"	"0.0-3.0-7.0-9.0-4.0-6.0-8.0-5.0-2.0-7.0-9.0-4.0-2.1-5.1-2.0-1.0"	98	"HG02809.verkko_filt_pat.fa:haplotype2-0001251_103421111_103827972_0"	231290	240080
"ENST00000414303.7"	1584	4	1583	"+"	"HG02809.verkko_filt_pat.fa:haplotype2-0001251_103421111_103827972_0"	406861	161349	169654	1569	8305	29	"P"	486	1494	1342	8e-04	0	"HG02809.verkko_filt_pat.fa:haplotype2-0001251_103421111_103827972_0"	"AMY2A-201"	"2A"	"HG02809"	"0-3-7-9-4-6-8-5-2-7-9-4-2-5-2-1"	"0.0-3.0-7.0-9.0-4.0-6.0-8.0-5.0-2.0-7.0-9.0-4.0-2.1-5.1-2.0-1.0"	98	"HG02809.verkko_filt_pat.fa:haplotype2-0001251_103421111_103827972_0"	161349	169654
"ENST00000610648.1"	1736	4	1733	"+"	"HG02809.verkko_filt_pat.fa:haplotype2-0001251_103421111_103827972_0"	406861	115015	123435	1720	8420	48	"P"	531	1638	1371	1e-04	0	"HG02809.verkko_filt_pat.fa:haplotype2-0001251_103421111_103827972_0"	"AMY2B-208"	"2B"	"HG02809"	"0-3-7-9-4-6-8-5-2-7-9-4-2-5-2-1"	"0.0-3.0-7.0-9.0-4.0-6.0-8.0-5.0-2.0-7.0-9.0-4.0-2.1-5.1-2.0-1.0"	98	"HG02809.verkko_filt_pat.fa:haplotype2-0001251_103421111_103827972_0"	115015	123435
"ENST00000370083.9"	1785	2	1784	"+"	"HG002.verkko_filt_pat.fa:haplotype2-0000649_147937390_148315979_1"	378589	265536	274327	1769	8791	51	"P"	557	1686	1393	1e-04	0	"HG002.verkko_filt_pat.fa:haplotype2-0000649_147937390_148315979_1"	"AMY1A-201"	"1"	"HG002"	"0-3-7-9-4-6-8-5-2-2-5-2-1"	"0.0-3.0-7.0-9.0-4.0-6.0-8.0-5.0-2.0-2.1-5.0-2.0-1.0"	154	"HG002.verkko_filt_pat.fa:haplotype2-0000649_147937390_148315979_1"	265536	274327
"ENST00000414303.7"	1584	4	1583	"+"	"HG002.verkko_filt_pat.fa:haplotype2-0000649_147937390_148315979_1"	378589	161423	169728	1563	8305	28	"P"	488	1488	1342	5e-04	0	"HG002.verkko_filt_pat.fa:haplotype2-0000649_147937390_148315979_1"	"AMY2A-201"	"2A"	"HG002"	"0-3-7-9-4-6-8-5-2-2-5-2-1"	"0.0-3.0-7.0-9.0-4.0-6.0-8.0-5.0-2.0-2.1-5.0-2.0-1.0"	154	"HG002.verkko_filt_pat.fa:haplotype2-0000649_147937390_148315979_1"	161423	169728
"ENST00000610648.1"	1736	4	1733	"+"	"HG002.verkko_filt_pat.fa:haplotype2-0000649_147937390_148315979_1"	378589	115090	123512	1720	8422	52	"P"	531	1638	1347	1e-04	0	"HG002.verkko_filt_pat.fa:haplotype2-0000649_147937390_148315979_1"	"AMY2B-208"	"2B"	"HG002"	"0-3-7-9-4-6-8-5-2-2-5-2-1"	"0.0-3.0-7.0-9.0-4.0-6.0-8.0-5.0-2.0-2.1-5.0-2.0-1.0"	154	"HG002.verkko_filt_pat.fa:haplotype2-0000649_147937390_148315979_1"	115090	123512
"ENST00000370083.9"	1785	2	1784	"-"	"HG01099.verkko_filt_pat.fa:haplotype2-0000583_143544270_144046196_1"	501926	325497	334289	1769	8792	0	"P"	557	1686	1686	1e-04	0	"HG01099.verkko_filt_pat.fa:haplotype2-0000583_143544270_144046196_1"	"AMY1A-201"	"1"	"HG01099"	"0-3-7-9-4-6-8-5-2-4-9-7-2-5-2-4-9-7-2-5-2-1"	"0.0-3.0-7.0-9.0-4.0-6.0-8.0-5.0-2.0-4.1-9.1-7.1-2.1-5.0-2.0-4.1-9.1-7.1-2.1-5.1-2.0-1.0"	154	"HG01099.verkko_filt_pat.fa:haplotype2-0000583_143544270_144046196_1"	325497	334289
"ENST00000370083.9"	1785	2	1784	"-"	"HG01099.verkko_filt_pat.fa:haplotype2-0000583_143544270_144046196_1"	501926	231364	240156	1769	8792	0	"S"	557	1686	NA	1e-04	0	"HG01099.verkko_filt_pat.fa:haplotype2-0000583_143544270_144046196_1"	"AMY1A-201"	"1"	"HG01099"	"0-3-7-9-4-6-8-5-2-4-9-7-2-5-2-4-9-7-2-5-2-1"	"0.0-3.0-7.0-9.0-4.0-6.0-8.0-5.0-2.0-4.1-9.1-7.1-2.1-5.0-2.0-4.1-9.1-7.1-2.1-5.1-2.0-1.0"	154	"HG01099.verkko_filt_pat.fa:haplotype2-0000583_143544270_144046196_1"	231364	240156
"ENST00000370083.9"	1785	2	1784	"+"	"HG01099.verkko_filt_pat.fa:haplotype2-0000583_143544270_144046196_1"	501926	387977	396768	1769	8791	0	"S"	557	1686	NA	1e-04	0	"HG01099.verkko_filt_pat.fa:haplotype2-0000583_143544270_144046196_1"	"AMY1A-201"	"1"	"HG01099"	"0-3-7-9-4-6-8-5-2-4-9-7-2-5-2-4-9-7-2-5-2-1"	"0.0-3.0-7.0-9.0-4.0-6.0-8.0-5.0-2.0-4.1-9.1-7.1-2.1-5.0-2.0-4.1-9.1-7.1-2.1-5.1-2.0-1.0"	154	"HG01099.verkko_filt_pat.fa:haplotype2-0000583_143544270_144046196_1"	387977	396768
"ENST00000370083.9"	1785	2	1784	"+"	"HG01099.verkko_filt_pat.fa:haplotype2-0000583_143544270_144046196_1"	501926	199710	208502	1769	8792	0	"S"	557	1686	NA	1e-04	0	"HG01099.verkko_filt_pat.fa:haplotype2-0000583_143544270_144046196_1"	"AMY1A-201"	"1"	"HG01099"	"0-3-7-9-4-6-8-5-2-4-9-7-2-5-2-4-9-7-2-5-2-1"	"0.0-3.0-7.0-9.0-4.0-6.0-8.0-5.0-2.0-4.1-9.1-7.1-2.1-5.0-2.0-4.1-9.1-7.1-2.1-5.1-2.0-1.0"	154	"HG01099.verkko_filt_pat.fa:haplotype2-0000583_143544270_144046196_1"	199710	208502
"ENST00000370083.9"	1785	2	1784	"+"	"HG01099.verkko_filt_pat.fa:haplotype2-0000583_143544270_144046196_1"	501926	293841	302633	1769	8792	0	"S"	557	1686	NA	1e-04	0	"HG01099.verkko_filt_pat.fa:haplotype2-0000583_143544270_144046196_1"	"AMY1A-201"	"1"	"HG01099"	"0-3-7-9-4-6-8-5-2-4-9-7-2-5-2-4-9-7-2-5-2-1"	"0.0-3.0-7.0-9.0-4.0-6.0-8.0-5.0-2.0-4.1-9.1-7.1-2.1-5.0-2.0-4.1-9.1-7.1-2.1-5.1-2.0-1.0"	154	"HG01099.verkko_filt_pat.fa:haplotype2-0000583_143544270_144046196_1"	293841	302633
"ENST00000414303.7"	1584	4	1583	"+"	"HG01099.verkko_filt_pat.fa:haplotype2-0000583_143544270_144046196_1"	501926	161452	169722	1563	8270	28	"P"	488	1488	1342	5e-04	0	"HG01099.verkko_filt_pat.fa:haplotype2-0000583_143544270_144046196_1"	"AMY2A-201"	"2A"	"HG01099"	"0-3-7-9-4-6-8-5-2-4-9-7-2-5-2-4-9-7-2-5-2-1"	"0.0-3.0-7.0-9.0-4.0-6.0-8.0-5.0-2.0-4.1-9.1-7.1-2.1-5.0-2.0-4.1-9.1-7.1-2.1-5.1-2.0-1.0"	154	"HG01099.verkko_filt_pat.fa:haplotype2-0000583_143544270_144046196_1"	161452	169722
"ENST00000610648.1"	1736	4	1733	"+"	"HG01099.verkko_filt_pat.fa:haplotype2-0000583_143544270_144046196_1"	501926	115120	123542	1720	8422	48	"P"	531	1638	1371	1e-04	0	"HG01099.verkko_filt_pat.fa:haplotype2-0000583_143544270_144046196_1"	"AMY2B-208"	"2B"	"HG01099"	"0-3-7-9-4-6-8-5-2-4-9-7-2-5-2-4-9-7-2-5-2-1"	"0.0-3.0-7.0-9.0-4.0-6.0-8.0-5.0-2.0-4.1-9.1-7.1-2.1-5.0-2.0-4.1-9.1-7.1-2.1-5.1-2.0-1.0"	154	"HG01099.verkko_filt_pat.fa:haplotype2-0000583_143544270_144046196_1"	115120	123542
"ENST00000370083.9"	1785	2	1784	"+"	"HG03927.verkko_filt_pat.fa:haplotype2-0000800_29002142_29504057_1"	501915	293795	302586	1769	8791	0	"P"	557	1686	1686	1e-04	0	"HG03927.verkko_filt_pat.fa:haplotype2-0000800_29002142_29504057_1"	"AMY1A-201"	"1"	"HG03927"	"0-3-7-9-4-6-8-5-2-7-9-4-2-5-2-7-9-4-2-5-2-1"	"0.0-3.0-7.0-9.0-4.0-6.0-8.0-5.0-2.0-7.0-9.0-4.0-2.1-5.1-2.0-7.0-9.0-4.0-2.1-5.1-2.0-1.0"	154	"HG03927.verkko_filt_pat.fa:haplotype2-0000800_29002142_29504057_1"	293795	302586
"ENST00000370083.9"	1785	2	1784	"-"	"HG03927.verkko_filt_pat.fa:haplotype2-0000800_29002142_29504057_1"	501915	325445	334236	1769	8791	0	"S"	557	1686	NA	1e-04	0	"HG03927.verkko_filt_pat.fa:haplotype2-0000800_29002142_29504057_1"	"AMY1A-201"	"1"	"HG03927"	"0-3-7-9-4-6-8-5-2-7-9-4-2-5-2-7-9-4-2-5-2-1"	"0.0-3.0-7.0-9.0-4.0-6.0-8.0-5.0-2.0-7.0-9.0-4.0-2.1-5.1-2.0-7.0-9.0-4.0-2.1-5.1-2.0-1.0"	154	"HG03927.verkko_filt_pat.fa:haplotype2-0000800_29002142_29504057_1"	325445	334236
"ENST00000370083.9"	1785	2	1784	"-"	"HG03927.verkko_filt_pat.fa:haplotype2-0000800_29002142_29504057_1"	501915	231328	240119	1769	8791	0	"S"	557	1686	NA	1e-04	0	"HG03927.verkko_filt_pat.fa:haplotype2-0000800_29002142_29504057_1"	"AMY1A-201"	"1"	"HG03927"	"0-3-7-9-4-6-8-5-2-7-9-4-2-5-2-7-9-4-2-5-2-1"	"0.0-3.0-7.0-9.0-4.0-6.0-8.0-5.0-2.0-7.0-9.0-4.0-2.1-5.1-2.0-7.0-9.0-4.0-2.1-5.1-2.0-1.0"	154	"HG03927.verkko_filt_pat.fa:haplotype2-0000800_29002142_29504057_1"	231328	240119
"ENST00000370083.9"	1785	2	1784	"+"	"HG03927.verkko_filt_pat.fa:haplotype2-0000800_29002142_29504057_1"	501915	387906	396697	1769	8791	0	"S"	557	1686	NA	1e-04	0	"HG03927.verkko_filt_pat.fa:haplotype2-0000800_29002142_29504057_1"	"AMY1A-201"	"1"	"HG03927"	"0-3-7-9-4-6-8-5-2-7-9-4-2-5-2-7-9-4-2-5-2-1"	"0.0-3.0-7.0-9.0-4.0-6.0-8.0-5.0-2.0-7.0-9.0-4.0-2.1-5.1-2.0-7.0-9.0-4.0-2.1-5.1-2.0-1.0"	154	"HG03927.verkko_filt_pat.fa:haplotype2-0000800_29002142_29504057_1"	387906	396697
"ENST00000370083.9"	1785	2	1784	"+"	"HG03927.verkko_filt_pat.fa:haplotype2-0000800_29002142_29504057_1"	501915	199678	208469	1761	8791	0	"S"	552	1678	NA	7e-04	0	"HG03927.verkko_filt_pat.fa:haplotype2-0000800_29002142_29504057_1"	"AMY1A-201"	"1"	"HG03927"	"0-3-7-9-4-6-8-5-2-7-9-4-2-5-2-7-9-4-2-5-2-1"	"0.0-3.0-7.0-9.0-4.0-6.0-8.0-5.0-2.0-7.0-9.0-4.0-2.1-5.1-2.0-7.0-9.0-4.0-2.1-5.1-2.0-1.0"	154	"HG03927.verkko_filt_pat.fa:haplotype2-0000800_29002142_29504057_1"	199678	208469
"ENST00000414303.7"	1584	4	1579	"+"	"HG03927.verkko_filt_pat.fa:haplotype2-0000800_29002142_29504057_1"	501915	161426	169692	1563	8266	28	"P"	484	1488	1342	0.001	0	"HG03927.verkko_filt_pat.fa:haplotype2-0000800_29002142_29504057_1"	"AMY2A-201"	"2A"	"HG03927"	"0-3-7-9-4-6-8-5-2-7-9-4-2-5-2-7-9-4-2-5-2-1"	"0.0-3.0-7.0-9.0-4.0-6.0-8.0-5.0-2.0-7.0-9.0-4.0-2.1-5.1-2.0-7.0-9.0-4.0-2.1-5.1-2.0-1.0"	154	"HG03927.verkko_filt_pat.fa:haplotype2-0000800_29002142_29504057_1"	161426	169692
"ENST00000610648.1"	1736	4	1733	"+"	"HG03927.verkko_filt_pat.fa:haplotype2-0000800_29002142_29504057_1"	501915	115108	123530	1720	8422	48	"P"	531	1638	1371	1e-04	0	"HG03927.verkko_filt_pat.fa:haplotype2-0000800_29002142_29504057_1"	"AMY2B-208"	"2B"	"HG03927"	"0-3-7-9-4-6-8-5-2-7-9-4-2-5-2-7-9-4-2-5-2-1"	"0.0-3.0-7.0-9.0-4.0-6.0-8.0-5.0-2.0-7.0-9.0-4.0-2.1-5.1-2.0-7.0-9.0-4.0-2.1-5.1-2.0-1.0"	154	"HG03927.verkko_filt_pat.fa:haplotype2-0000800_29002142_29504057_1"	115108	123530
"AMYP1-201"	1023	4	1022	"-"	"HG01243#1#JAHEOY010000013.1_90081_424495_0"	334414	197680	203824	998	6144	34	"P"	303	948	829	0.0013	0	"HG01243#1#JAHEOY010000013.1_90081_424495_0"	"AMYP1-201"	"2Ap"	"HG01243"	"0-3-7-9-4-2-5-2-1"	"0.0-3.0-7.0-9.0-4.0-2.1-5.1-2.0-1.0"	98	"HG01243#1#JAHEOY010000013.1_90081_424495_0"	197680	203824
"AMYP1-201"	1023	4	1022	"-"	"HG03492#2#JAHEPH010000288.1_2098270_2432686_1"	334416	197734	203878	998	6144	34	"P"	303	948	829	0.0013	0	"HG03492#2#JAHEPH010000288.1_2098270_2432686_1"	"AMYP1-201"	"2Ap"	"HG03492"	"0-3-7-9-4-2-5-2-1"	"0.0-3.0-7.0-9.0-4.0-2.1-5.1-2.0-1.0"	154	"HG03492#2#JAHEPH010000288.1_2098270_2432686_1"	197734	203878
"AMYP1-201"	1023	4	1022	"+"	"AV_HG00673#haplotype1#0000019:16627360-17129375"	502015	257601	263745	1010	6144	0	"S"	305	960	NA	0.0015	0	"AV_HG00673#haplotype1#0000019:16627360-17129375"	"AMYP1-201"	"2Ap"	"AV_HG00673"	"0-3-7-9-4-6-8-5-2-4-9-7-2-5-2-4-9-7-2-5-2-1"	"0.0-3.0-7.0-9.0-4.0-6.0-8.0-5.0-2.0-4.1-9.1-7.1-2.1-5.0-2.0-4.1-9.1-7.1-2.1-5.0-2.0-1.0"	100	"AV_HG00673#haplotype1#0000019:16627360-17129375"	257601	263745
"AMYP1-201"	1023	4	1022	"+"	"AV_HG00673#haplotype1#0000019:16627360-17129375"	502015	351747	357891	1010	6144	0	"P"	305	960	960	0.0015	0	"AV_HG00673#haplotype1#0000019:16627360-17129375"	"AMYP1-201"	"2Ap"	"AV_HG00673"	"0-3-7-9-4-6-8-5-2-4-9-7-2-5-2-4-9-7-2-5-2-1"	"0.0-3.0-7.0-9.0-4.0-6.0-8.0-5.0-2.0-4.1-9.1-7.1-2.1-5.0-2.0-4.1-9.1-7.1-2.1-5.0-2.0-1.0"	100	"AV_HG00673#haplotype1#0000019:16627360-17129375"	351747	357891
"AMYP1-201"	1023	4	1022	"-"	"AV_HG00673#haplotype2#0001165:24014011-24421797"	407786	270105	276249	1009	6144	2	"P"	306	959	952	7e-04	0	"AV_HG00673#haplotype2#0001165:24014011-24421797"	"AMYP1-201"	"2Ap"	"AV_HG00673"	"0-3-7-4-6-8-5-2-7-4-2-5-2-1"	"0.0-3.0-7.0-4.0-6.0-8.0-5.0-2.0-7.0-4.0-2.1-5.1-2.0-1.0"	99	"AV_HG00673#haplotype2#0001165:24014011-24421797"	270105	276249
"AMYP1-201"	1023	4	1022	"-"	"AV_HG01106#haplotype1#0000048:16666181-17262214"	596033	270062	276206	1010	6144	0	"S"	305	960	NA	0.0015	0	"AV_HG01106#haplotype1#0000048:16666181-17262214"	"AMYP1-201"	"2Ap"	"AV_HG01106"	"0-3-7-9-4-6-8-5-2-4-9-7-2-5-2-4-9-7-2-5-2-4-9-7-2-5-2-1"	"0.0-3.0-7.0-9.0-4.0-6.0-8.0-5.0-2.0-4.1-9.1-7.1-2.1-5.1-2.0-4.1-9.1-7.1-2.1-5.0-2.0-4.1-9.1-7.1-2.1-5.0-2.0-1.0"	100	"AV_HG01106#haplotype1#0000048:16666181-17262214"	270062	276206
"AMYP1-201"	1023	4	1022	"+"	"AV_HG01106#haplotype1#0000048:16666181-17262214"	596033	351680	357824	1013	6144	0	"P"	311	963	963	2e-04	0	"AV_HG01106#haplotype1#0000048:16666181-17262214"	"AMYP1-201"	"2Ap"	"AV_HG01106"	"0-3-7-9-4-6-8-5-2-4-9-7-2-5-2-4-9-7-2-5-2-4-9-7-2-5-2-1"	"0.0-3.0-7.0-9.0-4.0-6.0-8.0-5.0-2.0-4.1-9.1-7.1-2.1-5.1-2.0-4.1-9.1-7.1-2.1-5.0-2.0-4.1-9.1-7.1-2.1-5.0-2.0-1.0"	100	"AV_HG01106#haplotype1#0000048:16666181-17262214"	351680	357824
"AMYP1-201"	1023	4	1022	"+"	"AV_HG01106#haplotype1#0000048:16666181-17262214"	596033	445805	451949	1013	6144	0	"S"	311	963	NA	2e-04	0	"AV_HG01106#haplotype1#0000048:16666181-17262214"	"AMYP1-201"	"2Ap"	"AV_HG01106"	"0-3-7-9-4-6-8-5-2-4-9-7-2-5-2-4-9-7-2-5-2-4-9-7-2-5-2-1"	"0.0-3.0-7.0-9.0-4.0-6.0-8.0-5.0-2.0-4.1-9.1-7.1-2.1-5.1-2.0-4.1-9.1-7.1-2.1-5.0-2.0-4.1-9.1-7.1-2.1-5.0-2.0-1.0"	100	"AV_HG01106#haplotype1#0000048:16666181-17262214"	445805	451949
"AMYP1-201"	1023	4	1022	"-"	"AV_HG01106#haplotype2#0000932:16673968-17175925"	501957	270091	276235	1013	6144	0	"S"	311	963	NA	2e-04	0	"AV_HG01106#haplotype2#0000932:16673968-17175925"	"AMYP1-201"	"2Ap"	"AV_HG01106"	"0-3-7-9-4-6-8-5-2-7-9-4-2-5-2-4-9-7-2-5-2-1"	"0.0-3.0-7.0-9.0-4.0-6.0-8.0-5.0-2.0-7.0-9.0-4.0-2.1-5.1-2.0-4.1-9.1-7.1-2.1-5.0-2.0-1.0"	100	"AV_HG01106#haplotype2#0000932:16673968-17175925"	270091	276235
"AMYP1-201"	1023	4	1022	"+"	"AV_HG01106#haplotype2#0000932:16673968-17175925"	501957	351699	357843	1013	6144	0	"P"	311	963	963	2e-04	0	"AV_HG01106#haplotype2#0000932:16673968-17175925"	"AMYP1-201"	"2Ap"	"AV_HG01106"	"0-3-7-9-4-6-8-5-2-7-9-4-2-5-2-4-9-7-2-5-2-1"	"0.0-3.0-7.0-9.0-4.0-6.0-8.0-5.0-2.0-7.0-9.0-4.0-2.1-5.1-2.0-4.1-9.1-7.1-2.1-5.0-2.0-1.0"	100	"AV_HG01106#haplotype2#0000932:16673968-17175925"	351699	357843
"AMYP1-201"	1023	4	1022	"+"	"AV_HG01175#haplotype1#0000070:46006269-46414083"	407814	257546	263690	1013	6144	1	"P"	311	963	959	2e-04	0	"AV_HG01175#haplotype1#0000070:46006269-46414083"	"AMYP1-201"	"2Ap"	"AV_HG01175"	"0-3-7-9-4-6-8-5-2-4-9-7-2-5-2-1"	"0.0-3.0-7.0-9.0-4.0-6.0-8.0-5.0-2.0-4.1-9.1-7.1-2.1-5.0-2.0-1.0"	100	"AV_HG01175#haplotype1#0000070:46006269-46414083"	257546	263690
"AMYP1-201"	1023	4	1022	"-"	"AV_HG01361#haplotype1#0000023:101593539-102001341"	407802	270104	276248	998	6144	0	"S"	303	948	NA	0.0013	0	"AV_HG01361#haplotype1#0000023:101593539-102001341"	"AMYP1-201"	"2Ap"	"AV_HG01361"	"0-3-7-9-4-6-8-5-2-4-9-7-2-5-2-1"	"0.0-3.0-7.0-9.0-4.0-6.0-8.0-5.0-2.0-4.1-9.1-7.1-2.1-5.1-2.0-1.0"	99	"AV_HG01361#haplotype1#0000023:101593539-102001341"	270104	276248
"AMYP1-201"	1023	4	1022	"+"	"AV_HG02148#haplotype2#0002863:16304803-16712699"	407896	257618	263762	1013	6144	1	"P"	311	963	959	2e-04	0	"AV_HG02148#haplotype2#0002863:16304803-16712699"	"AMYP1-201"	"2Ap"	"AV_HG02148"	"0-3-7-9-4-6-8-5-2-4-9-7-2-5-2-1"	"0.0-3.0-7.0-9.0-4.0-6.0-8.0-5.0-2.0-4.1-9.1-7.1-2.1-5.0-2.0-1.0"	100	"AV_HG02148#haplotype2#0002863:16304803-16712699"	257618	263762
"AMYP1-201"	1023	4	1022	"+"	"AV_HG02257#haplotype2#0001152:102843493-103251377"	407884	257623	263767	1003	6144	0	"S"	299	953	NA	0.0022	0	"AV_HG02257#haplotype2#0001152:102843493-103251377"	"AMYP1-201"	"2Ap"	"AV_HG02257"	"0-3-7-9-4-6-8-5-2-4-9-7-2-5-2-1"	"0.0-3.0-7.0-9.0-4.0-6.0-8.0-5.0-2.0-4.1-9.1-7.1-2.1-5.0-2.0-1.0"	99	"AV_HG02257#haplotype2#0001152:102843493-103251377"	257623	263767
"AMYP1-201"	1023	4	1022	"-"	"chr1_chm13_103304997_103901127_0"	596130	270113	276257	1010	6144	0	"S"	305	960	NA	0.0015	0	"chr1_chm13_103304997_103901127_0"	"AMYP1-201"	"2Ap"	"chr1_chm13_103304997_103901127_0"	"0-3-7-9-4-6-8-5-2-4-9-7-2-5-2-4-9-7-2-5-2-4-9-7-2-5-2-1"	"0.0-3.0-7.0-9.0-4.0-6.0-8.0-5.0-2.0-4.1-9.1-7.1-2.1-5.1-2.0-4.1-9.1-7.1-2.1-5.0-2.0-4.1-9.1-7.1-2.1-5.0-2.0-1.0"	99	"chr1_chm13_103304997_103901127_0"	270113	276257
"AMYP1-201"	1023	4	1022	"+"	"chr1_chm13_103304997_103901127_0"	596130	351739	357883	1013	6144	0	"S"	311	963	NA	2e-04	0	"chr1_chm13_103304997_103901127_0"	"AMYP1-201"	"2Ap"	"chr1_chm13_103304997_103901127_0"	"0-3-7-9-4-6-8-5-2-4-9-7-2-5-2-4-9-7-2-5-2-4-9-7-2-5-2-1"	"0.0-3.0-7.0-9.0-4.0-6.0-8.0-5.0-2.0-4.1-9.1-7.1-2.1-5.1-2.0-4.1-9.1-7.1-2.1-5.0-2.0-4.1-9.1-7.1-2.1-5.0-2.0-1.0"	99	"chr1_chm13_103304997_103901127_0"	351739	357883
"AMYP1-201"	1023	4	1022	"+"	"chr1_chm13_103304997_103901127_0"	596130	445869	452013	1013	6144	0	"P"	311	963	963	2e-04	0	"chr1_chm13_103304997_103901127_0"	"AMYP1-201"	"2Ap"	"chr1_chm13_103304997_103901127_0"	"0-3-7-9-4-6-8-5-2-4-9-7-2-5-2-4-9-7-2-5-2-4-9-7-2-5-2-1"	"0.0-3.0-7.0-9.0-4.0-6.0-8.0-5.0-2.0-4.1-9.1-7.1-2.1-5.1-2.0-4.1-9.1-7.1-2.1-5.0-2.0-4.1-9.1-7.1-2.1-5.0-2.0-1.0"	99	"chr1_chm13_103304997_103901127_0"	445869	452013
"AMYP1-201"	1023	4	1022	"+"	"chr1_hg19_103998686_104406594_0"	407908	257662	263806	1010	6144	0	"P"	305	960	959	0.0015	0	"chr1_hg19_103998686_104406594_0"	"AMYP1-201"	"2Ap"	"chr1_hg19_103998686_104406594_0"	"0-3-7-9-4-6-8-5-2-4-9-7-2-5-2-1"	"0.0-3.0-7.0-9.0-4.0-6.0-8.0-5.0-2.0-4.1-9.1-7.1-2.1-5.0-2.0-1.0"	99	"chr1_hg19_103998686_104406594_0"	257662	263806
"AMYP1-201"	1023	4	1022	"+"	"chr1_hg38_103456064_103863972_0"	407908	257662	263806	1010	6144	0	"P"	305	960	959	0.0015	0	"chr1_hg38_103456064_103863972_0"	"AMYP1-201"	"2Ap"	"chr1_hg38_103456064_103863972_0"	"0-3-7-9-4-6-8-5-2-4-9-7-2-5-2-1"	"0.0-3.0-7.0-9.0-4.0-6.0-8.0-5.0-2.0-4.1-9.1-7.1-2.1-5.0-2.0-1.0"	99	"chr1_hg38_103456064_103863972_0"	257662	263806
"AMYP1-201"	1023	4	1022	"+"	"HG002.verkko_filt_mat.fa:haplotype1-0000005_138228497_138636354_1"	407857	257652	263796	1010	6144	0	"P"	305	960	959	0.0017	0	"HG002.verkko_filt_mat.fa:haplotype1-0000005_138228497_138636354_1"	"AMYP1-201"	"2Ap"	"HG002"	"0-3-7-9-4-6-8-5-2-4-9-7-2-5-2-1"	"0.0-3.0-7.0-9.0-4.0-6.0-8.0-5.0-2.0-4.1-9.1-7.1-2.1-5.0-2.0-1.0"	154	"HG002.verkko_filt_mat.fa:haplotype1-0000005_138228497_138636354_1"	257652	263796
"AMYP1-201"	1023	4	1022	"+"	"HG002.verkko_filt_pat.fa:haplotype2-0000649_147937390_148315979_1"	378589	229369	235513	998	6144	0	"S"	303	948	NA	0.0013	0	"HG002.verkko_filt_pat.fa:haplotype2-0000649_147937390_148315979_1"	"AMYP1-201"	"2Ap"	"HG002"	"0-3-7-9-4-6-8-5-2-2-5-2-1"	"0.0-3.0-7.0-9.0-4.0-6.0-8.0-5.0-2.0-2.1-5.0-2.0-1.0"	154	"HG002.verkko_filt_pat.fa:haplotype2-0000649_147937390_148315979_1"	229369	235513
"AMYP1-201"	1023	4	1022	"-"	"HG00438#1#JAHBCB010000015.1_33474867_33954171_0"	479304	342504	348648	998	6144	0	"S"	303	948	NA	0.0013	0	"HG00438#1#JAHBCB010000015.1_33474867_33954171_0"	"AMYP1-201"	"2Ap"	"HG00438"	"0-3-7-9-4-6-8-5-2-4-9-7-2-5-8-6-4-9-7-2-5-2-1"	"0.0-3.0-7.0-9.0-4.0-6.0-8.0-5.0-2.0-4.1-9.1-7.1-2.1-5.1-8.1-6.1-4.1-9.1-7.1-2.1-5.1-2.0-1.0"	98	"HG00438#1#JAHBCB010000015.1_33474867_33954171_0"	342504	348648
"AMYP1-201"	1023	4	1022	"-"	"HG005#1#JAHEPO010000002.1_51519219_51926067_0"	406848	270086	276230	996	6144	0	"S"	299	946	NA	0.0022	0	"HG005#1#JAHEPO010000002.1_51519219_51926067_0"	"AMYP1-201"	"2Ap"	"HG005"	"0-3-7-9-4-6-8-5-2-7-9-4-2-5-2-1"	"0.0-3.0-7.0-9.0-4.0-6.0-8.0-5.0-2.0-7.0-9.0-4.0-2.1-5.1-2.0-1.0"	98	"HG005#1#JAHEPO010000002.1_51519219_51926067_0"	270086	276230
"AMYP1-201"	1023	4	1022	"+"	"HG005#2#JAHEPN010000023.1_51542210_51950070_0"	407860	257586	263730	1010	6144	0	"P"	305	960	959	0.0015	0	"HG005#2#JAHEPN010000023.1_51542210_51950070_0"	"AMYP1-201"	"2Ap"	"HG005"	"0-3-7-9-4-6-8-5-2-4-9-7-2-5-2-1"	"0.0-3.0-7.0-9.0-4.0-6.0-8.0-5.0-2.0-4.1-9.1-7.1-2.1-5.0-2.0-1.0"	99	"HG005#2#JAHEPN010000023.1_51542210_51950070_0"	257586	263730
"AMYP1-201"	1023	4	1022	"-"	"HG00621#1#JAHBCD010000034.1_2122997_2624098_1"	501101	270168	276312	1010	6144	0	"P"	305	960	960	0.0015	0	"HG00621#1#JAHBCD010000034.1_2122997_2624098_1"	"AMYP1-201"	"2Ap"	"HG00621"	"0-3-7-9-4-6-8-5-2-4-9-7-2-5-2-4-9-7-2-5-2-1"	"0.0-3.0-7.0-9.0-4.0-6.0-8.0-5.0-2.0-4.1-9.1-7.1-2.1-5.1-2.0-4.1-9.1-7.1-2.1-5.1-2.0-1.0"	155	"HG00621#1#JAHBCD010000034.1_2122997_2624098_1"	270168	276312
"AMYP1-201"	1023	4	1022	"-"	"HG00621#1#JAHBCD010000034.1_2122997_2624098_1"	501101	364322	370466	1010	6144	0	"S"	305	960	NA	0.0015	0	"HG00621#1#JAHBCD010000034.1_2122997_2624098_1"	"AMYP1-201"	"2Ap"	"HG00621"	"0-3-7-9-4-6-8-5-2-4-9-7-2-5-2-4-9-7-2-5-2-1"	"0.0-3.0-7.0-9.0-4.0-6.0-8.0-5.0-2.0-4.1-9.1-7.1-2.1-5.1-2.0-4.1-9.1-7.1-2.1-5.1-2.0-1.0"	155	"HG00621#1#JAHBCD010000034.1_2122997_2624098_1"	364322	370466
"AMYP1-201"	1023	4	1022	"+"	"HG00621#2#JAHBCC010000031.1_16669999_17077865_0"	407866	257610	263754	1013	6144	1	"P"	311	963	959	2e-04	0	"HG00621#2#JAHBCC010000031.1_16669999_17077865_0"	"AMYP1-201"	"2Ap"	"HG00621"	"0-3-7-9-4-6-8-5-2-4-9-7-2-5-2-1"	"0.0-3.0-7.0-9.0-4.0-6.0-8.0-5.0-2.0-4.1-9.1-7.1-2.1-5.0-2.0-1.0"	99	"HG00621#2#JAHBCC010000031.1_16669999_17077865_0"	257610	263754
"AMYP1-201"	1023	4	1022	"+"	"HG00741#1#JAHALY010000007.1_18781197_19307680_1"	526483	376325	382469	998	6144	0	"S"	303	948	NA	0.0013	0	"HG00741#1#JAHALY010000007.1_18781197_19307680_1"	"AMYP1-201"	"2Ap"	"HG00741"	"0-3-7-9-4-6-8-5-2-4-0-3-7-9-4-6-8-5-2-4-4-2-5-2-1"	"0.0-3.0-7.0-9.0-4.0-6.0-8.0-5.0-2.0-4.1-0.0-3.0-7.0-9.0-4.0-6.0-8.0-5.0-2.0-4.1-4.0-2.1-5.0-2.0-1.0"	154	"HG00741#1#JAHALY010000007.1_18781197_19307680_1"	376325	382469
"AMYP1-201"	1023	4	1022	"-"	"HG00741#2#JAHALX010000013.1_51574319_51981226_0"	406907	270137	276281	998	6144	0	"S"	303	948	NA	0.0013	0	"HG00741#2#JAHALX010000013.1_51574319_51981226_0"	"AMYP1-201"	"2Ap"	"HG00741"	"0-3-7-9-4-6-8-5-2-7-9-4-2-5-2-1"	"0.0-3.0-7.0-9.0-4.0-6.0-8.0-5.0-2.0-7.0-9.0-4.0-2.1-5.1-2.0-1.0"	98	"HG00741#2#JAHALX010000013.1_51574319_51981226_0"	270137	276281
"AMYP1-201"	1023	4	1022	"+"	"HG01071#1#JAHBCF010000053.1_26607100_27108065_1"	500965	257602	263746	1013	6144	1	"P"	311	963	959	2e-04	0	"HG01071#1#JAHBCF010000053.1_26607100_27108065_1"	"AMYP1-201"	"2Ap"	"HG01071"	"0-3-7-9-4-6-8-5-2-4-9-7-2-5-2-7-9-4-2-5-2-1"	"0.0-3.0-7.0-9.0-4.0-6.0-8.0-5.0-2.0-4.1-9.1-7.1-2.1-5.0-2.0-7.0-9.0-4.0-2.1-5.1-2.0-1.0"	155	"HG01071#1#JAHBCF010000053.1_26607100_27108065_1"	257602	263746
"AMYP1-201"	1023	4	1022	"-"	"HG01071#1#JAHBCF010000053.1_26607100_27108065_1"	500965	364242	370386	998	6144	0	"S"	303	948	NA	0.0019	0	"HG01071#1#JAHBCF010000053.1_26607100_27108065_1"	"AMYP1-201"	"2Ap"	"HG01071"	"0-3-7-9-4-6-8-5-2-4-9-7-2-5-2-7-9-4-2-5-2-1"	"0.0-3.0-7.0-9.0-4.0-6.0-8.0-5.0-2.0-4.1-9.1-7.1-2.1-5.0-2.0-7.0-9.0-4.0-2.1-5.1-2.0-1.0"	155	"HG01071#1#JAHBCF010000053.1_26607100_27108065_1"	364242	370386
"AMYP1-201"	1023	4	1022	"-"	"HG01099.verkko_filt_mat.fa:haplotype1-0000034_142513097_142920876_1"	407779	270136	276280	998	6144	0	"S"	303	948	NA	0.0013	0	"HG01099.verkko_filt_mat.fa:haplotype1-0000034_142513097_142920876_1"	"AMYP1-201"	"2Ap"	"HG01099"	"0-3-7-9-4-6-8-5-2-4-9-7-2-5-2-1"	"0.0-3.0-7.0-9.0-4.0-6.0-8.0-5.0-2.0-4.1-9.1-7.1-2.1-5.1-2.0-1.0"	154	"HG01099.verkko_filt_mat.fa:haplotype1-0000034_142513097_142920876_1"	270136	276280
"AMYP1-201"	1023	4	1022	"+"	"HG01099.verkko_filt_pat.fa:haplotype2-0000583_143544270_144046196_1"	501926	257677	263822	1009	6145	3	"P"	306	959	948	7e-04	0	"HG01099.verkko_filt_pat.fa:haplotype2-0000583_143544270_144046196_1"	"AMYP1-201"	"2Ap"	"HG01099"	"0-3-7-9-4-6-8-5-2-4-9-7-2-5-2-4-9-7-2-5-2-1"	"0.0-3.0-7.0-9.0-4.0-6.0-8.0-5.0-2.0-4.1-9.1-7.1-2.1-5.0-2.0-4.1-9.1-7.1-2.1-5.1-2.0-1.0"	154	"HG01099.verkko_filt_pat.fa:haplotype2-0000583_143544270_144046196_1"	257677	263822
"AMYP1-201"	1023	4	1022	"-"	"HG01099.verkko_filt_pat.fa:haplotype2-0000583_143544270_144046196_1"	501926	364321	370464	998	6143	0	"S"	303	948	NA	0.0013	0	"HG01099.verkko_filt_pat.fa:haplotype2-0000583_143544270_144046196_1"	"AMYP1-201"	"2Ap"	"HG01099"	"0-3-7-9-4-6-8-5-2-4-9-7-2-5-2-4-9-7-2-5-2-1"	"0.0-3.0-7.0-9.0-4.0-6.0-8.0-5.0-2.0-4.1-9.1-7.1-2.1-5.0-2.0-4.1-9.1-7.1-2.1-5.1-2.0-1.0"	154	"HG01099.verkko_filt_pat.fa:haplotype2-0000583_143544270_144046196_1"	364321	370464
"AMYP1-201"	1023	4	1022	"-"	"HG01109#1#JAHEPA010000099.1_2104245_2511104_1"	406859	270140	276284	998	6144	0	"S"	303	948	NA	0.0013	0	"HG01109#1#JAHEPA010000099.1_2104245_2511104_1"	"AMYP1-201"	"2Ap"	"HG01109"	"0-3-7-9-4-6-8-5-2-7-9-4-2-5-2-1"	"0.0-3.0-7.0-9.0-4.0-6.0-8.0-5.0-2.0-7.0-9.0-4.0-2.1-5.1-2.0-1.0"	155	"HG01109#1#JAHEPA010000099.1_2104245_2511104_1"	270140	276284
"AMYP1-201"	1023	4	1022	"+"	"HG01109#2#JAHEOZ010000047.1_16671232_17151375_0"	480143	329930	336067	998	6137	0	"S"	303	948	NA	0.0013	0	"HG01109#2#JAHEOZ010000047.1_16671232_17151375_0"	"AMYP1-201"	"2Ap"	"HG01109"	"0-3-7-9-4-6-8-5-2-7-9-4-6-8-5-2-7-4-2-5-2-1"	"0.0-3.0-7.0-9.0-4.0-6.0-8.0-5.0-2.0-7.0-9.0-4.0-6.0-8.0-5.0-2.0-7.0-4.0-2.1-5.0-2.0-1.0"	98	"HG01109#2#JAHEOZ010000047.1_16671232_17151375_0"	329930	336067
"AMYP1-201"	1023	4	1022	"-"	"HG01123#1#JAGYYZ010000015.1_51528240_51935090_0"	406850	270094	276238	998	6144	0	"S"	303	948	NA	0.0013	0	"HG01123#1#JAGYYZ010000015.1_51528240_51935090_0"	"AMYP1-201"	"2Ap"	"HG01123"	"0-3-7-9-4-6-8-5-2-7-9-4-2-5-2-1"	"0.0-3.0-7.0-9.0-4.0-6.0-8.0-5.0-2.0-7.0-9.0-4.0-2.1-5.1-2.0-1.0"	98	"HG01123#1#JAGYYZ010000015.1_51528240_51935090_0"	270094	276238
"AMYP1-201"	1023	4	1022	"+"	"HG01258#1#JAGYYV010000004.1_56955948_57456952_1"	501004	257659	263803	1013	6144	1	"P"	311	963	959	2e-04	0	"HG01258#1#JAGYYV010000004.1_56955948_57456952_1"	"AMYP1-201"	"2Ap"	"HG01258"	"0-3-7-9-4-6-8-5-2-4-9-7-2-5-2-7-9-4-2-5-2-1"	"0.0-3.0-7.0-9.0-4.0-6.0-8.0-5.0-2.0-4.1-9.1-7.1-2.1-5.0-2.0-7.0-9.0-4.0-2.1-5.0-2.0-1.0"	155	"HG01258#1#JAGYYV010000004.1_56955948_57456952_1"	257659	263803
"AMYP1-201"	1023	4	1022	"+"	"HG01258#1#JAGYYV010000004.1_56955948_57456952_1"	501004	351782	357926	998	6144	0	"S"	303	948	NA	0.0019	0	"HG01258#1#JAGYYV010000004.1_56955948_57456952_1"	"AMYP1-201"	"2Ap"	"HG01258"	"0-3-7-9-4-6-8-5-2-4-9-7-2-5-2-7-9-4-2-5-2-1"	"0.0-3.0-7.0-9.0-4.0-6.0-8.0-5.0-2.0-4.1-9.1-7.1-2.1-5.0-2.0-7.0-9.0-4.0-2.1-5.0-2.0-1.0"	155	"HG01258#1#JAGYYV010000004.1_56955948_57456952_1"	351782	357926
"AMYP1-201"	1023	4	1022	"-"	"HG01258#2#JAGYYU010000072.1_51562603_51970395_0"	407792	270108	276252	998	6144	0	"S"	303	948	NA	0.0013	0	"HG01258#2#JAGYYU010000072.1_51562603_51970395_0"	"AMYP1-201"	"2Ap"	"HG01258"	"0-3-7-9-4-6-8-5-2-7-9-4-2-5-2-1"	"0.0-3.0-7.0-9.0-4.0-6.0-8.0-5.0-2.0-7.0-9.0-4.0-2.1-5.1-2.0-1.0"	98	"HG01258#2#JAGYYU010000072.1_51562603_51970395_0"	270108	276252
"AMYP1-201"	1023	4	1022	"-"	"HG01358#1#JAGYZB010000020.1_27445742_27855492_1"	409750	273041	279185	998	6144	0	"P"	303	948	948	0.0013	0	"HG01358#1#JAGYZB010000020.1_27445742_27855492_1"	"AMYP1-201"	"2Ap"	"HG01358"	"0-3-7-9-4-6-8-5-2-4-4-2-5-2-1"	"0.0-3.0-7.0-9.0-4.0-6.0-8.0-5.0-2.0-4.1-4.0-2.1-5.1-2.0-1.0"	154	"HG01358#1#JAGYZB010000020.1_27445742_27855492_1"	273041	279185
"AMYP1-201"	1023	4	1022	"-"	"HG01928#1#JAGYVQ010000053.1_16676493_17083407_0"	406914	270085	276229	1010	6144	0	"P"	305	960	959	0.0015	0	"HG01928#1#JAGYVQ010000053.1_16676493_17083407_0"	"AMYP1-201"	"2Ap"	"HG01928"	"0-3-7-9-4-6-8-5-2-4-9-7-2-5-2-1"	"0.0-3.0-7.0-9.0-4.0-6.0-8.0-5.0-2.0-4.1-9.1-7.1-2.1-5.1-2.0-1.0"	99	"HG01928#1#JAGYVQ010000053.1_16676493_17083407_0"	270085	276229
"AMYP1-201"	1023	4	1022	"-"	"HG01978#1#JAGYVS010000002.1_51519970_52021951_0"	501981	270105	276249	1010	6144	0	"S"	305	960	NA	0.0015	0	"HG01978#1#JAGYVS010000002.1_51519970_52021951_0"	"AMYP1-201"	"2Ap"	"HG01978"	"0-3-7-9-4-6-8-5-2-4-9-7-2-5-2-4-9-7-2-5-2-1"	"0.0-3.0-7.0-9.0-4.0-6.0-8.0-5.0-2.0-4.1-9.1-7.1-2.1-5.1-2.0-4.1-9.1-7.1-2.1-5.0-2.0-1.0"	99	"HG01978#1#JAGYVS010000002.1_51519970_52021951_0"	270105	276249
"AMYP1-201"	1023	4	1022	"+"	"HG01978#1#JAGYVS010000002.1_51519970_52021951_0"	501981	351730	357874	1013	6144	0	"P"	311	963	960	2e-04	0	"HG01978#1#JAGYVS010000002.1_51519970_52021951_0"	"AMYP1-201"	"2Ap"	"HG01978"	"0-3-7-9-4-6-8-5-2-4-9-7-2-5-2-4-9-7-2-5-2-1"	"0.0-3.0-7.0-9.0-4.0-6.0-8.0-5.0-2.0-4.1-9.1-7.1-2.1-5.1-2.0-4.1-9.1-7.1-2.1-5.0-2.0-1.0"	99	"HG01978#1#JAGYVS010000002.1_51519970_52021951_0"	351730	357874
"AMYP1-201"	1023	4	1022	"-"	"HG01978#2#JAGYVR010000007.1_51532241_51939176_0"	406935	270110	276254	1010	6144	0	"P"	305	960	959	0.0015	0	"HG01978#2#JAGYVR010000007.1_51532241_51939176_0"	"AMYP1-201"	"2Ap"	"HG01978"	"0-3-7-9-4-6-8-5-2-4-9-7-2-5-2-1"	"0.0-3.0-7.0-9.0-4.0-6.0-8.0-5.0-2.0-4.1-9.1-7.1-2.1-5.1-2.0-1.0"	99	"HG01978#2#JAGYVR010000007.1_51532241_51939176_0"	270110	276254
"AMYP1-201"	1023	4	1022	"-"	"HG02004.verkko_filt_mat.fa:haplotype1-0000022_97828542_98235483_0"	406941	270106	276250	1010	6144	0	"P"	305	960	959	0.0015	0	"HG02004.verkko_filt_mat.fa:haplotype1-0000022_97828542_98235483_0"	"AMYP1-201"	"2Ap"	"HG02004"	"0-3-7-9-4-6-8-5-2-4-9-7-2-5-2-1"	"0.0-3.0-7.0-9.0-4.0-6.0-8.0-5.0-2.0-4.1-9.1-7.1-2.1-5.1-2.0-1.0"	99	"HG02004.verkko_filt_mat.fa:haplotype1-0000022_97828542_98235483_0"	270106	276250
"AMYP1-201"	1023	4	1022	"-"	"HG02004.verkko_filt_pat.fa:haplotype2-0000813_139386576_140076845_1"	690269	270180	276324	1010	6144	0	"S"	305	960	NA	0.0015	0	"HG02004.verkko_filt_pat.fa:haplotype2-0000813_139386576_140076845_1"	"AMYP1-201"	"2Ap"	"HG02004"	"0-3-7-9-4-6-8-5-2-4-9-7-2-5-2-4-9-7-2-5-2-4-9-7-2-5-2-4-9-7-2-5-2-1"	"0.0-3.0-7.0-9.0-4.0-6.0-8.0-5.0-2.0-4.1-9.1-7.1-2.1-5.1-2.0-4.1-9.1-7.1-2.1-5.1-2.0-4.1-9.1-7.1-2.1-5.1-2.0-4.1-9.1-7.1-2.1-5.0-2.0-1.0"	154	"HG02004.verkko_filt_pat.fa:haplotype2-0000813_139386576_140076845_1"	270180	276324
"AMYP1-201"	1023	4	1022	"-"	"HG02004.verkko_filt_pat.fa:haplotype2-0000813_139386576_140076845_1"	690269	364317	370461	1010	6144	0	"S"	305	960	NA	0.0015	0	"HG02004.verkko_filt_pat.fa:haplotype2-0000813_139386576_140076845_1"	"AMYP1-201"	"2Ap"	"HG02004"	"0-3-7-9-4-6-8-5-2-4-9-7-2-5-2-4-9-7-2-5-2-4-9-7-2-5-2-4-9-7-2-5-2-1"	"0.0-3.0-7.0-9.0-4.0-6.0-8.0-5.0-2.0-4.1-9.1-7.1-2.1-5.1-2.0-4.1-9.1-7.1-2.1-5.1-2.0-4.1-9.1-7.1-2.1-5.1-2.0-4.1-9.1-7.1-2.1-5.0-2.0-1.0"	154	"HG02004.verkko_filt_pat.fa:haplotype2-0000813_139386576_140076845_1"	364317	370461
"AMYP1-201"	1023	4	1022	"-"	"HG02004.verkko_filt_pat.fa:haplotype2-0000813_139386576_140076845_1"	690269	458451	464595	1010	6144	0	"P"	305	960	960	0.0015	0	"HG02004.verkko_filt_pat.fa:haplotype2-0000813_139386576_140076845_1"	"AMYP1-201"	"2Ap"	"HG02004"	"0-3-7-9-4-6-8-5-2-4-9-7-2-5-2-4-9-7-2-5-2-4-9-7-2-5-2-4-9-7-2-5-2-1"	"0.0-3.0-7.0-9.0-4.0-6.0-8.0-5.0-2.0-4.1-9.1-7.1-2.1-5.1-2.0-4.1-9.1-7.1-2.1-5.1-2.0-4.1-9.1-7.1-2.1-5.1-2.0-4.1-9.1-7.1-2.1-5.0-2.0-1.0"	154	"HG02004.verkko_filt_pat.fa:haplotype2-0000813_139386576_140076845_1"	458451	464595
"AMYP1-201"	1023	4	1022	"+"	"HG02004.verkko_filt_pat.fa:haplotype2-0000813_139386576_140076845_1"	690269	540075	546219	1010	6144	0	"S"	305	960	NA	0.0015	0	"HG02004.verkko_filt_pat.fa:haplotype2-0000813_139386576_140076845_1"	"AMYP1-201"	"2Ap"	"HG02004"	"0-3-7-9-4-6-8-5-2-4-9-7-2-5-2-4-9-7-2-5-2-4-9-7-2-5-2-4-9-7-2-5-2-1"	"0.0-3.0-7.0-9.0-4.0-6.0-8.0-5.0-2.0-4.1-9.1-7.1-2.1-5.1-2.0-4.1-9.1-7.1-2.1-5.1-2.0-4.1-9.1-7.1-2.1-5.1-2.0-4.1-9.1-7.1-2.1-5.0-2.0-1.0"	154	"HG02004.verkko_filt_pat.fa:haplotype2-0000813_139386576_140076845_1"	540075	546219
"AMYP1-201"	1023	4	1022	"+"	"HG02071.verkko_filt_mat.fa:haplotype1-0000041_103610513_104018399_0"	407886	257608	263752	1010	6144	0	"P"	305	960	959	0.0015	0	"HG02071.verkko_filt_mat.fa:haplotype1-0000041_103610513_104018399_0"	"AMYP1-201"	"2Ap"	"HG02071"	"0-3-7-9-4-6-8-5-2-4-9-7-2-5-2-1"	"0.0-3.0-7.0-9.0-4.0-6.0-8.0-5.0-2.0-4.1-9.1-7.1-2.1-5.0-2.0-1.0"	99	"HG02071.verkko_filt_mat.fa:haplotype1-0000041_103610513_104018399_0"	257608	263752
"AMYP1-201"	1023	4	1022	"-"	"HG02071.verkko_filt_pat.fa:haplotype2-0000736_102745972_103248026_0"	502054	270142	276286	1010	6144	0	"S"	305	960	NA	0.0015	0	"HG02071.verkko_filt_pat.fa:haplotype2-0000736_102745972_103248026_0"	"AMYP1-201"	"2Ap"	"HG02071"	"0-3-7-9-4-6-8-5-2-4-9-7-2-5-2-4-9-7-2-5-2-1"	"0.0-3.0-7.0-9.0-4.0-6.0-8.0-5.0-2.0-4.1-9.1-7.1-2.1-5.1-2.0-4.1-9.1-7.1-2.1-5.1-2.0-1.0"	99	"HG02071.verkko_filt_pat.fa:haplotype2-0000736_102745972_103248026_0"	270142	276286
"AMYP1-201"	1023	4	1022	"-"	"HG02071.verkko_filt_pat.fa:haplotype2-0000736_102745972_103248026_0"	502054	364305	370449	1010	6144	0	"P"	305	960	960	0.0015	0	"HG02071.verkko_filt_pat.fa:haplotype2-0000736_102745972_103248026_0"	"AMYP1-201"	"2Ap"	"HG02071"	"0-3-7-9-4-6-8-5-2-4-9-7-2-5-2-4-9-7-2-5-2-1"	"0.0-3.0-7.0-9.0-4.0-6.0-8.0-5.0-2.0-4.1-9.1-7.1-2.1-5.1-2.0-4.1-9.1-7.1-2.1-5.1-2.0-1.0"	99	"HG02071.verkko_filt_pat.fa:haplotype2-0000736_102745972_103248026_0"	364305	370449
"AMYP1-201"	1023	9	1022	"-"	"HG02080#1#JAHEOW010000048.1_16689583_17097287_0"	407704	270012	276151	993	6139	0	"S"	301	943	NA	0.0013	0	"HG02080#1#JAHEOW010000048.1_16689583_17097287_0"	"AMYP1-201"	"2Ap"	"HG02080"	"0-3-7-9-4-6-8-5-2-4-9-7-2-5-2-1"	"0.0-3.0-7.0-9.0-4.0-6.0-8.0-5.0-2.0-4.1-9.1-7.1-2.1-5.1-2.0-1.0"	98	"HG02080#1#JAHEOW010000048.1_16689583_17097287_0"	270012	276151
"AMYP1-201"	1023	4	1022	"+"	"HG02080#2#JAHEOV010000017.1_16662177_17164189_0"	502012	257606	263750	1010	6144	0	"S"	305	960	NA	0.0015	0	"HG02080#2#JAHEOV010000017.1_16662177_17164189_0"	"AMYP1-201"	"2Ap"	"HG02080"	"0-3-7-9-4-6-8-5-2-4-9-7-2-5-2-4-9-7-2-5-2-1"	"0.0-3.0-7.0-9.0-4.0-6.0-8.0-5.0-2.0-4.1-9.1-7.1-2.1-5.0-2.0-4.1-9.1-7.1-2.1-5.0-2.0-1.0"	99	"HG02080#2#JAHEOV010000017.1_16662177_17164189_0"	257606	263750
"AMYP1-201"	1023	4	1022	"+"	"HG02080#2#JAHEOV010000017.1_16662177_17164189_0"	502012	351734	357878	1010	6144	0	"P"	305	960	960	0.0015	0	"HG02080#2#JAHEOV010000017.1_16662177_17164189_0"	"AMYP1-201"	"2Ap"	"HG02080"	"0-3-7-9-4-6-8-5-2-4-9-7-2-5-2-4-9-7-2-5-2-1"	"0.0-3.0-7.0-9.0-4.0-6.0-8.0-5.0-2.0-4.1-9.1-7.1-2.1-5.0-2.0-4.1-9.1-7.1-2.1-5.0-2.0-1.0"	99	"HG02080#2#JAHEOV010000017.1_16662177_17164189_0"	351734	357878
"AMYP1-201"	1023	4	1022	"-"	"HG02109#1#JAHEPG010000026.1_16673035_17080816_0"	407781	270082	276226	998	6144	1	"P"	303	948	944	0.0013	0	"HG02109#1#JAHEPG010000026.1_16673035_17080816_0"	"AMYP1-201"	"2Ap"	"HG02109"	"0-3-7-9-4-6-8-5-2-4-9-7-2-5-2-1"	"0.0-3.0-7.0-9.0-4.0-6.0-8.0-5.0-2.0-4.1-9.1-7.1-2.1-5.1-2.0-1.0"	98	"HG02109#1#JAHEPG010000026.1_16673035_17080816_0"	270082	276226
"AMYP1-201"	1023	4	1022	"+"	"HG02145#2#JAHKSF010000206.1_1005292_1413195_1"	407903	257744	263888	1003	6144	0	"S"	299	953	NA	0.0022	0	"HG02145#2#JAHKSF010000206.1_1005292_1413195_1"	"AMYP1-201"	"2Ap"	"HG02145"	"0-3-7-9-4-6-8-5-2-4-9-7-2-5-2-1"	"0.0-3.0-7.0-9.0-4.0-6.0-8.0-5.0-2.0-4.1-9.1-7.1-2.1-5.0-2.0-1.0"	154	"HG02145#2#JAHKSF010000206.1_1005292_1413195_1"	257744	263888
"AMYP1-201"	1023	4	1022	"-"	"HG02293.verkko_filt_pat.fa:haplotype2-0000836_148310532_148812524_1"	501992	270163	276307	1010	6144	0	"S"	305	960	NA	0.0015	0	"HG02293.verkko_filt_pat.fa:haplotype2-0000836_148310532_148812524_1"	"AMYP1-201"	"2Ap"	"HG02293"	"0-3-7-9-4-6-8-5-2-4-9-7-2-5-2-4-9-7-2-5-2-1"	"0.0-3.0-7.0-9.0-4.0-6.0-8.0-5.0-2.0-4.1-9.1-7.1-2.1-5.1-2.0-4.1-9.1-7.1-2.1-5.1-2.0-1.0"	155	"HG02293.verkko_filt_pat.fa:haplotype2-0000836_148310532_148812524_1"	270163	276307
"AMYP1-201"	1023	4	1022	"-"	"HG02293.verkko_filt_pat.fa:haplotype2-0000836_148310532_148812524_1"	501992	364295	370439	1010	6144	0	"P"	305	960	960	0.0015	0	"HG02293.verkko_filt_pat.fa:haplotype2-0000836_148310532_148812524_1"	"AMYP1-201"	"2Ap"	"HG02293"	"0-3-7-9-4-6-8-5-2-4-9-7-2-5-2-4-9-7-2-5-2-1"	"0.0-3.0-7.0-9.0-4.0-6.0-8.0-5.0-2.0-4.1-9.1-7.1-2.1-5.1-2.0-4.1-9.1-7.1-2.1-5.1-2.0-1.0"	155	"HG02293.verkko_filt_pat.fa:haplotype2-0000836_148310532_148812524_1"	364295	370439
"AMYP1-201"	1023	4	1022	"-"	"HG02300.verkko_filt_mat.fa:haplotype1-0000028_144052837_144460586_1"	407749	270106	276250	998	6144	0	"S"	303	948	NA	0.0013	0	"HG02300.verkko_filt_mat.fa:haplotype1-0000028_144052837_144460586_1"	"AMYP1-201"	"2Ap"	"HG02300"	"0-3-7-9-4-6-8-5-2-4-9-7-2-5-2-1"	"0.0-3.0-7.0-9.0-4.0-6.0-8.0-5.0-2.0-4.1-9.1-7.1-2.1-5.1-2.0-1.0"	154	"HG02300.verkko_filt_mat.fa:haplotype1-0000028_144052837_144460586_1"	270106	276250
"AMYP1-201"	1023	4	1022	"+"	"HG02300.verkko_filt_pat.fa:haplotype2-0000620_143362344_143769323_1"	406979	257676	263820	1013	6144	1	"P"	311	963	959	2e-04	0	"HG02300.verkko_filt_pat.fa:haplotype2-0000620_143362344_143769323_1"	"AMYP1-201"	"2Ap"	"HG02300"	"0-3-7-9-4-6-8-5-2-4-9-7-2-5-2-1"	"0.0-3.0-7.0-9.0-4.0-6.0-8.0-5.0-2.0-4.1-9.1-7.1-2.1-5.0-2.0-1.0"	155	"HG02300.verkko_filt_pat.fa:haplotype2-0000620_143362344_143769323_1"	257676	263820
"AMYP1-201"	1023	4	1022	"-"	"HG02486#1#JAGYVM010000007.1_28868414_29370339_1"	501925	270182	276325	995	6143	0	"S"	298	945	NA	0.0024	0	"HG02486#1#JAGYVM010000007.1_28868414_29370339_1"	"AMYP1-201"	"2Ap"	"HG02486"	"0-3-7-9-4-6-8-5-2-4-9-7-2-5-2-7-9-4-2-5-2-1"	"0.0-3.0-7.0-9.0-4.0-6.0-8.0-5.0-2.0-4.1-9.1-7.1-2.1-5.1-2.0-7.0-9.0-4.0-2.1-5.0-2.0-1.0"	154	"HG02486#1#JAGYVM010000007.1_28868414_29370339_1"	270182	276325
"AMYP1-201"	1023	4	1022	"+"	"HG02486#1#JAGYVM010000007.1_28868414_29370339_1"	501925	351773	357916	995	6143	0	"S"	298	945	NA	0.0024	0	"HG02486#1#JAGYVM010000007.1_28868414_29370339_1"	"AMYP1-201"	"2Ap"	"HG02486"	"0-3-7-9-4-6-8-5-2-4-9-7-2-5-2-7-9-4-2-5-2-1"	"0.0-3.0-7.0-9.0-4.0-6.0-8.0-5.0-2.0-4.1-9.1-7.1-2.1-5.1-2.0-7.0-9.0-4.0-2.1-5.0-2.0-1.0"	154	"HG02486#1#JAGYVM010000007.1_28868414_29370339_1"	351773	357916
"AMYP1-201"	1023	4	1022	"-"	"HG02486#2#JAGYVL010000029.1_94163344_94570162_0"	406818	270060	276204	998	6144	0	"P"	303	948	948	0.0013	0	"HG02486#2#JAGYVL010000029.1_94163344_94570162_0"	"AMYP1-201"	"2Ap"	"HG02486"	"0-3-7-9-4-6-8-5-2-7-9-4-2-5-2-1"	"0.0-3.0-7.0-9.0-4.0-6.0-8.0-5.0-2.0-7.0-9.0-4.0-2.1-5.1-2.0-1.0"	98	"HG02486#2#JAGYVL010000029.1_94163344_94570162_0"	270060	276204
"AMYP1-201"	1023	4	1022	"-"	"HG02559#1#JAGYVK010000012.1_51505852_51913611_0"	407759	270107	276250	998	6143	0	"S"	303	948	NA	0.0013	0	"HG02559#1#JAGYVK010000012.1_51505852_51913611_0"	"AMYP1-201"	"2Ap"	"HG02559"	"0-3-7-9-4-6-8-5-2-4-9-7-2-5-2-1"	"0.0-3.0-7.0-9.0-4.0-6.0-8.0-5.0-2.0-4.1-9.1-7.1-2.1-5.1-2.0-1.0"	98	"HG02559#1#JAGYVK010000012.1_51505852_51913611_0"	270107	276250
"AMYP1-201"	1023	4	1022	"-"	"HG02559#2#JAGYVJ010000037.1_52167780_52574597_1"	406817	270118	276262	1009	6144	0	"S"	306	959	NA	7e-04	0	"HG02559#2#JAGYVJ010000037.1_52167780_52574597_1"	"AMYP1-201"	"2Ap"	"HG02559"	"0-3-7-9-4-6-8-5-2-4-9-7-2-5-2-1"	"0.0-3.0-7.0-9.0-4.0-6.0-8.0-5.0-2.0-4.1-9.1-7.1-2.1-5.1-2.0-1.0"	154	"HG02559#2#JAGYVJ010000037.1_52167780_52574597_1"	270118	276262
"AMYP1-201"	1023	4	1022	"+"	"HG02622#1#JAHAOO010000002.1_16673678_17080663_0"	406985	257682	263826	1003	6144	0	"S"	299	953	NA	0.0022	0	"HG02622#1#JAHAOO010000002.1_16673678_17080663_0"	"AMYP1-201"	"2Ap"	"HG02622"	"0-3-7-9-4-6-8-5-2-4-9-7-2-5-2-1"	"0.0-3.0-7.0-9.0-4.0-6.0-8.0-5.0-2.0-4.1-9.1-7.1-2.1-5.0-2.0-1.0"	98	"HG02622#1#JAHAOO010000002.1_16673678_17080663_0"	257682	263826
"AMYP1-201"	1023	4	1022	"+"	"HG02622#2#JAHAON010000012.1_51551779_52031001_0"	479222	329933	336042	998	6109	0	"S"	303	948	NA	0.0013	0	"HG02622#2#JAHAON010000012.1_51551779_52031001_0"	"AMYP1-201"	"2Ap"	"HG02622"	"0-3-7-9-4-6-8-5-2-7-9-4-2-5-8-6-4-9-7-2-5-2-1"	"0.0-3.0-7.0-9.0-4.0-6.0-8.0-5.0-2.0-7.0-9.0-4.0-2.1-5.1-8.1-6.1-4.1-9.1-7.1-2.1-5.0-2.0-1.0"	98	"HG02622#2#JAHAON010000012.1_51551779_52031001_0"	329933	336042
"AMYP1-201"	1023	4	1022	"+"	"HG02630#1#JAHAOQ010000102.1_16672145_17079089_0"	406944	257659	263803	1003	6144	0	"S"	299	953	NA	0.0022	0	"HG02630#1#JAHAOQ010000102.1_16672145_17079089_0"	"AMYP1-201"	"2Ap"	"HG02630"	"0-3-7-9-4-6-8-5-2-4-9-7-2-5-2-1"	"0.0-3.0-7.0-9.0-4.0-6.0-8.0-5.0-2.0-4.1-9.1-7.1-2.1-5.0-2.0-1.0"	98	"HG02630#1#JAHAOQ010000102.1_16672145_17079089_0"	257659	263803
"AMYP1-201"	1023	4	1022	"-"	"HG02630#2#JAHAOP010000089.1_16669255_17076135_0"	406880	270129	276274	1009	6145	3	"P"	306	959	948	7e-04	0	"HG02630#2#JAHAOP010000089.1_16669255_17076135_0"	"AMYP1-201"	"2Ap"	"HG02630"	"0-3-7-9-4-6-8-5-2-7-9-4-2-5-2-1"	"0.0-3.0-7.0-9.0-4.0-6.0-8.0-5.0-2.0-7.0-9.0-4.0-2.1-5.1-2.0-1.0"	98	"HG02630#2#JAHAOP010000089.1_16669255_17076135_0"	270129	276274
"AMYP1-201"	1023	4	1022	"+"	"HG02717#1#JAHAOS010000015.1_16660311_17067250_0"	406939	257586	263730	1003	6144	0	"P"	299	953	953	0.0022	0	"HG02717#1#JAHAOS010000015.1_16660311_17067250_0"	"AMYP1-201"	"2Ap"	"HG02717"	"0-3-7-9-4-6-8-5-2-4-9-7-2-5-2-1"	"0.0-3.0-7.0-9.0-4.0-6.0-8.0-5.0-2.0-4.1-9.1-7.1-2.1-5.0-2.0-1.0"	98	"HG02717#1#JAHAOS010000015.1_16660311_17067250_0"	257586	263730
"AMYP1-201"	1023	4	1022	"-"	"HG02717#2#JAHAOR010000006.1_19663827_20070693_1"	406866	270161	276305	998	6144	0	"S"	303	948	NA	0.0013	0	"HG02717#2#JAHAOR010000006.1_19663827_20070693_1"	"AMYP1-201"	"2Ap"	"HG02717"	"0-3-7-9-4-6-8-5-2-7-9-4-2-5-2-1"	"0.0-3.0-7.0-9.0-4.0-6.0-8.0-5.0-2.0-7.0-9.0-4.0-2.1-5.1-2.0-1.0"	154	"HG02717#2#JAHAOR010000006.1_19663827_20070693_1"	270161	276305
"AMYP1-201"	1023	4	1022	"-"	"HG02809.verkko_filt_pat.fa:haplotype2-0001251_103421111_103827972_0"	406861	270105	276249	993	6144	0	"S"	299	943	NA	0.0022	0	"HG02809.verkko_filt_pat.fa:haplotype2-0001251_103421111_103827972_0"	"AMYP1-201"	"2Ap"	"HG02809"	"0-3-7-9-4-6-8-5-2-7-9-4-2-5-2-1"	"0.0-3.0-7.0-9.0-4.0-6.0-8.0-5.0-2.0-7.0-9.0-4.0-2.1-5.1-2.0-1.0"	98	"HG02809.verkko_filt_pat.fa:haplotype2-0001251_103421111_103827972_0"	270105	276249
"AMYP1-201"	1023	4	1022	"+"	"HG02818#1#JAHEOS010000101.1_89626_496613_0"	406987	257692	263836	1003	6144	0	"P"	299	953	953	0.0022	0	"HG02818#1#JAHEOS010000101.1_89626_496613_0"	"AMYP1-201"	"2Ap"	"HG02818"	"0-3-7-9-4-6-8-5-2-4-9-7-2-5-2-1"	"0.0-3.0-7.0-9.0-4.0-6.0-8.0-5.0-2.0-4.1-9.1-7.1-2.1-5.0-2.0-1.0"	98	"HG02818#1#JAHEOS010000101.1_89626_496613_0"	257692	263836
"AMYP1-201"	1023	4	1022	"+"	"HG02818#2#JAHEOR010000010.1_31775319_32183091_1"	407772	257664	263809	1009	6145	3	"P"	306	959	948	7e-04	0	"HG02818#2#JAHEOR010000010.1_31775319_32183091_1"	"AMYP1-201"	"2Ap"	"HG02818"	"0-3-7-9-4-6-8-5-2-4-9-7-2-5-2-1"	"0.0-3.0-7.0-9.0-4.0-6.0-8.0-5.0-2.0-4.1-9.1-7.1-2.1-5.0-2.0-1.0"	154	"HG02818#2#JAHEOR010000010.1_31775319_32183091_1"	257664	263809
"AMYP1-201"	1023	4	1022	"-"	"HG02886#1#JAHAOU010000178.1_62411_469262_0"	406851	270089	276233	998	6144	0	"P"	303	948	948	0.0013	0	"HG02886#1#JAHAOU010000178.1_62411_469262_0"	"AMYP1-201"	"2Ap"	"HG02886"	"0-3-7-9-4-6-8-5-2-4-9-7-2-5-2-1"	"0.0-3.0-7.0-9.0-4.0-6.0-8.0-5.0-2.0-4.1-9.1-7.1-2.1-5.1-2.0-1.0"	98	"HG02886#1#JAHAOU010000178.1_62411_469262_0"	270089	276233
"AMYP1-201"	1023	4	1022	"+"	"HG03453#1#JAGYVW010000157.1_2105722_2585000_1"	479278	330040	336184	994	6144	0	"S"	297	944	NA	0.0026	0	"HG03453#1#JAGYVW010000157.1_2105722_2585000_1"	"AMYP1-201"	"2Ap"	"HG03453"	"0-3-7-9-4-6-8-5-2-7-9-4-6-8-5-2-7-9-4-2-5-2-1"	"0.0-3.0-7.0-9.0-4.0-6.0-8.0-5.0-2.0-7.0-9.0-4.0-6.0-8.0-5.0-2.0-7.0-9.0-4.0-2.1-5.0-2.0-1.0"	154	"HG03453#1#JAGYVW010000157.1_2105722_2585000_1"	330040	336184
"AMYP1-201"	1023	4	1022	"-"	"HG03453#2#JAGYVV010000088.1_22597550_23005370_1"	407820	270155	276299	1005	6144	1	"P"	306	955	951	0.0013	0	"HG03453#2#JAGYVV010000088.1_22597550_23005370_1"	"AMYP1-201"	"2Ap"	"HG03453"	"0-3-7-9-4-6-8-5-2-7-9-4-2-5-2-1"	"0.0-3.0-7.0-9.0-4.0-6.0-8.0-5.0-2.0-7.0-9.0-4.0-2.1-5.1-2.0-1.0"	154	"HG03453#2#JAGYVV010000088.1_22597550_23005370_1"	270155	276299
"AMYP1-201"	1023	4	1022	"+"	"HG03486#1#JAHEOQ010000123.1_16677696_17085575_0"	407879	257610	263754	1010	6144	0	"P"	305	960	959	0.0015	0	"HG03486#1#JAHEOQ010000123.1_16677696_17085575_0"	"AMYP1-201"	"2Ap"	"HG03486"	"0-3-7-9-4-6-8-5-2-4-9-7-2-5-2-1"	"0.0-3.0-7.0-9.0-4.0-6.0-8.0-5.0-2.0-4.1-9.1-7.1-2.1-5.0-2.0-1.0"	99	"HG03486#1#JAHEOQ010000123.1_16677696_17085575_0"	257610	263754
"AMYP1-201"	1023	4	1022	"-"	"HG03486#2#JAHEOP010000248.1_2105565_2584784_1"	479219	342512	348656	998	6144	1	"P"	303	948	944	0.0013	0	"HG03486#2#JAHEOP010000248.1_2105565_2584784_1"	"AMYP1-201"	"2Ap"	"HG03486"	"0-3-7-9-4-6-8-5-2-7-9-4-6-8-5-2-7-9-4-2-5-2-1"	"0.0-3.0-7.0-9.0-4.0-6.0-8.0-5.0-2.0-7.0-9.0-4.0-6.0-8.0-5.0-2.0-7.0-9.0-4.0-2.1-5.1-2.0-1.0"	154	"HG03486#2#JAHEOP010000248.1_2105565_2584784_1"	342512	348656
"AMYP1-201"	1023	4	1022	"-"	"HG03492#1#JAHEPI010000180.1_2103395_2543326_1"	439931	302305	308449	998	6144	0	"S"	303	948	NA	0.0013	0	"HG03492#1#JAHEPI010000180.1_2103395_2543326_1"	"AMYP1-201"	"2Ap"	"HG03492"	"0-3-7-9-4-6-8-5-2-7-9-4-6-8-5-2-4-2-5-2-1"	"0.0-3.0-7.0-9.0-4.0-6.0-8.0-5.0-2.0-7.0-9.0-4.0-6.0-8.0-5.0-2.0-4.0-2.1-5.1-2.0-1.0"	154	"HG03492#1#JAHEPI010000180.1_2103395_2543326_1"	302305	308449
"AMYP1-201"	1023	4	1022	"-"	"HG03516#1#JAGYYT010000012.1_24170958_24578778_1"	407820	270158	276302	998	6144	0	"S"	303	948	NA	0.0013	0	"HG03516#1#JAGYYT010000012.1_24170958_24578778_1"	"AMYP1-201"	"2Ap"	"HG03516"	"0-3-7-9-4-6-8-5-2-7-9-4-2-5-2-1"	"0.0-3.0-7.0-9.0-4.0-6.0-8.0-5.0-2.0-7.0-9.0-4.0-2.1-5.1-2.0-1.0"	154	"HG03516#1#JAGYYT010000012.1_24170958_24578778_1"	270158	276302
"AMYP1-201"	1023	4	1022	"-"	"HG03516#2#JAGYYS010000004.1_24452130_24859892_1"	407762	270159	276302	998	6143	0	"S"	303	948	NA	0.0013	0	"HG03516#2#JAGYYS010000004.1_24452130_24859892_1"	"AMYP1-201"	"2Ap"	"HG03516"	"0-3-7-9-4-6-8-5-2-4-9-7-2-5-2-1"	"0.0-3.0-7.0-9.0-4.0-6.0-8.0-5.0-2.0-4.1-9.1-7.1-2.1-5.1-2.0-1.0"	154	"HG03516#2#JAGYYS010000004.1_24452130_24859892_1"	270159	276302
"AMYP1-201"	1023	4	1022	"+"	"HG03540#1#JAGYVY010000208.1_95187_596142_0"	500955	257575	263720	1000	6145	0	"P"	304	950	948	0.0011	0	"HG03540#1#JAGYVY010000208.1_95187_596142_0"	"AMYP1-201"	"2Ap"	"HG03540"	"0-3-7-9-4-6-8-5-2-4-9-7-2-5-2-4-9-7-2-5-2-1"	"0.0-3.0-7.0-9.0-4.0-6.0-8.0-5.0-2.0-4.1-9.1-7.1-2.1-5.0-2.0-4.1-9.1-7.1-2.1-5.1-2.0-1.0"	98	"HG03540#1#JAGYVY010000208.1_95187_596142_0"	257575	263720
"AMYP1-201"	1023	4	1022	"-"	"HG03540#1#JAGYVY010000208.1_95187_596142_0"	500955	364218	370361	998	6143	0	"S"	303	948	NA	0.0013	0	"HG03540#1#JAGYVY010000208.1_95187_596142_0"	"AMYP1-201"	"2Ap"	"HG03540"	"0-3-7-9-4-6-8-5-2-4-9-7-2-5-2-4-9-7-2-5-2-1"	"0.0-3.0-7.0-9.0-4.0-6.0-8.0-5.0-2.0-4.1-9.1-7.1-2.1-5.0-2.0-4.1-9.1-7.1-2.1-5.1-2.0-1.0"	98	"HG03540#1#JAGYVY010000208.1_95187_596142_0"	364218	370361
"AMYP1-201"	1023	4	1022	"+"	"HG03540#2#JAGYVX010000148.1_1368955_1877115_0"	508160	260869	267013	998	6144	0	"P"	303	948	948	0.0013	0	"HG03540#2#JAGYVX010000148.1_1368955_1877115_0"	"AMYP1-201"	"2Ap"	"HG03540"	"0-3-7-9-4-6-8-5-2-4-4-2-5-2-4-4-2-5-2-1"	"0.0-3.0-7.0-9.0-4.0-6.0-8.0-5.0-2.0-4.1-4.0-2.1-5.0-2.0-4.1-4.0-2.1-5.1-2.0-1.0"	98	"HG03540#2#JAGYVX010000148.1_1368955_1877115_0"	260869	267013
"AMYP1-201"	1023	4	1022	"-"	"HG03540#2#JAGYVX010000148.1_1368955_1877115_0"	508160	370400	376544	998	6144	0	"S"	303	948	NA	0.0013	0	"HG03540#2#JAGYVX010000148.1_1368955_1877115_0"	"AMYP1-201"	"2Ap"	"HG03540"	"0-3-7-9-4-6-8-5-2-4-4-2-5-2-4-4-2-5-2-1"	"0.0-3.0-7.0-9.0-4.0-6.0-8.0-5.0-2.0-4.1-4.0-2.1-5.0-2.0-4.1-4.0-2.1-5.1-2.0-1.0"	98	"HG03540#2#JAGYVX010000148.1_1368955_1877115_0"	370400	376544
"AMYP1-201"	1023	4	1022	"-"	"HG03579#1#JAGYVU010000029.1_91404_499180_0"	407776	270120	276265	998	6145	0	"S"	303	948	NA	0.0013	0	"HG03579#1#JAGYVU010000029.1_91404_499180_0"	"AMYP1-201"	"2Ap"	"HG03579"	"0-3-7-9-4-6-8-5-2-7-9-4-2-5-2-1"	"0.0-3.0-7.0-9.0-4.0-6.0-8.0-5.0-2.0-7.0-9.0-4.0-2.1-5.1-2.0-1.0"	98	"HG03579#1#JAGYVU010000029.1_91404_499180_0"	270120	276265
"AMYP1-201"	1023	4	1022	"+"	"HG03710.verkko_filt_pat.fa:haplotype2-0000488_101614437_102218208_0"	603771	260426	266570	995	6144	0	"S"	299	945	NA	0.0022	0	"HG03710.verkko_filt_pat.fa:haplotype2-0000488_101614437_102218208_0"	"AMYP1-201"	"2Ap"	"HG03710"	"0-3-7-9-4-6-8-5-2-4-4-2-5-2-4-4-2-5-2-4-4-2-5-2-1"	"0.0-3.0-7.0-9.0-4.0-6.0-8.0-5.0-2.0-4.1-4.0-2.1-5.0-2.0-4.1-4.0-2.1-5.1-2.0-4.1-4.0-2.1-5.0-2.0-1.0"	98	"HG03710.verkko_filt_pat.fa:haplotype2-0000488_101614437_102218208_0"	260426	266570
"AMYP1-201"	1023	4	1022	"-"	"HG03710.verkko_filt_pat.fa:haplotype2-0000488_101614437_102218208_0"	603771	369976	376120	998	6144	0	"P"	303	948	948	0.0013	0	"HG03710.verkko_filt_pat.fa:haplotype2-0000488_101614437_102218208_0"	"AMYP1-201"	"2Ap"	"HG03710"	"0-3-7-9-4-6-8-5-2-4-4-2-5-2-4-4-2-5-2-4-4-2-5-2-1"	"0.0-3.0-7.0-9.0-4.0-6.0-8.0-5.0-2.0-4.1-4.0-2.1-5.0-2.0-4.1-4.0-2.1-5.1-2.0-4.1-4.0-2.1-5.0-2.0-1.0"	98	"HG03710.verkko_filt_pat.fa:haplotype2-0000488_101614437_102218208_0"	369976	376120
"AMYP1-201"	1023	4	1022	"+"	"HG03710.verkko_filt_pat.fa:haplotype2-0000488_101614437_102218208_0"	603771	454507	460651	998	6144	0	"S"	303	948	NA	0.0013	0	"HG03710.verkko_filt_pat.fa:haplotype2-0000488_101614437_102218208_0"	"AMYP1-201"	"2Ap"	"HG03710"	"0-3-7-9-4-6-8-5-2-4-4-2-5-2-4-4-2-5-2-4-4-2-5-2-1"	"0.0-3.0-7.0-9.0-4.0-6.0-8.0-5.0-2.0-4.1-4.0-2.1-5.0-2.0-4.1-4.0-2.1-5.1-2.0-4.1-4.0-2.1-5.0-2.0-1.0"	98	"HG03710.verkko_filt_pat.fa:haplotype2-0000488_101614437_102218208_0"	454507	460651
"AMYP1-201"	1023	4	1022	"-"	"HG03927.verkko_filt_mat.fa:haplotype1-0000009_134765170_135173010_1"	407840	270181	276325	998	6144	0	"S"	303	948	NA	0.0013	0	"HG03927.verkko_filt_mat.fa:haplotype1-0000009_134765170_135173010_1"	"AMYP1-201"	"2Ap"	"HG03927"	"0-3-7-9-4-6-8-5-2-7-9-4-2-5-2-1"	"0.0-3.0-7.0-9.0-4.0-6.0-8.0-5.0-2.0-7.0-9.0-4.0-2.1-5.1-2.0-1.0"	154	"HG03927.verkko_filt_mat.fa:haplotype1-0000009_134765170_135173010_1"	270181	276325
"AMYP1-201"	1023	4	1022	"-"	"HG03927.verkko_filt_pat.fa:haplotype2-0000800_29002142_29504057_1"	501915	270135	276279	998	6144	0	"S"	303	948	NA	0.0013	0	"HG03927.verkko_filt_pat.fa:haplotype2-0000800_29002142_29504057_1"	"AMYP1-201"	"2Ap"	"HG03927"	"0-3-7-9-4-6-8-5-2-7-9-4-2-5-2-7-9-4-2-5-2-1"	"0.0-3.0-7.0-9.0-4.0-6.0-8.0-5.0-2.0-7.0-9.0-4.0-2.1-5.1-2.0-7.0-9.0-4.0-2.1-5.1-2.0-1.0"	154	"HG03927.verkko_filt_pat.fa:haplotype2-0000800_29002142_29504057_1"	270135	276279
"AMYP1-201"	1023	4	1022	"-"	"HG03927.verkko_filt_pat.fa:haplotype2-0000800_29002142_29504057_1"	501915	364252	370396	998	6144	0	"S"	303	948	NA	0.0013	0	"HG03927.verkko_filt_pat.fa:haplotype2-0000800_29002142_29504057_1"	"AMYP1-201"	"2Ap"	"HG03927"	"0-3-7-9-4-6-8-5-2-7-9-4-2-5-2-7-9-4-2-5-2-1"	"0.0-3.0-7.0-9.0-4.0-6.0-8.0-5.0-2.0-7.0-9.0-4.0-2.1-5.1-2.0-7.0-9.0-4.0-2.1-5.1-2.0-1.0"	154	"HG03927.verkko_filt_pat.fa:haplotype2-0000800_29002142_29504057_1"	364252	370396
"AMYP1-201"	1023	4	1022	"-"	"HG04228.verkko_filt_mat.fa:haplotype1-0000023_103429213_103930285_0"	501072	270089	276233	1010	6144	0	"S"	305	960	NA	0.0015	0	"HG04228.verkko_filt_mat.fa:haplotype1-0000023_103429213_103930285_0"	"AMYP1-201"	"2Ap"	"HG04228"	"0-3-7-9-4-6-8-5-2-7-9-4-2-5-2-4-9-7-2-5-2-1"	"0.0-3.0-7.0-9.0-4.0-6.0-8.0-5.0-2.0-7.0-9.0-4.0-2.1-5.1-2.0-4.1-9.1-7.1-2.1-5.0-2.0-1.0"	99	"HG04228.verkko_filt_mat.fa:haplotype1-0000023_103429213_103930285_0"	270089	276233
"AMYP1-201"	1023	4	1022	"+"	"HG04228.verkko_filt_mat.fa:haplotype1-0000023_103429213_103930285_0"	501072	351719	357863	1010	6144	0	"P"	305	960	960	0.0015	0	"HG04228.verkko_filt_mat.fa:haplotype1-0000023_103429213_103930285_0"	"AMYP1-201"	"2Ap"	"HG04228"	"0-3-7-9-4-6-8-5-2-7-9-4-2-5-2-4-9-7-2-5-2-1"	"0.0-3.0-7.0-9.0-4.0-6.0-8.0-5.0-2.0-7.0-9.0-4.0-2.1-5.1-2.0-4.1-9.1-7.1-2.1-5.0-2.0-1.0"	99	"HG04228.verkko_filt_mat.fa:haplotype1-0000023_103429213_103930285_0"	351719	357863
"AMYP1-201"	1023	4	1022	"+"	"NA18906#1#JAHEOO010000054.1_2103477_2510435_1"	406958	257721	263865	1003	6144	0	"S"	299	953	NA	0.0022	0	"NA18906#1#JAHEOO010000054.1_2103477_2510435_1"	"AMYP1-201"	"2Ap"	"NA18906"	"0-3-7-9-4-6-8-5-2-4-9-7-2-5-2-1"	"0.0-3.0-7.0-9.0-4.0-6.0-8.0-5.0-2.0-4.1-9.1-7.1-2.1-5.0-2.0-1.0"	154	"NA18906#1#JAHEOO010000054.1_2103477_2510435_1"	257721	263865
"AMYP1-201"	1023	4	1022	"+"	"NA18906#2#JAHEON010000009.1_93748295_94249275_0"	500980	257552	263689	1009	6137	3	"P"	306	959	948	7e-04	0	"NA18906#2#JAHEON010000009.1_93748295_94249275_0"	"AMYP1-201"	"2Ap"	"NA18906"	"0-3-7-9-4-6-8-5-2-4-9-7-2-5-2-4-9-7-2-5-2-1"	"0.0-3.0-7.0-9.0-4.0-6.0-8.0-5.0-2.0-4.1-9.1-7.1-2.1-5.0-2.0-4.1-9.1-7.1-2.1-5.1-2.0-1.0"	98	"NA18906#2#JAHEON010000009.1_93748295_94249275_0"	257552	263689
"AMYP1-201"	1023	4	1022	"-"	"NA18906#2#JAHEON010000009.1_93748295_94249275_0"	500980	364174	370311	998	6137	0	"S"	303	948	NA	0.0013	0	"NA18906#2#JAHEON010000009.1_93748295_94249275_0"	"AMYP1-201"	"2Ap"	"NA18906"	"0-3-7-9-4-6-8-5-2-4-9-7-2-5-2-4-9-7-2-5-2-1"	"0.0-3.0-7.0-9.0-4.0-6.0-8.0-5.0-2.0-4.1-9.1-7.1-2.1-5.0-2.0-4.1-9.1-7.1-2.1-5.1-2.0-1.0"	98	"NA18906#2#JAHEON010000009.1_93748295_94249275_0"	364174	370311
"AMYP1-201"	1023	4	1022	"-"	"NA19240#1#JAHEOM010000047.1_30103390_30511199_1"	407809	270203	276346	998	6143	0	"S"	303	948	NA	0.0013	0	"NA19240#1#JAHEOM010000047.1_30103390_30511199_1"	"AMYP1-201"	"2Ap"	"NA19240"	"0-3-7-9-4-6-8-5-2-4-9-7-2-5-2-1"	"0.0-3.0-7.0-9.0-4.0-6.0-8.0-5.0-2.0-4.1-9.1-7.1-2.1-5.1-2.0-1.0"	154	"NA19240#1#JAHEOM010000047.1_30103390_30511199_1"	270203	276346
"AMYP1-201"	1023	4	1022	"-"	"NA19240#2#JAHEOL010000010.1_37445323_37853017_0"	407694	270019	276128	998	6109	2	"P"	303	948	941	0.0013	0	"NA19240#2#JAHEOL010000010.1_37445323_37853017_0"	"AMYP1-201"	"2Ap"	"NA19240"	"0-3-7-9-4-6-8-5-2-7-9-4-2-5-2-1"	"0.0-3.0-7.0-9.0-4.0-6.0-8.0-5.0-2.0-7.0-9.0-4.0-2.1-5.1-2.0-1.0"	98	"NA19240#2#JAHEOL010000010.1_37445323_37853017_0"	270019	276128
"AMYP1-201"	1023	4	1022	"+"	"NA20129#2#JAHEPD010000155.1_90039_569275_0"	479236	329950	336059	998	6109	0	"S"	303	948	NA	0.0013	0	"NA20129#2#JAHEPD010000155.1_90039_569275_0"	"AMYP1-201"	"2Ap"	"NA20129"	"0-3-7-9-4-6-8-5-2-7-9-4-2-5-8-6-4-9-7-2-5-2-1"	"0.0-3.0-7.0-9.0-4.0-6.0-8.0-5.0-2.0-7.0-9.0-4.0-2.1-5.1-8.1-6.1-4.1-9.1-7.1-2.1-5.0-2.0-1.0"	98	"NA20129#2#JAHEPD010000155.1_90039_569275_0"	329950	336059
