contig	sample_id	bstart	bend	bID	bdunno	bOrientation	entryix	exitix	seg_len	rel_end	rel_start	hap_struc	hap_struc_d	hap_block_start	rel_start2	rel_end2
AV_HG00673#haplotype1#0000019:16627360-17129375	AV_HG00673	100	115475	0	672	0	0	671	115375	115375	0	0-3-7-9-4-6-8-5-2-4-9-7-2-5-2-4-9-7-2-5-2-1	0.0-3.0-7.0-9.0-4.0-6.0-8.0-5.0-2.0-4.1-9.1-7.1-2.1-5.0-2.0-4.1-9.1-7.1-2.1-5.0-2.0-1.0	100	0	115375
AV_HG00673#haplotype1#0000019:16627360-17129375	AV_HG00673	115566	138404	3	132	0	0	131	22838	138213	115375	0-3-7-9-4-6-8-5-2-4-9-7-2-5-2-4-9-7-2-5-2-1	0.0-3.0-7.0-9.0-4.0-6.0-8.0-5.0-2.0-4.1-9.1-7.1-2.1-5.0-2.0-4.1-9.1-7.1-2.1-5.0-2.0-1.0	100	115466	138304
AV_HG00673#haplotype1#0000019:16627360-17129375	AV_HG00673	139163	141203	7	12	0	0	11	2040	140253	138213	0-3-7-9-4-6-8-5-2-4-9-7-2-5-2-4-9-7-2-5-2-1	0.0-3.0-7.0-9.0-4.0-6.0-8.0-5.0-2.0-4.1-9.1-7.1-2.1-5.0-2.0-4.1-9.1-7.1-2.1-5.0-2.0-1.0	100	139063	141103
AV_HG00673#haplotype1#0000019:16627360-17129375	AV_HG00673	141147	142459	9	5	0	0	4	1312	141565	140253	0-3-7-9-4-6-8-5-2-4-9-7-2-5-2-4-9-7-2-5-2-1	0.0-3.0-7.0-9.0-4.0-6.0-8.0-5.0-2.0-4.1-9.1-7.1-2.1-5.0-2.0-4.1-9.1-7.1-2.1-5.0-2.0-1.0	100	141047	142359
AV_HG00673#haplotype1#0000019:16627360-17129375	AV_HG00673	142907	158700	4	84	0	0	83	15793	157358	141565	0-3-7-9-4-6-8-5-2-4-9-7-2-5-2-4-9-7-2-5-2-1	0.0-3.0-7.0-9.0-4.0-6.0-8.0-5.0-2.0-4.1-9.1-7.1-2.1-5.0-2.0-4.1-9.1-7.1-2.1-5.0-2.0-1.0	100	142807	158600
AV_HG00673#haplotype1#0000019:16627360-17129375	AV_HG00673	158644	161460	6	12	0	0	11	2816	160174	157358	0-3-7-9-4-6-8-5-2-4-9-7-2-5-2-4-9-7-2-5-2-1	0.0-3.0-7.0-9.0-4.0-6.0-8.0-5.0-2.0-4.1-9.1-7.1-2.1-5.0-2.0-4.1-9.1-7.1-2.1-5.0-2.0-1.0	100	158544	161360
AV_HG00673#haplotype1#0000019:16627360-17129375	AV_HG00673	161404	163174	8	8	0	0	7	1770	161944	160174	0-3-7-9-4-6-8-5-2-4-9-7-2-5-2-4-9-7-2-5-2-1	0.0-3.0-7.0-9.0-4.0-6.0-8.0-5.0-2.0-4.1-9.1-7.1-2.1-5.0-2.0-4.1-9.1-7.1-2.1-5.0-2.0-1.0	100	161304	163074
AV_HG00673#haplotype1#0000019:16627360-17129375	AV_HG00673	163118	176222	5	79	0	0	78	13104	175048	161944	0-3-7-9-4-6-8-5-2-4-9-7-2-5-2-4-9-7-2-5-2-1	0.0-3.0-7.0-9.0-4.0-6.0-8.0-5.0-2.0-4.1-9.1-7.1-2.1-5.0-2.0-4.1-9.1-7.1-2.1-5.0-2.0-1.0	100	163018	176122
AV_HG00673#haplotype1#0000019:16627360-17129375	AV_HG00673	176166	210104	2	196	0	0	194	33938	208986	175048	0-3-7-9-4-6-8-5-2-4-9-7-2-5-2-4-9-7-2-5-2-1	0.0-3.0-7.0-9.0-4.0-6.0-8.0-5.0-2.0-4.1-9.1-7.1-2.1-5.0-2.0-4.1-9.1-7.1-2.1-5.0-2.0-1.0	100	176066	210004
AV_HG00673#haplotype1#0000019:16627360-17129375	AV_HG00673	212355	223900	4	84	1	58	4	11545	220531	208986	0-3-7-9-4-6-8-5-2-4-9-7-2-5-2-4-9-7-2-5-2-1	0.0-3.0-7.0-9.0-4.0-6.0-8.0-5.0-2.0-4.1-9.1-7.1-2.1-5.0-2.0-4.1-9.1-7.1-2.1-5.0-2.0-1.0	100	212255	223800
AV_HG00673#haplotype1#0000019:16627360-17129375	AV_HG00673	224967	226278	9	5	1	4	0	1311	221842	220531	0-3-7-9-4-6-8-5-2-4-9-7-2-5-2-4-9-7-2-5-2-1	0.0-3.0-7.0-9.0-4.0-6.0-8.0-5.0-2.0-4.1-9.1-7.1-2.1-5.0-2.0-4.1-9.1-7.1-2.1-5.0-2.0-1.0	100	224867	226178
AV_HG00673#haplotype1#0000019:16627360-17129375	AV_HG00673	226222	228262	7	12	1	11	0	2040	223882	221842	0-3-7-9-4-6-8-5-2-4-9-7-2-5-2-4-9-7-2-5-2-1	0.0-3.0-7.0-9.0-4.0-6.0-8.0-5.0-2.0-4.1-9.1-7.1-2.1-5.0-2.0-4.1-9.1-7.1-2.1-5.0-2.0-1.0	100	226122	228162
AV_HG00673#haplotype1#0000019:16627360-17129375	AV_HG00673	229724	257258	2	196	1	194	39	27534	251416	223882	0-3-7-9-4-6-8-5-2-4-9-7-2-5-2-4-9-7-2-5-2-1	0.0-3.0-7.0-9.0-4.0-6.0-8.0-5.0-2.0-4.1-9.1-7.1-2.1-5.0-2.0-4.1-9.1-7.1-2.1-5.0-2.0-1.0	100	229624	257158
AV_HG00673#haplotype1#0000019:16627360-17129375	AV_HG00673	258224	270352	5	79	0	5	78	12128	263544	251416	0-3-7-9-4-6-8-5-2-4-9-7-2-5-2-4-9-7-2-5-2-1	0.0-3.0-7.0-9.0-4.0-6.0-8.0-5.0-2.0-4.1-9.1-7.1-2.1-5.0-2.0-4.1-9.1-7.1-2.1-5.0-2.0-1.0	100	258124	270252
AV_HG00673#haplotype1#0000019:16627360-17129375	AV_HG00673	270296	303916	2	196	0	0	191	33620	297164	263544	0-3-7-9-4-6-8-5-2-4-9-7-2-5-2-4-9-7-2-5-2-1	0.0-3.0-7.0-9.0-4.0-6.0-8.0-5.0-2.0-4.1-9.1-7.1-2.1-5.0-2.0-4.1-9.1-7.1-2.1-5.0-2.0-1.0	100	270196	303816
AV_HG00673#haplotype1#0000019:16627360-17129375	AV_HG00673	306508	318054	4	84	1	58	4	11546	308710	297164	0-3-7-9-4-6-8-5-2-4-9-7-2-5-2-4-9-7-2-5-2-1	0.0-3.0-7.0-9.0-4.0-6.0-8.0-5.0-2.0-4.1-9.1-7.1-2.1-5.0-2.0-4.1-9.1-7.1-2.1-5.0-2.0-1.0	100	306408	317954
AV_HG00673#haplotype1#0000019:16627360-17129375	AV_HG00673	319121	320432	9	5	1	4	0	1311	310021	308710	0-3-7-9-4-6-8-5-2-4-9-7-2-5-2-4-9-7-2-5-2-1	0.0-3.0-7.0-9.0-4.0-6.0-8.0-5.0-2.0-4.1-9.1-7.1-2.1-5.0-2.0-4.1-9.1-7.1-2.1-5.0-2.0-1.0	100	319021	320332
AV_HG00673#haplotype1#0000019:16627360-17129375	AV_HG00673	320376	322416	7	12	1	11	0	2040	312061	310021	0-3-7-9-4-6-8-5-2-4-9-7-2-5-2-4-9-7-2-5-2-1	0.0-3.0-7.0-9.0-4.0-6.0-8.0-5.0-2.0-4.1-9.1-7.1-2.1-5.0-2.0-4.1-9.1-7.1-2.1-5.0-2.0-1.0	100	320276	322316
AV_HG00673#haplotype1#0000019:16627360-17129375	AV_HG00673	323878	351404	2	196	1	194	39	27526	339587	312061	0-3-7-9-4-6-8-5-2-4-9-7-2-5-2-4-9-7-2-5-2-1	0.0-3.0-7.0-9.0-4.0-6.0-8.0-5.0-2.0-4.1-9.1-7.1-2.1-5.0-2.0-4.1-9.1-7.1-2.1-5.0-2.0-1.0	100	323778	351304
AV_HG00673#haplotype1#0000019:16627360-17129375	AV_HG00673	352370	364498	5	79	0	5	78	12128	351715	339587	0-3-7-9-4-6-8-5-2-4-9-7-2-5-2-4-9-7-2-5-2-1	0.0-3.0-7.0-9.0-4.0-6.0-8.0-5.0-2.0-4.1-9.1-7.1-2.1-5.0-2.0-4.1-9.1-7.1-2.1-5.0-2.0-1.0	100	352270	364398
AV_HG00673#haplotype1#0000019:16627360-17129375	AV_HG00673	364442	398781	2	196	0	0	195	34339	386054	351715	0-3-7-9-4-6-8-5-2-4-9-7-2-5-2-4-9-7-2-5-2-1	0.0-3.0-7.0-9.0-4.0-6.0-8.0-5.0-2.0-4.1-9.1-7.1-2.1-5.0-2.0-4.1-9.1-7.1-2.1-5.0-2.0-1.0	100	364342	398681
AV_HG00673#haplotype1#0000019:16627360-17129375	AV_HG00673	398725	501943	1	612	0	0	611	103218	489272	386054	0-3-7-9-4-6-8-5-2-4-9-7-2-5-2-4-9-7-2-5-2-1	0.0-3.0-7.0-9.0-4.0-6.0-8.0-5.0-2.0-4.1-9.1-7.1-2.1-5.0-2.0-4.1-9.1-7.1-2.1-5.0-2.0-1.0	100	398625	501843
AV_HG00673#haplotype2#0001165:24014011-24421797	AV_HG00673	99	115506	0	672	0	0	671	115407	115407	0	0-3-7-4-6-8-5-2-7-4-2-5-2-1	0.0-3.0-7.0-4.0-6.0-8.0-5.0-2.0-7.0-4.0-2.1-5.1-2.0-1.0	99	0	115407
AV_HG00673#haplotype2#0001165:24014011-24421797	AV_HG00673	115597	138429	3	132	0	0	131	22832	138239	115407	0-3-7-4-6-8-5-2-7-4-2-5-2-1	0.0-3.0-7.0-4.0-6.0-8.0-5.0-2.0-7.0-4.0-2.1-5.1-2.0-1.0	99	115498	138330
AV_HG00673#haplotype2#0001165:24014011-24421797	AV_HG00673	139188	141228	7	12	0	0	11	2040	140279	138239	0-3-7-4-6-8-5-2-7-4-2-5-2-1	0.0-3.0-7.0-4.0-6.0-8.0-5.0-2.0-7.0-4.0-2.1-5.1-2.0-1.0	99	139089	141129
AV_HG00673#haplotype2#0001165:24014011-24421797	AV_HG00673	143274	158722	4	84	0	1	83	15448	155727	140279	0-3-7-4-6-8-5-2-7-4-2-5-2-1	0.0-3.0-7.0-4.0-6.0-8.0-5.0-2.0-7.0-4.0-2.1-5.1-2.0-1.0	99	143175	158623
AV_HG00673#haplotype2#0001165:24014011-24421797	AV_HG00673	158666	161481	6	12	0	0	11	2815	158542	155727	0-3-7-4-6-8-5-2-7-4-2-5-2-1	0.0-3.0-7.0-4.0-6.0-8.0-5.0-2.0-7.0-4.0-2.1-5.1-2.0-1.0	99	158567	161382
AV_HG00673#haplotype2#0001165:24014011-24421797	AV_HG00673	161425	163195	8	8	0	0	7	1770	160312	158542	0-3-7-4-6-8-5-2-7-4-2-5-2-1	0.0-3.0-7.0-4.0-6.0-8.0-5.0-2.0-7.0-4.0-2.1-5.1-2.0-1.0	99	161326	163096
AV_HG00673#haplotype2#0001165:24014011-24421797	AV_HG00673	163139	176243	5	79	0	0	78	13104	173416	160312	0-3-7-4-6-8-5-2-7-4-2-5-2-1	0.0-3.0-7.0-4.0-6.0-8.0-5.0-2.0-7.0-4.0-2.1-5.1-2.0-1.0	99	163040	176144
AV_HG00673#haplotype2#0001165:24014011-24421797	AV_HG00673	176187	210503	2	196	0	0	195	34316	207732	173416	0-3-7-4-6-8-5-2-7-4-2-5-2-1	0.0-3.0-7.0-4.0-6.0-8.0-5.0-2.0-7.0-4.0-2.1-5.1-2.0-1.0	99	176088	210404
AV_HG00673#haplotype2#0001165:24014011-24421797	AV_HG00673	211580	213620	7	12	0	0	11	2040	209772	207732	0-3-7-4-6-8-5-2-7-4-2-5-2-1	0.0-3.0-7.0-4.0-6.0-8.0-5.0-2.0-7.0-4.0-2.1-5.1-2.0-1.0	99	211481	213521
AV_HG00673#haplotype2#0001165:24014011-24421797	AV_HG00673	215938	227482	4	84	0	4	58	11544	221316	209772	0-3-7-4-6-8-5-2-7-4-2-5-2-1	0.0-3.0-7.0-4.0-6.0-8.0-5.0-2.0-7.0-4.0-2.1-5.1-2.0-1.0	99	215839	227383
AV_HG00673#haplotype2#0001165:24014011-24421797	AV_HG00673	229348	263666	2	196	1	195	0	34318	255634	221316	0-3-7-4-6-8-5-2-7-4-2-5-2-1	0.0-3.0-7.0-4.0-6.0-8.0-5.0-2.0-7.0-4.0-2.1-5.1-2.0-1.0	99	229249	263567
AV_HG00673#haplotype2#0001165:24014011-24421797	AV_HG00673	263610	276265	5	79	1	78	3	12655	268289	255634	0-3-7-4-6-8-5-2-7-4-2-5-2-1	0.0-3.0-7.0-4.0-6.0-8.0-5.0-2.0-7.0-4.0-2.1-5.1-2.0-1.0	99	263511	276166
AV_HG00673#haplotype2#0001165:24014011-24421797	AV_HG00673	276704	304609	2	196	0	39	195	27905	296194	268289	0-3-7-4-6-8-5-2-7-4-2-5-2-1	0.0-3.0-7.0-4.0-6.0-8.0-5.0-2.0-7.0-4.0-2.1-5.1-2.0-1.0	99	276605	304510
AV_HG00673#haplotype2#0001165:24014011-24421797	AV_HG00673	304553	407714	1	612	0	0	611	103161	399355	296194	0-3-7-4-6-8-5-2-7-4-2-5-2-1	0.0-3.0-7.0-4.0-6.0-8.0-5.0-2.0-7.0-4.0-2.1-5.1-2.0-1.0	99	304454	407615
AV_HG01106#haplotype1#0000048:16666181-17262214	AV_HG01106	100	115440	0	672	0	0	671	115340	115340	0	0-3-7-9-4-6-8-5-2-4-9-7-2-5-2-4-9-7-2-5-2-4-9-7-2-5-2-1	0.0-3.0-7.0-9.0-4.0-6.0-8.0-5.0-2.0-4.1-9.1-7.1-2.1-5.1-2.0-4.1-9.1-7.1-2.1-5.0-2.0-4.1-9.1-7.1-2.1-5.0-2.0-1.0	100	0	115340
AV_HG01106#haplotype1#0000048:16666181-17262214	AV_HG01106	115531	138368	3	132	0	0	131	22837	138177	115340	0-3-7-9-4-6-8-5-2-4-9-7-2-5-2-4-9-7-2-5-2-4-9-7-2-5-2-1	0.0-3.0-7.0-9.0-4.0-6.0-8.0-5.0-2.0-4.1-9.1-7.1-2.1-5.1-2.0-4.1-9.1-7.1-2.1-5.0-2.0-4.1-9.1-7.1-2.1-5.0-2.0-1.0	100	115431	138268
AV_HG01106#haplotype1#0000048:16666181-17262214	AV_HG01106	139127	141167	7	12	0	0	11	2040	140217	138177	0-3-7-9-4-6-8-5-2-4-9-7-2-5-2-4-9-7-2-5-2-4-9-7-2-5-2-1	0.0-3.0-7.0-9.0-4.0-6.0-8.0-5.0-2.0-4.1-9.1-7.1-2.1-5.1-2.0-4.1-9.1-7.1-2.1-5.0-2.0-4.1-9.1-7.1-2.1-5.0-2.0-1.0	100	139027	141067
AV_HG01106#haplotype1#0000048:16666181-17262214	AV_HG01106	141111	142423	9	5	0	0	4	1312	141529	140217	0-3-7-9-4-6-8-5-2-4-9-7-2-5-2-4-9-7-2-5-2-4-9-7-2-5-2-1	0.0-3.0-7.0-9.0-4.0-6.0-8.0-5.0-2.0-4.1-9.1-7.1-2.1-5.1-2.0-4.1-9.1-7.1-2.1-5.0-2.0-4.1-9.1-7.1-2.1-5.0-2.0-1.0	100	141011	142323
AV_HG01106#haplotype1#0000048:16666181-17262214	AV_HG01106	143217	158669	4	84	0	1	83	15452	156981	141529	0-3-7-9-4-6-8-5-2-4-9-7-2-5-2-4-9-7-2-5-2-4-9-7-2-5-2-1	0.0-3.0-7.0-9.0-4.0-6.0-8.0-5.0-2.0-4.1-9.1-7.1-2.1-5.1-2.0-4.1-9.1-7.1-2.1-5.0-2.0-4.1-9.1-7.1-2.1-5.0-2.0-1.0	100	143117	158569
AV_HG01106#haplotype1#0000048:16666181-17262214	AV_HG01106	158613	161429	6	12	0	0	11	2816	159797	156981	0-3-7-9-4-6-8-5-2-4-9-7-2-5-2-4-9-7-2-5-2-4-9-7-2-5-2-1	0.0-3.0-7.0-9.0-4.0-6.0-8.0-5.0-2.0-4.1-9.1-7.1-2.1-5.1-2.0-4.1-9.1-7.1-2.1-5.0-2.0-4.1-9.1-7.1-2.1-5.0-2.0-1.0	100	158513	161329
AV_HG01106#haplotype1#0000048:16666181-17262214	AV_HG01106	161373	163143	8	8	0	0	7	1770	161567	159797	0-3-7-9-4-6-8-5-2-4-9-7-2-5-2-4-9-7-2-5-2-4-9-7-2-5-2-1	0.0-3.0-7.0-9.0-4.0-6.0-8.0-5.0-2.0-4.1-9.1-7.1-2.1-5.1-2.0-4.1-9.1-7.1-2.1-5.0-2.0-4.1-9.1-7.1-2.1-5.0-2.0-1.0	100	161273	163043
AV_HG01106#haplotype1#0000048:16666181-17262214	AV_HG01106	163087	176191	5	79	0	0	78	13104	174671	161567	0-3-7-9-4-6-8-5-2-4-9-7-2-5-2-4-9-7-2-5-2-4-9-7-2-5-2-1	0.0-3.0-7.0-9.0-4.0-6.0-8.0-5.0-2.0-4.1-9.1-7.1-2.1-5.1-2.0-4.1-9.1-7.1-2.1-5.0-2.0-4.1-9.1-7.1-2.1-5.0-2.0-1.0	100	162987	176091
AV_HG01106#haplotype1#0000048:16666181-17262214	AV_HG01106	176135	210069	2	196	0	0	194	33934	208605	174671	0-3-7-9-4-6-8-5-2-4-9-7-2-5-2-4-9-7-2-5-2-4-9-7-2-5-2-1	0.0-3.0-7.0-9.0-4.0-6.0-8.0-5.0-2.0-4.1-9.1-7.1-2.1-5.1-2.0-4.1-9.1-7.1-2.1-5.0-2.0-4.1-9.1-7.1-2.1-5.0-2.0-1.0	100	176035	209969
AV_HG01106#haplotype1#0000048:16666181-17262214	AV_HG01106	212320	224133	4	84	1	58	1	11813	220418	208605	0-3-7-9-4-6-8-5-2-4-9-7-2-5-2-4-9-7-2-5-2-4-9-7-2-5-2-1	0.0-3.0-7.0-9.0-4.0-6.0-8.0-5.0-2.0-4.1-9.1-7.1-2.1-5.1-2.0-4.1-9.1-7.1-2.1-5.0-2.0-4.1-9.1-7.1-2.1-5.0-2.0-1.0	100	212220	224033
AV_HG01106#haplotype1#0000048:16666181-17262214	AV_HG01106	224927	226239	9	5	1	4	0	1312	221730	220418	0-3-7-9-4-6-8-5-2-4-9-7-2-5-2-4-9-7-2-5-2-4-9-7-2-5-2-1	0.0-3.0-7.0-9.0-4.0-6.0-8.0-5.0-2.0-4.1-9.1-7.1-2.1-5.1-2.0-4.1-9.1-7.1-2.1-5.0-2.0-4.1-9.1-7.1-2.1-5.0-2.0-1.0	100	224827	226139
AV_HG01106#haplotype1#0000048:16666181-17262214	AV_HG01106	226183	228223	7	12	1	11	0	2040	223770	221730	0-3-7-9-4-6-8-5-2-4-9-7-2-5-2-4-9-7-2-5-2-4-9-7-2-5-2-1	0.0-3.0-7.0-9.0-4.0-6.0-8.0-5.0-2.0-4.1-9.1-7.1-2.1-5.1-2.0-4.1-9.1-7.1-2.1-5.0-2.0-4.1-9.1-7.1-2.1-5.0-2.0-1.0	100	226083	228123
AV_HG01106#haplotype1#0000048:16666181-17262214	AV_HG01106	229685	263623	2	196	1	194	0	33938	257708	223770	0-3-7-9-4-6-8-5-2-4-9-7-2-5-2-4-9-7-2-5-2-4-9-7-2-5-2-1	0.0-3.0-7.0-9.0-4.0-6.0-8.0-5.0-2.0-4.1-9.1-7.1-2.1-5.1-2.0-4.1-9.1-7.1-2.1-5.0-2.0-4.1-9.1-7.1-2.1-5.0-2.0-1.0	100	229585	263523
AV_HG01106#haplotype1#0000048:16666181-17262214	AV_HG01106	263567	275695	5	79	1	78	5	12128	269836	257708	0-3-7-9-4-6-8-5-2-4-9-7-2-5-2-4-9-7-2-5-2-4-9-7-2-5-2-1	0.0-3.0-7.0-9.0-4.0-6.0-8.0-5.0-2.0-4.1-9.1-7.1-2.1-5.1-2.0-4.1-9.1-7.1-2.1-5.0-2.0-4.1-9.1-7.1-2.1-5.0-2.0-1.0	100	263467	275595
AV_HG01106#haplotype1#0000048:16666181-17262214	AV_HG01106	276661	303850	2	196	0	39	191	27189	297025	269836	0-3-7-9-4-6-8-5-2-4-9-7-2-5-2-4-9-7-2-5-2-4-9-7-2-5-2-1	0.0-3.0-7.0-9.0-4.0-6.0-8.0-5.0-2.0-4.1-9.1-7.1-2.1-5.1-2.0-4.1-9.1-7.1-2.1-5.0-2.0-4.1-9.1-7.1-2.1-5.0-2.0-1.0	100	276561	303750
AV_HG01106#haplotype1#0000048:16666181-17262214	AV_HG01106	306442	317989	4	84	1	58	4	11547	308572	297025	0-3-7-9-4-6-8-5-2-4-9-7-2-5-2-4-9-7-2-5-2-4-9-7-2-5-2-1	0.0-3.0-7.0-9.0-4.0-6.0-8.0-5.0-2.0-4.1-9.1-7.1-2.1-5.1-2.0-4.1-9.1-7.1-2.1-5.0-2.0-4.1-9.1-7.1-2.1-5.0-2.0-1.0	100	306342	317889
AV_HG01106#haplotype1#0000048:16666181-17262214	AV_HG01106	319056	320367	9	5	1	4	0	1311	309883	308572	0-3-7-9-4-6-8-5-2-4-9-7-2-5-2-4-9-7-2-5-2-4-9-7-2-5-2-1	0.0-3.0-7.0-9.0-4.0-6.0-8.0-5.0-2.0-4.1-9.1-7.1-2.1-5.1-2.0-4.1-9.1-7.1-2.1-5.0-2.0-4.1-9.1-7.1-2.1-5.0-2.0-1.0	100	318956	320267
AV_HG01106#haplotype1#0000048:16666181-17262214	AV_HG01106	320311	322351	7	12	1	11	0	2040	311923	309883	0-3-7-9-4-6-8-5-2-4-9-7-2-5-2-4-9-7-2-5-2-4-9-7-2-5-2-1	0.0-3.0-7.0-9.0-4.0-6.0-8.0-5.0-2.0-4.1-9.1-7.1-2.1-5.1-2.0-4.1-9.1-7.1-2.1-5.0-2.0-4.1-9.1-7.1-2.1-5.0-2.0-1.0	100	320211	322251
AV_HG01106#haplotype1#0000048:16666181-17262214	AV_HG01106	323813	351337	2	196	1	194	39	27524	339447	311923	0-3-7-9-4-6-8-5-2-4-9-7-2-5-2-4-9-7-2-5-2-4-9-7-2-5-2-1	0.0-3.0-7.0-9.0-4.0-6.0-8.0-5.0-2.0-4.1-9.1-7.1-2.1-5.1-2.0-4.1-9.1-7.1-2.1-5.0-2.0-4.1-9.1-7.1-2.1-5.0-2.0-1.0	100	323713	351237
AV_HG01106#haplotype1#0000048:16666181-17262214	AV_HG01106	352784	363991	5	79	0	8	77	11207	350654	339447	0-3-7-9-4-6-8-5-2-4-9-7-2-5-2-4-9-7-2-5-2-4-9-7-2-5-2-1	0.0-3.0-7.0-9.0-4.0-6.0-8.0-5.0-2.0-4.1-9.1-7.1-2.1-5.1-2.0-4.1-9.1-7.1-2.1-5.0-2.0-4.1-9.1-7.1-2.1-5.0-2.0-1.0	100	352684	363891
AV_HG01106#haplotype1#0000048:16666181-17262214	AV_HG01106	364598	397972	2	196	0	1	191	33374	384028	350654	0-3-7-9-4-6-8-5-2-4-9-7-2-5-2-4-9-7-2-5-2-4-9-7-2-5-2-1	0.0-3.0-7.0-9.0-4.0-6.0-8.0-5.0-2.0-4.1-9.1-7.1-2.1-5.1-2.0-4.1-9.1-7.1-2.1-5.0-2.0-4.1-9.1-7.1-2.1-5.0-2.0-1.0	100	364498	397872
AV_HG01106#haplotype1#0000048:16666181-17262214	AV_HG01106	400564	412110	4	84	1	58	4	11546	395574	384028	0-3-7-9-4-6-8-5-2-4-9-7-2-5-2-4-9-7-2-5-2-4-9-7-2-5-2-1	0.0-3.0-7.0-9.0-4.0-6.0-8.0-5.0-2.0-4.1-9.1-7.1-2.1-5.1-2.0-4.1-9.1-7.1-2.1-5.0-2.0-4.1-9.1-7.1-2.1-5.0-2.0-1.0	100	400464	412010
AV_HG01106#haplotype1#0000048:16666181-17262214	AV_HG01106	413179	414490	9	5	1	4	0	1311	396885	395574	0-3-7-9-4-6-8-5-2-4-9-7-2-5-2-4-9-7-2-5-2-4-9-7-2-5-2-1	0.0-3.0-7.0-9.0-4.0-6.0-8.0-5.0-2.0-4.1-9.1-7.1-2.1-5.1-2.0-4.1-9.1-7.1-2.1-5.0-2.0-4.1-9.1-7.1-2.1-5.0-2.0-1.0	100	413079	414390
AV_HG01106#haplotype1#0000048:16666181-17262214	AV_HG01106	414434	416474	7	12	1	11	0	2040	398925	396885	0-3-7-9-4-6-8-5-2-4-9-7-2-5-2-4-9-7-2-5-2-4-9-7-2-5-2-1	0.0-3.0-7.0-9.0-4.0-6.0-8.0-5.0-2.0-4.1-9.1-7.1-2.1-5.1-2.0-4.1-9.1-7.1-2.1-5.0-2.0-4.1-9.1-7.1-2.1-5.0-2.0-1.0	100	414334	416374
AV_HG01106#haplotype1#0000048:16666181-17262214	AV_HG01106	417936	445462	2	196	1	194	39	27526	426451	398925	0-3-7-9-4-6-8-5-2-4-9-7-2-5-2-4-9-7-2-5-2-4-9-7-2-5-2-1	0.0-3.0-7.0-9.0-4.0-6.0-8.0-5.0-2.0-4.1-9.1-7.1-2.1-5.1-2.0-4.1-9.1-7.1-2.1-5.0-2.0-4.1-9.1-7.1-2.1-5.0-2.0-1.0	100	417836	445362
AV_HG01106#haplotype1#0000048:16666181-17262214	AV_HG01106	446909	458116	5	79	0	8	77	11207	437658	426451	0-3-7-9-4-6-8-5-2-4-9-7-2-5-2-4-9-7-2-5-2-4-9-7-2-5-2-1	0.0-3.0-7.0-9.0-4.0-6.0-8.0-5.0-2.0-4.1-9.1-7.1-2.1-5.1-2.0-4.1-9.1-7.1-2.1-5.0-2.0-4.1-9.1-7.1-2.1-5.0-2.0-1.0	100	446809	458016
AV_HG01106#haplotype1#0000048:16666181-17262214	AV_HG01106	458723	492828	2	196	0	1	195	34105	471763	437658	0-3-7-9-4-6-8-5-2-4-9-7-2-5-2-4-9-7-2-5-2-4-9-7-2-5-2-1	0.0-3.0-7.0-9.0-4.0-6.0-8.0-5.0-2.0-4.1-9.1-7.1-2.1-5.1-2.0-4.1-9.1-7.1-2.1-5.0-2.0-4.1-9.1-7.1-2.1-5.0-2.0-1.0	100	458623	492728
AV_HG01106#haplotype1#0000048:16666181-17262214	AV_HG01106	492772	595763	1	612	0	0	610	102991	574754	471763	0-3-7-9-4-6-8-5-2-4-9-7-2-5-2-4-9-7-2-5-2-4-9-7-2-5-2-1	0.0-3.0-7.0-9.0-4.0-6.0-8.0-5.0-2.0-4.1-9.1-7.1-2.1-5.1-2.0-4.1-9.1-7.1-2.1-5.0-2.0-4.1-9.1-7.1-2.1-5.0-2.0-1.0	100	492672	595663
AV_HG01106#haplotype2#0000932:16673968-17175925	AV_HG01106	100	115459	0	672	0	0	671	115359	115359	0	0-3-7-9-4-6-8-5-2-7-9-4-2-5-2-4-9-7-2-5-2-1	0.0-3.0-7.0-9.0-4.0-6.0-8.0-5.0-2.0-7.0-9.0-4.0-2.1-5.1-2.0-4.1-9.1-7.1-2.1-5.0-2.0-1.0	100	0	115359
AV_HG01106#haplotype2#0000932:16673968-17175925	AV_HG01106	115550	138384	3	132	0	0	131	22834	138193	115359	0-3-7-9-4-6-8-5-2-7-9-4-2-5-2-4-9-7-2-5-2-1	0.0-3.0-7.0-9.0-4.0-6.0-8.0-5.0-2.0-7.0-9.0-4.0-2.1-5.1-2.0-4.1-9.1-7.1-2.1-5.0-2.0-1.0	100	115450	138284
AV_HG01106#haplotype2#0000932:16673968-17175925	AV_HG01106	139143	141183	7	12	0	0	11	2040	140233	138193	0-3-7-9-4-6-8-5-2-7-9-4-2-5-2-4-9-7-2-5-2-1	0.0-3.0-7.0-9.0-4.0-6.0-8.0-5.0-2.0-7.0-9.0-4.0-2.1-5.1-2.0-4.1-9.1-7.1-2.1-5.0-2.0-1.0	100	139043	141083
AV_HG01106#haplotype2#0000932:16673968-17175925	AV_HG01106	141127	142439	9	5	0	0	4	1312	141545	140233	0-3-7-9-4-6-8-5-2-7-9-4-2-5-2-4-9-7-2-5-2-1	0.0-3.0-7.0-9.0-4.0-6.0-8.0-5.0-2.0-7.0-9.0-4.0-2.1-5.1-2.0-4.1-9.1-7.1-2.1-5.0-2.0-1.0	100	141027	142339
AV_HG01106#haplotype2#0000932:16673968-17175925	AV_HG01106	142887	158682	4	84	0	0	83	15795	157340	141545	0-3-7-9-4-6-8-5-2-7-9-4-2-5-2-4-9-7-2-5-2-1	0.0-3.0-7.0-9.0-4.0-6.0-8.0-5.0-2.0-7.0-9.0-4.0-2.1-5.1-2.0-4.1-9.1-7.1-2.1-5.0-2.0-1.0	100	142787	158582
AV_HG01106#haplotype2#0000932:16673968-17175925	AV_HG01106	158626	161442	6	12	0	0	11	2816	160156	157340	0-3-7-9-4-6-8-5-2-7-9-4-2-5-2-4-9-7-2-5-2-1	0.0-3.0-7.0-9.0-4.0-6.0-8.0-5.0-2.0-7.0-9.0-4.0-2.1-5.1-2.0-4.1-9.1-7.1-2.1-5.0-2.0-1.0	100	158526	161342
AV_HG01106#haplotype2#0000932:16673968-17175925	AV_HG01106	161386	163156	8	8	0	0	7	1770	161926	160156	0-3-7-9-4-6-8-5-2-7-9-4-2-5-2-4-9-7-2-5-2-1	0.0-3.0-7.0-9.0-4.0-6.0-8.0-5.0-2.0-7.0-9.0-4.0-2.1-5.1-2.0-4.1-9.1-7.1-2.1-5.0-2.0-1.0	100	161286	163056
AV_HG01106#haplotype2#0000932:16673968-17175925	AV_HG01106	163100	176204	5	79	0	0	78	13104	175030	161926	0-3-7-9-4-6-8-5-2-7-9-4-2-5-2-4-9-7-2-5-2-1	0.0-3.0-7.0-9.0-4.0-6.0-8.0-5.0-2.0-7.0-9.0-4.0-2.1-5.1-2.0-4.1-9.1-7.1-2.1-5.0-2.0-1.0	100	163000	176104
AV_HG01106#haplotype2#0000932:16673968-17175925	AV_HG01106	176148	210091	2	196	0	0	194	33943	208973	175030	0-3-7-9-4-6-8-5-2-7-9-4-2-5-2-4-9-7-2-5-2-1	0.0-3.0-7.0-9.0-4.0-6.0-8.0-5.0-2.0-7.0-9.0-4.0-2.1-5.1-2.0-4.1-9.1-7.1-2.1-5.0-2.0-1.0	100	176048	209991
AV_HG01106#haplotype2#0000932:16673968-17175925	AV_HG01106	211553	213593	7	12	0	0	11	2040	211013	208973	0-3-7-9-4-6-8-5-2-7-9-4-2-5-2-4-9-7-2-5-2-1	0.0-3.0-7.0-9.0-4.0-6.0-8.0-5.0-2.0-7.0-9.0-4.0-2.1-5.1-2.0-4.1-9.1-7.1-2.1-5.0-2.0-1.0	100	211453	213493
AV_HG01106#haplotype2#0000932:16673968-17175925	AV_HG01106	213537	214848	9	5	0	0	4	1311	212324	211013	0-3-7-9-4-6-8-5-2-7-9-4-2-5-2-4-9-7-2-5-2-1	0.0-3.0-7.0-9.0-4.0-6.0-8.0-5.0-2.0-7.0-9.0-4.0-2.1-5.1-2.0-4.1-9.1-7.1-2.1-5.0-2.0-1.0	100	213437	214748
AV_HG01106#haplotype2#0000932:16673968-17175925	AV_HG01106	215913	227460	4	84	0	4	58	11547	223871	212324	0-3-7-9-4-6-8-5-2-7-9-4-2-5-2-4-9-7-2-5-2-1	0.0-3.0-7.0-9.0-4.0-6.0-8.0-5.0-2.0-7.0-9.0-4.0-2.1-5.1-2.0-4.1-9.1-7.1-2.1-5.0-2.0-1.0	100	215813	227360
AV_HG01106#haplotype2#0000932:16673968-17175925	AV_HG01106	229711	263652	2	196	1	194	0	33941	257812	223871	0-3-7-9-4-6-8-5-2-7-9-4-2-5-2-4-9-7-2-5-2-1	0.0-3.0-7.0-9.0-4.0-6.0-8.0-5.0-2.0-7.0-9.0-4.0-2.1-5.1-2.0-4.1-9.1-7.1-2.1-5.0-2.0-1.0	100	229611	263552
AV_HG01106#haplotype2#0000932:16673968-17175925	AV_HG01106	263596	275724	5	79	1	78	5	12128	269940	257812	0-3-7-9-4-6-8-5-2-7-9-4-2-5-2-4-9-7-2-5-2-1	0.0-3.0-7.0-9.0-4.0-6.0-8.0-5.0-2.0-7.0-9.0-4.0-2.1-5.1-2.0-4.1-9.1-7.1-2.1-5.0-2.0-1.0	100	263496	275624
AV_HG01106#haplotype2#0000932:16673968-17175925	AV_HG01106	276690	303873	2	196	0	39	191	27183	297123	269940	0-3-7-9-4-6-8-5-2-7-9-4-2-5-2-4-9-7-2-5-2-1	0.0-3.0-7.0-9.0-4.0-6.0-8.0-5.0-2.0-7.0-9.0-4.0-2.1-5.1-2.0-4.1-9.1-7.1-2.1-5.0-2.0-1.0	100	276590	303773
AV_HG01106#haplotype2#0000932:16673968-17175925	AV_HG01106	306465	318011	4	84	1	58	4	11546	308669	297123	0-3-7-9-4-6-8-5-2-7-9-4-2-5-2-4-9-7-2-5-2-1	0.0-3.0-7.0-9.0-4.0-6.0-8.0-5.0-2.0-7.0-9.0-4.0-2.1-5.1-2.0-4.1-9.1-7.1-2.1-5.0-2.0-1.0	100	306365	317911
AV_HG01106#haplotype2#0000932:16673968-17175925	AV_HG01106	319076	320387	9	5	1	4	0	1311	309980	308669	0-3-7-9-4-6-8-5-2-7-9-4-2-5-2-4-9-7-2-5-2-1	0.0-3.0-7.0-9.0-4.0-6.0-8.0-5.0-2.0-7.0-9.0-4.0-2.1-5.1-2.0-4.1-9.1-7.1-2.1-5.0-2.0-1.0	100	318976	320287
AV_HG01106#haplotype2#0000932:16673968-17175925	AV_HG01106	320331	322371	7	12	1	11	0	2040	312020	309980	0-3-7-9-4-6-8-5-2-7-9-4-2-5-2-4-9-7-2-5-2-1	0.0-3.0-7.0-9.0-4.0-6.0-8.0-5.0-2.0-7.0-9.0-4.0-2.1-5.1-2.0-4.1-9.1-7.1-2.1-5.0-2.0-1.0	100	320231	322271
AV_HG01106#haplotype2#0000932:16673968-17175925	AV_HG01106	323833	351356	2	196	1	194	39	27523	339543	312020	0-3-7-9-4-6-8-5-2-7-9-4-2-5-2-4-9-7-2-5-2-1	0.0-3.0-7.0-9.0-4.0-6.0-8.0-5.0-2.0-7.0-9.0-4.0-2.1-5.1-2.0-4.1-9.1-7.1-2.1-5.0-2.0-1.0	100	323733	351256
AV_HG01106#haplotype2#0000932:16673968-17175925	AV_HG01106	352322	364010	5	79	0	5	77	11688	351231	339543	0-3-7-9-4-6-8-5-2-7-9-4-2-5-2-4-9-7-2-5-2-1	0.0-3.0-7.0-9.0-4.0-6.0-8.0-5.0-2.0-7.0-9.0-4.0-2.1-5.1-2.0-4.1-9.1-7.1-2.1-5.0-2.0-1.0	100	352222	363910
AV_HG01106#haplotype2#0000932:16673968-17175925	AV_HG01106	364617	398716	2	196	0	1	195	34099	385330	351231	0-3-7-9-4-6-8-5-2-7-9-4-2-5-2-4-9-7-2-5-2-1	0.0-3.0-7.0-9.0-4.0-6.0-8.0-5.0-2.0-7.0-9.0-4.0-2.1-5.1-2.0-4.1-9.1-7.1-2.1-5.0-2.0-1.0	100	364517	398616
AV_HG01106#haplotype2#0000932:16673968-17175925	AV_HG01106	398660	501885	1	612	0	0	611	103225	488555	385330	0-3-7-9-4-6-8-5-2-7-9-4-2-5-2-4-9-7-2-5-2-1	0.0-3.0-7.0-9.0-4.0-6.0-8.0-5.0-2.0-7.0-9.0-4.0-2.1-5.1-2.0-4.1-9.1-7.1-2.1-5.0-2.0-1.0	100	398560	501785
AV_HG01175#haplotype1#0000070:46006269-46414083	AV_HG01175	100	115427	0	672	0	0	671	115327	115327	0	0-3-7-9-4-6-8-5-2-4-9-7-2-5-2-1	0.0-3.0-7.0-9.0-4.0-6.0-8.0-5.0-2.0-4.1-9.1-7.1-2.1-5.0-2.0-1.0	100	0	115327
AV_HG01175#haplotype1#0000070:46006269-46414083	AV_HG01175	115518	138355	3	132	0	0	131	22837	138164	115327	0-3-7-9-4-6-8-5-2-4-9-7-2-5-2-1	0.0-3.0-7.0-9.0-4.0-6.0-8.0-5.0-2.0-4.1-9.1-7.1-2.1-5.0-2.0-1.0	100	115418	138255
AV_HG01175#haplotype1#0000070:46006269-46414083	AV_HG01175	139114	141154	7	12	0	0	11	2040	140204	138164	0-3-7-9-4-6-8-5-2-4-9-7-2-5-2-1	0.0-3.0-7.0-9.0-4.0-6.0-8.0-5.0-2.0-4.1-9.1-7.1-2.1-5.0-2.0-1.0	100	139014	141054
AV_HG01175#haplotype1#0000070:46006269-46414083	AV_HG01175	141098	142410	9	5	0	0	4	1312	141516	140204	0-3-7-9-4-6-8-5-2-4-9-7-2-5-2-1	0.0-3.0-7.0-9.0-4.0-6.0-8.0-5.0-2.0-4.1-9.1-7.1-2.1-5.0-2.0-1.0	100	140998	142310
AV_HG01175#haplotype1#0000070:46006269-46414083	AV_HG01175	142858	158654	4	84	0	0	83	15796	157312	141516	0-3-7-9-4-6-8-5-2-4-9-7-2-5-2-1	0.0-3.0-7.0-9.0-4.0-6.0-8.0-5.0-2.0-4.1-9.1-7.1-2.1-5.0-2.0-1.0	100	142758	158554
AV_HG01175#haplotype1#0000070:46006269-46414083	AV_HG01175	158598	161414	6	12	0	0	11	2816	160128	157312	0-3-7-9-4-6-8-5-2-4-9-7-2-5-2-1	0.0-3.0-7.0-9.0-4.0-6.0-8.0-5.0-2.0-4.1-9.1-7.1-2.1-5.0-2.0-1.0	100	158498	161314
AV_HG01175#haplotype1#0000070:46006269-46414083	AV_HG01175	161358	163128	8	8	0	0	7	1770	161898	160128	0-3-7-9-4-6-8-5-2-4-9-7-2-5-2-1	0.0-3.0-7.0-9.0-4.0-6.0-8.0-5.0-2.0-4.1-9.1-7.1-2.1-5.0-2.0-1.0	100	161258	163028
AV_HG01175#haplotype1#0000070:46006269-46414083	AV_HG01175	163072	176176	5	79	0	0	78	13104	175002	161898	0-3-7-9-4-6-8-5-2-4-9-7-2-5-2-1	0.0-3.0-7.0-9.0-4.0-6.0-8.0-5.0-2.0-4.1-9.1-7.1-2.1-5.0-2.0-1.0	100	162972	176076
AV_HG01175#haplotype1#0000070:46006269-46414083	AV_HG01175	176120	210055	2	196	0	0	194	33935	208937	175002	0-3-7-9-4-6-8-5-2-4-9-7-2-5-2-1	0.0-3.0-7.0-9.0-4.0-6.0-8.0-5.0-2.0-4.1-9.1-7.1-2.1-5.0-2.0-1.0	100	176020	209955
AV_HG01175#haplotype1#0000070:46006269-46414083	AV_HG01175	212306	223853	4	84	1	58	4	11547	220484	208937	0-3-7-9-4-6-8-5-2-4-9-7-2-5-2-1	0.0-3.0-7.0-9.0-4.0-6.0-8.0-5.0-2.0-4.1-9.1-7.1-2.1-5.0-2.0-1.0	100	212206	223753
AV_HG01175#haplotype1#0000070:46006269-46414083	AV_HG01175	224918	226229	9	5	1	4	0	1311	221795	220484	0-3-7-9-4-6-8-5-2-4-9-7-2-5-2-1	0.0-3.0-7.0-9.0-4.0-6.0-8.0-5.0-2.0-4.1-9.1-7.1-2.1-5.0-2.0-1.0	100	224818	226129
AV_HG01175#haplotype1#0000070:46006269-46414083	AV_HG01175	226173	228213	7	12	1	11	0	2040	223835	221795	0-3-7-9-4-6-8-5-2-4-9-7-2-5-2-1	0.0-3.0-7.0-9.0-4.0-6.0-8.0-5.0-2.0-4.1-9.1-7.1-2.1-5.0-2.0-1.0	100	226073	228113
AV_HG01175#haplotype1#0000070:46006269-46414083	AV_HG01175	229675	257203	2	196	1	194	39	27528	251363	223835	0-3-7-9-4-6-8-5-2-4-9-7-2-5-2-1	0.0-3.0-7.0-9.0-4.0-6.0-8.0-5.0-2.0-4.1-9.1-7.1-2.1-5.0-2.0-1.0	100	229575	257103
AV_HG01175#haplotype1#0000070:46006269-46414083	AV_HG01175	258169	269857	5	79	0	5	77	11688	263051	251363	0-3-7-9-4-6-8-5-2-4-9-7-2-5-2-1	0.0-3.0-7.0-9.0-4.0-6.0-8.0-5.0-2.0-4.1-9.1-7.1-2.1-5.0-2.0-1.0	100	258069	269757
AV_HG01175#haplotype1#0000070:46006269-46414083	AV_HG01175	270464	304568	2	196	0	1	195	34104	297155	263051	0-3-7-9-4-6-8-5-2-4-9-7-2-5-2-1	0.0-3.0-7.0-9.0-4.0-6.0-8.0-5.0-2.0-4.1-9.1-7.1-2.1-5.0-2.0-1.0	100	270364	304468
AV_HG01175#haplotype1#0000070:46006269-46414083	AV_HG01175	304512	407469	1	612	0	0	609	102957	400112	297155	0-3-7-9-4-6-8-5-2-4-9-7-2-5-2-1	0.0-3.0-7.0-9.0-4.0-6.0-8.0-5.0-2.0-4.1-9.1-7.1-2.1-5.0-2.0-1.0	100	304412	407369
AV_HG01361#haplotype1#0000023:101593539-102001341	AV_HG01361	99	115493	0	672	0	0	671	115394	115394	0	0-3-7-9-4-6-8-5-2-4-9-7-2-5-2-1	0.0-3.0-7.0-9.0-4.0-6.0-8.0-5.0-2.0-4.1-9.1-7.1-2.1-5.1-2.0-1.0	99	0	115394
AV_HG01361#haplotype1#0000023:101593539-102001341	AV_HG01361	115584	138415	3	132	0	0	131	22831	138225	115394	0-3-7-9-4-6-8-5-2-4-9-7-2-5-2-1	0.0-3.0-7.0-9.0-4.0-6.0-8.0-5.0-2.0-4.1-9.1-7.1-2.1-5.1-2.0-1.0	99	115485	138316
AV_HG01361#haplotype1#0000023:101593539-102001341	AV_HG01361	139174	141214	7	12	0	0	11	2040	140265	138225	0-3-7-9-4-6-8-5-2-4-9-7-2-5-2-1	0.0-3.0-7.0-9.0-4.0-6.0-8.0-5.0-2.0-4.1-9.1-7.1-2.1-5.1-2.0-1.0	99	139075	141115
AV_HG01361#haplotype1#0000023:101593539-102001341	AV_HG01361	141158	142469	9	5	0	0	4	1311	141576	140265	0-3-7-9-4-6-8-5-2-4-9-7-2-5-2-1	0.0-3.0-7.0-9.0-4.0-6.0-8.0-5.0-2.0-4.1-9.1-7.1-2.1-5.1-2.0-1.0	99	141059	142370
AV_HG01361#haplotype1#0000023:101593539-102001341	AV_HG01361	143260	158712	4	84	0	1	83	15452	157028	141576	0-3-7-9-4-6-8-5-2-4-9-7-2-5-2-1	0.0-3.0-7.0-9.0-4.0-6.0-8.0-5.0-2.0-4.1-9.1-7.1-2.1-5.1-2.0-1.0	99	143161	158613
AV_HG01361#haplotype1#0000023:101593539-102001341	AV_HG01361	158656	161471	6	12	0	0	11	2815	159843	157028	0-3-7-9-4-6-8-5-2-4-9-7-2-5-2-1	0.0-3.0-7.0-9.0-4.0-6.0-8.0-5.0-2.0-4.1-9.1-7.1-2.1-5.1-2.0-1.0	99	158557	161372
AV_HG01361#haplotype1#0000023:101593539-102001341	AV_HG01361	161415	163185	8	8	0	0	7	1770	161613	159843	0-3-7-9-4-6-8-5-2-4-9-7-2-5-2-1	0.0-3.0-7.0-9.0-4.0-6.0-8.0-5.0-2.0-4.1-9.1-7.1-2.1-5.1-2.0-1.0	99	161316	163086
AV_HG01361#haplotype1#0000023:101593539-102001341	AV_HG01361	163129	176233	5	79	0	0	78	13104	174717	161613	0-3-7-9-4-6-8-5-2-4-9-7-2-5-2-1	0.0-3.0-7.0-9.0-4.0-6.0-8.0-5.0-2.0-4.1-9.1-7.1-2.1-5.1-2.0-1.0	99	163030	176134
AV_HG01361#haplotype1#0000023:101593539-102001341	AV_HG01361	176177	210497	2	196	0	0	195	34320	209037	174717	0-3-7-9-4-6-8-5-2-4-9-7-2-5-2-1	0.0-3.0-7.0-9.0-4.0-6.0-8.0-5.0-2.0-4.1-9.1-7.1-2.1-5.1-2.0-1.0	99	176078	210398
AV_HG01361#haplotype1#0000023:101593539-102001341	AV_HG01361	212363	223908	4	84	1	58	4	11545	220582	209037	0-3-7-9-4-6-8-5-2-4-9-7-2-5-2-1	0.0-3.0-7.0-9.0-4.0-6.0-8.0-5.0-2.0-4.1-9.1-7.1-2.1-5.1-2.0-1.0	99	212264	223809
AV_HG01361#haplotype1#0000023:101593539-102001341	AV_HG01361	224971	226282	9	5	1	4	0	1311	221893	220582	0-3-7-9-4-6-8-5-2-4-9-7-2-5-2-1	0.0-3.0-7.0-9.0-4.0-6.0-8.0-5.0-2.0-4.1-9.1-7.1-2.1-5.1-2.0-1.0	99	224872	226183
AV_HG01361#haplotype1#0000023:101593539-102001341	AV_HG01361	226226	228266	7	12	1	11	0	2040	223933	221893	0-3-7-9-4-6-8-5-2-4-9-7-2-5-2-1	0.0-3.0-7.0-9.0-4.0-6.0-8.0-5.0-2.0-4.1-9.1-7.1-2.1-5.1-2.0-1.0	99	226127	228167
AV_HG01361#haplotype1#0000023:101593539-102001341	AV_HG01361	229343	263442	2	196	1	195	1	34099	258032	223933	0-3-7-9-4-6-8-5-2-4-9-7-2-5-2-1	0.0-3.0-7.0-9.0-4.0-6.0-8.0-5.0-2.0-4.1-9.1-7.1-2.1-5.1-2.0-1.0	99	229244	263343
AV_HG01361#haplotype1#0000023:101593539-102001341	AV_HG01361	264049	276264	5	79	1	77	3	12215	270247	258032	0-3-7-9-4-6-8-5-2-4-9-7-2-5-2-1	0.0-3.0-7.0-9.0-4.0-6.0-8.0-5.0-2.0-4.1-9.1-7.1-2.1-5.1-2.0-1.0	99	263950	276165
AV_HG01361#haplotype1#0000023:101593539-102001341	AV_HG01361	276703	304604	2	196	0	39	195	27901	298148	270247	0-3-7-9-4-6-8-5-2-4-9-7-2-5-2-1	0.0-3.0-7.0-9.0-4.0-6.0-8.0-5.0-2.0-4.1-9.1-7.1-2.1-5.1-2.0-1.0	99	276604	304505
AV_HG01361#haplotype1#0000023:101593539-102001341	AV_HG01361	304548	407730	1	612	0	0	611	103182	401330	298148	0-3-7-9-4-6-8-5-2-4-9-7-2-5-2-1	0.0-3.0-7.0-9.0-4.0-6.0-8.0-5.0-2.0-4.1-9.1-7.1-2.1-5.1-2.0-1.0	99	304449	407631
AV_HG01361#haplotype2#0001322:101872897-102186552	AV_HG01361	99	115465	0	672	0	0	671	115366	115366	0	0-3-7-9-4-6-8-5-2-1	0.0-3.0-7.0-9.0-4.0-6.0-8.0-5.0-2.0-1.0	99	0	115366
AV_HG01361#haplotype2#0001322:101872897-102186552	AV_HG01361	115556	138387	3	132	0	0	131	22831	138197	115366	0-3-7-9-4-6-8-5-2-1	0.0-3.0-7.0-9.0-4.0-6.0-8.0-5.0-2.0-1.0	99	115457	138288
AV_HG01361#haplotype2#0001322:101872897-102186552	AV_HG01361	139146	141186	7	12	0	0	11	2040	140237	138197	0-3-7-9-4-6-8-5-2-1	0.0-3.0-7.0-9.0-4.0-6.0-8.0-5.0-2.0-1.0	99	139047	141087
AV_HG01361#haplotype2#0001322:101872897-102186552	AV_HG01361	141130	142441	9	5	0	0	4	1311	141548	140237	0-3-7-9-4-6-8-5-2-1	0.0-3.0-7.0-9.0-4.0-6.0-8.0-5.0-2.0-1.0	99	141031	142342
AV_HG01361#haplotype2#0001322:101872897-102186552	AV_HG01361	143232	158689	4	84	0	1	83	15457	157005	141548	0-3-7-9-4-6-8-5-2-1	0.0-3.0-7.0-9.0-4.0-6.0-8.0-5.0-2.0-1.0	99	143133	158590
AV_HG01361#haplotype2#0001322:101872897-102186552	AV_HG01361	158633	161448	6	12	0	0	11	2815	159820	157005	0-3-7-9-4-6-8-5-2-1	0.0-3.0-7.0-9.0-4.0-6.0-8.0-5.0-2.0-1.0	99	158534	161349
AV_HG01361#haplotype2#0001322:101872897-102186552	AV_HG01361	161392	163162	8	8	0	0	7	1770	161590	159820	0-3-7-9-4-6-8-5-2-1	0.0-3.0-7.0-9.0-4.0-6.0-8.0-5.0-2.0-1.0	99	161293	163063
AV_HG01361#haplotype2#0001322:101872897-102186552	AV_HG01361	163106	176210	5	79	0	0	78	13104	174694	161590	0-3-7-9-4-6-8-5-2-1	0.0-3.0-7.0-9.0-4.0-6.0-8.0-5.0-2.0-1.0	99	163007	176111
AV_HG01361#haplotype2#0001322:101872897-102186552	AV_HG01361	176154	210480	2	196	0	0	195	34326	209020	174694	0-3-7-9-4-6-8-5-2-1	0.0-3.0-7.0-9.0-4.0-6.0-8.0-5.0-2.0-1.0	99	176055	210381
AV_HG01361#haplotype2#0001322:101872897-102186552	AV_HG01361	210424	313583	1	612	0	0	611	103159	312179	209020	0-3-7-9-4-6-8-5-2-1	0.0-3.0-7.0-9.0-4.0-6.0-8.0-5.0-2.0-1.0	99	210325	313484
AV_HG02148#haplotype2#0002863:16304803-16712699	AV_HG02148	100	115500	0	672	0	0	671	115400	115400	0	0-3-7-9-4-6-8-5-2-4-9-7-2-5-2-1	0.0-3.0-7.0-9.0-4.0-6.0-8.0-5.0-2.0-4.1-9.1-7.1-2.1-5.0-2.0-1.0	100	0	115400
AV_HG02148#haplotype2#0002863:16304803-16712699	AV_HG02148	115591	138425	3	132	0	0	131	22834	138234	115400	0-3-7-9-4-6-8-5-2-4-9-7-2-5-2-1	0.0-3.0-7.0-9.0-4.0-6.0-8.0-5.0-2.0-4.1-9.1-7.1-2.1-5.0-2.0-1.0	100	115491	138325
AV_HG02148#haplotype2#0002863:16304803-16712699	AV_HG02148	139184	141224	7	12	0	0	11	2040	140274	138234	0-3-7-9-4-6-8-5-2-4-9-7-2-5-2-1	0.0-3.0-7.0-9.0-4.0-6.0-8.0-5.0-2.0-4.1-9.1-7.1-2.1-5.0-2.0-1.0	100	139084	141124
AV_HG02148#haplotype2#0002863:16304803-16712699	AV_HG02148	141168	142480	9	5	0	0	4	1312	141586	140274	0-3-7-9-4-6-8-5-2-4-9-7-2-5-2-1	0.0-3.0-7.0-9.0-4.0-6.0-8.0-5.0-2.0-4.1-9.1-7.1-2.1-5.0-2.0-1.0	100	141068	142380
AV_HG02148#haplotype2#0002863:16304803-16712699	AV_HG02148	142928	158724	4	84	0	0	83	15796	157382	141586	0-3-7-9-4-6-8-5-2-4-9-7-2-5-2-1	0.0-3.0-7.0-9.0-4.0-6.0-8.0-5.0-2.0-4.1-9.1-7.1-2.1-5.0-2.0-1.0	100	142828	158624
AV_HG02148#haplotype2#0002863:16304803-16712699	AV_HG02148	158668	161484	6	12	0	0	11	2816	160198	157382	0-3-7-9-4-6-8-5-2-4-9-7-2-5-2-1	0.0-3.0-7.0-9.0-4.0-6.0-8.0-5.0-2.0-4.1-9.1-7.1-2.1-5.0-2.0-1.0	100	158568	161384
AV_HG02148#haplotype2#0002863:16304803-16712699	AV_HG02148	161428	163198	8	8	0	0	7	1770	161968	160198	0-3-7-9-4-6-8-5-2-4-9-7-2-5-2-1	0.0-3.0-7.0-9.0-4.0-6.0-8.0-5.0-2.0-4.1-9.1-7.1-2.1-5.0-2.0-1.0	100	161328	163098
AV_HG02148#haplotype2#0002863:16304803-16712699	AV_HG02148	163142	176246	5	79	0	0	78	13104	175072	161968	0-3-7-9-4-6-8-5-2-4-9-7-2-5-2-1	0.0-3.0-7.0-9.0-4.0-6.0-8.0-5.0-2.0-4.1-9.1-7.1-2.1-5.0-2.0-1.0	100	163042	176146
AV_HG02148#haplotype2#0002863:16304803-16712699	AV_HG02148	176190	210131	2	196	0	0	194	33941	209013	175072	0-3-7-9-4-6-8-5-2-4-9-7-2-5-2-1	0.0-3.0-7.0-9.0-4.0-6.0-8.0-5.0-2.0-4.1-9.1-7.1-2.1-5.0-2.0-1.0	100	176090	210031
AV_HG02148#haplotype2#0002863:16304803-16712699	AV_HG02148	212382	223928	4	84	1	58	4	11546	220559	209013	0-3-7-9-4-6-8-5-2-4-9-7-2-5-2-1	0.0-3.0-7.0-9.0-4.0-6.0-8.0-5.0-2.0-4.1-9.1-7.1-2.1-5.0-2.0-1.0	100	212282	223828
AV_HG02148#haplotype2#0002863:16304803-16712699	AV_HG02148	224993	226304	9	5	1	4	0	1311	221870	220559	0-3-7-9-4-6-8-5-2-4-9-7-2-5-2-1	0.0-3.0-7.0-9.0-4.0-6.0-8.0-5.0-2.0-4.1-9.1-7.1-2.1-5.0-2.0-1.0	100	224893	226204
AV_HG02148#haplotype2#0002863:16304803-16712699	AV_HG02148	226248	228288	7	12	1	11	0	2040	223910	221870	0-3-7-9-4-6-8-5-2-4-9-7-2-5-2-1	0.0-3.0-7.0-9.0-4.0-6.0-8.0-5.0-2.0-4.1-9.1-7.1-2.1-5.0-2.0-1.0	100	226148	228188
AV_HG02148#haplotype2#0002863:16304803-16712699	AV_HG02148	229750	257275	2	196	1	194	39	27525	251435	223910	0-3-7-9-4-6-8-5-2-4-9-7-2-5-2-1	0.0-3.0-7.0-9.0-4.0-6.0-8.0-5.0-2.0-4.1-9.1-7.1-2.1-5.0-2.0-1.0	100	229650	257175
AV_HG02148#haplotype2#0002863:16304803-16712699	AV_HG02148	258241	269929	5	79	0	5	77	11688	263123	251435	0-3-7-9-4-6-8-5-2-4-9-7-2-5-2-1	0.0-3.0-7.0-9.0-4.0-6.0-8.0-5.0-2.0-4.1-9.1-7.1-2.1-5.0-2.0-1.0	100	258141	269829
AV_HG02148#haplotype2#0002863:16304803-16712699	AV_HG02148	270536	304635	2	196	0	1	195	34099	297222	263123	0-3-7-9-4-6-8-5-2-4-9-7-2-5-2-1	0.0-3.0-7.0-9.0-4.0-6.0-8.0-5.0-2.0-4.1-9.1-7.1-2.1-5.0-2.0-1.0	100	270436	304535
AV_HG02148#haplotype2#0002863:16304803-16712699	AV_HG02148	304579	407626	1	612	0	0	610	103047	400269	297222	0-3-7-9-4-6-8-5-2-4-9-7-2-5-2-1	0.0-3.0-7.0-9.0-4.0-6.0-8.0-5.0-2.0-4.1-9.1-7.1-2.1-5.0-2.0-1.0	100	304479	407526
AV_HG02257#haplotype2#0001152:102843493-103251377	AV_HG02257	99	115461	0	672	0	0	671	115362	115362	0	0-3-7-9-4-6-8-5-2-4-9-7-2-5-2-1	0.0-3.0-7.0-9.0-4.0-6.0-8.0-5.0-2.0-4.1-9.1-7.1-2.1-5.0-2.0-1.0	99	0	115362
AV_HG02257#haplotype2#0001152:102843493-103251377	AV_HG02257	115552	138383	3	132	0	0	131	22831	138193	115362	0-3-7-9-4-6-8-5-2-4-9-7-2-5-2-1	0.0-3.0-7.0-9.0-4.0-6.0-8.0-5.0-2.0-4.1-9.1-7.1-2.1-5.0-2.0-1.0	99	115453	138284
AV_HG02257#haplotype2#0001152:102843493-103251377	AV_HG02257	139142	141182	7	12	0	0	11	2040	140233	138193	0-3-7-9-4-6-8-5-2-4-9-7-2-5-2-1	0.0-3.0-7.0-9.0-4.0-6.0-8.0-5.0-2.0-4.1-9.1-7.1-2.1-5.0-2.0-1.0	99	139043	141083
AV_HG02257#haplotype2#0001152:102843493-103251377	AV_HG02257	141126	142437	9	5	0	0	4	1311	141544	140233	0-3-7-9-4-6-8-5-2-4-9-7-2-5-2-1	0.0-3.0-7.0-9.0-4.0-6.0-8.0-5.0-2.0-4.1-9.1-7.1-2.1-5.0-2.0-1.0	99	141027	142338
AV_HG02257#haplotype2#0001152:102843493-103251377	AV_HG02257	143500	158693	4	84	0	4	83	15193	156737	141544	0-3-7-9-4-6-8-5-2-4-9-7-2-5-2-1	0.0-3.0-7.0-9.0-4.0-6.0-8.0-5.0-2.0-4.1-9.1-7.1-2.1-5.0-2.0-1.0	99	143401	158594
AV_HG02257#haplotype2#0001152:102843493-103251377	AV_HG02257	158637	161452	6	12	0	0	11	2815	159552	156737	0-3-7-9-4-6-8-5-2-4-9-7-2-5-2-1	0.0-3.0-7.0-9.0-4.0-6.0-8.0-5.0-2.0-4.1-9.1-7.1-2.1-5.0-2.0-1.0	99	158538	161353
AV_HG02257#haplotype2#0001152:102843493-103251377	AV_HG02257	161396	163166	8	8	0	0	7	1770	161322	159552	0-3-7-9-4-6-8-5-2-4-9-7-2-5-2-1	0.0-3.0-7.0-9.0-4.0-6.0-8.0-5.0-2.0-4.1-9.1-7.1-2.1-5.0-2.0-1.0	99	161297	163067
AV_HG02257#haplotype2#0001152:102843493-103251377	AV_HG02257	163110	176248	5	79	0	0	78	13138	174460	161322	0-3-7-9-4-6-8-5-2-4-9-7-2-5-2-1	0.0-3.0-7.0-9.0-4.0-6.0-8.0-5.0-2.0-4.1-9.1-7.1-2.1-5.0-2.0-1.0	99	163011	176149
AV_HG02257#haplotype2#0001152:102843493-103251377	AV_HG02257	176192	210527	2	196	0	0	195	34335	208795	174460	0-3-7-9-4-6-8-5-2-4-9-7-2-5-2-1	0.0-3.0-7.0-9.0-4.0-6.0-8.0-5.0-2.0-4.1-9.1-7.1-2.1-5.0-2.0-1.0	99	176093	210428
AV_HG02257#haplotype2#0001152:102843493-103251377	AV_HG02257	212843	223937	4	84	1	56	4	11094	219889	208795	0-3-7-9-4-6-8-5-2-4-9-7-2-5-2-1	0.0-3.0-7.0-9.0-4.0-6.0-8.0-5.0-2.0-4.1-9.1-7.1-2.1-5.0-2.0-1.0	99	212744	223838
AV_HG02257#haplotype2#0001152:102843493-103251377	AV_HG02257	225000	226311	9	5	1	4	0	1311	221200	219889	0-3-7-9-4-6-8-5-2-4-9-7-2-5-2-1	0.0-3.0-7.0-9.0-4.0-6.0-8.0-5.0-2.0-4.1-9.1-7.1-2.1-5.0-2.0-1.0	99	224901	226212
AV_HG02257#haplotype2#0001152:102843493-103251377	AV_HG02257	226255	228295	7	12	1	11	0	2040	223240	221200	0-3-7-9-4-6-8-5-2-4-9-7-2-5-2-1	0.0-3.0-7.0-9.0-4.0-6.0-8.0-5.0-2.0-4.1-9.1-7.1-2.1-5.0-2.0-1.0	99	226156	228196
AV_HG02257#haplotype2#0001152:102843493-103251377	AV_HG02257	229372	257280	2	196	1	195	39	27908	251148	223240	0-3-7-9-4-6-8-5-2-4-9-7-2-5-2-1	0.0-3.0-7.0-9.0-4.0-6.0-8.0-5.0-2.0-4.1-9.1-7.1-2.1-5.0-2.0-1.0	99	229273	257181
AV_HG02257#haplotype2#0001152:102843493-103251377	AV_HG02257	258246	269460	5	79	0	5	75	11214	262362	251148	0-3-7-9-4-6-8-5-2-4-9-7-2-5-2-1	0.0-3.0-7.0-9.0-4.0-6.0-8.0-5.0-2.0-4.1-9.1-7.1-2.1-5.0-2.0-1.0	99	258147	269361
AV_HG02257#haplotype2#0001152:102843493-103251377	AV_HG02257	270541	304640	2	196	0	1	195	34099	296461	262362	0-3-7-9-4-6-8-5-2-4-9-7-2-5-2-1	0.0-3.0-7.0-9.0-4.0-6.0-8.0-5.0-2.0-4.1-9.1-7.1-2.1-5.0-2.0-1.0	99	270442	304541
AV_HG02257#haplotype2#0001152:102843493-103251377	AV_HG02257	304584	407614	1	612	0	0	610	103030	399491	296461	0-3-7-9-4-6-8-5-2-4-9-7-2-5-2-1	0.0-3.0-7.0-9.0-4.0-6.0-8.0-5.0-2.0-4.1-9.1-7.1-2.1-5.0-2.0-1.0	99	304485	407515
HG002.verkko_filt_mat.fa:haplotype1-0000005_138228497_138636354_1	HG002.verkko_filt_mat.fa:haplotype1-0000005_138228497_138636354_1	154	115529	0	672	0	0	671	115375	115375	0	0-3-7-9-4-6-8-5-2-4-9-7-2-5-2-1	0.0-3.0-7.0-9.0-4.0-6.0-8.0-5.0-2.0-4.1-9.1-7.1-2.1-5.0-2.0-1.0	154	0	115375
HG002.verkko_filt_mat.fa:haplotype1-0000005_138228497_138636354_1	HG002.verkko_filt_mat.fa:haplotype1-0000005_138228497_138636354_1	115620	138455	3	132	0	0	131	22835	138210	115375	0-3-7-9-4-6-8-5-2-4-9-7-2-5-2-1	0.0-3.0-7.0-9.0-4.0-6.0-8.0-5.0-2.0-4.1-9.1-7.1-2.1-5.0-2.0-1.0	154	115466	138301
HG002.verkko_filt_mat.fa:haplotype1-0000005_138228497_138636354_1	HG002.verkko_filt_mat.fa:haplotype1-0000005_138228497_138636354_1	139214	141254	7	12	0	0	11	2040	140250	138210	0-3-7-9-4-6-8-5-2-4-9-7-2-5-2-1	0.0-3.0-7.0-9.0-4.0-6.0-8.0-5.0-2.0-4.1-9.1-7.1-2.1-5.0-2.0-1.0	154	139060	141100
HG002.verkko_filt_mat.fa:haplotype1-0000005_138228497_138636354_1	HG002.verkko_filt_mat.fa:haplotype1-0000005_138228497_138636354_1	141198	142510	9	5	0	0	4	1312	141562	140250	0-3-7-9-4-6-8-5-2-4-9-7-2-5-2-1	0.0-3.0-7.0-9.0-4.0-6.0-8.0-5.0-2.0-4.1-9.1-7.1-2.1-5.0-2.0-1.0	154	141044	142356
HG002.verkko_filt_mat.fa:haplotype1-0000005_138228497_138636354_1	HG002.verkko_filt_mat.fa:haplotype1-0000005_138228497_138636354_1	142958	158753	4	84	0	0	83	15795	157357	141562	0-3-7-9-4-6-8-5-2-4-9-7-2-5-2-1	0.0-3.0-7.0-9.0-4.0-6.0-8.0-5.0-2.0-4.1-9.1-7.1-2.1-5.0-2.0-1.0	154	142804	158599
HG002.verkko_filt_mat.fa:haplotype1-0000005_138228497_138636354_1	HG002.verkko_filt_mat.fa:haplotype1-0000005_138228497_138636354_1	158697	161513	6	12	0	0	11	2816	160173	157357	0-3-7-9-4-6-8-5-2-4-9-7-2-5-2-1	0.0-3.0-7.0-9.0-4.0-6.0-8.0-5.0-2.0-4.1-9.1-7.1-2.1-5.0-2.0-1.0	154	158543	161359
HG002.verkko_filt_mat.fa:haplotype1-0000005_138228497_138636354_1	HG002.verkko_filt_mat.fa:haplotype1-0000005_138228497_138636354_1	161457	163227	8	8	0	0	7	1770	161943	160173	0-3-7-9-4-6-8-5-2-4-9-7-2-5-2-1	0.0-3.0-7.0-9.0-4.0-6.0-8.0-5.0-2.0-4.1-9.1-7.1-2.1-5.0-2.0-1.0	154	161303	163073
HG002.verkko_filt_mat.fa:haplotype1-0000005_138228497_138636354_1	HG002.verkko_filt_mat.fa:haplotype1-0000005_138228497_138636354_1	163171	176275	5	79	0	0	78	13104	175047	161943	0-3-7-9-4-6-8-5-2-4-9-7-2-5-2-1	0.0-3.0-7.0-9.0-4.0-6.0-8.0-5.0-2.0-4.1-9.1-7.1-2.1-5.0-2.0-1.0	154	163017	176121
HG002.verkko_filt_mat.fa:haplotype1-0000005_138228497_138636354_1	HG002.verkko_filt_mat.fa:haplotype1-0000005_138228497_138636354_1	176219	210153	2	196	0	0	194	33934	208981	175047	0-3-7-9-4-6-8-5-2-4-9-7-2-5-2-1	0.0-3.0-7.0-9.0-4.0-6.0-8.0-5.0-2.0-4.1-9.1-7.1-2.1-5.0-2.0-1.0	154	176065	209999
HG002.verkko_filt_mat.fa:haplotype1-0000005_138228497_138636354_1	HG002.verkko_filt_mat.fa:haplotype1-0000005_138228497_138636354_1	212404	223957	4	84	1	58	4	11553	220534	208981	0-3-7-9-4-6-8-5-2-4-9-7-2-5-2-1	0.0-3.0-7.0-9.0-4.0-6.0-8.0-5.0-2.0-4.1-9.1-7.1-2.1-5.0-2.0-1.0	154	212250	223803
HG002.verkko_filt_mat.fa:haplotype1-0000005_138228497_138636354_1	HG002.verkko_filt_mat.fa:haplotype1-0000005_138228497_138636354_1	225024	226335	9	5	1	4	0	1311	221845	220534	0-3-7-9-4-6-8-5-2-4-9-7-2-5-2-1	0.0-3.0-7.0-9.0-4.0-6.0-8.0-5.0-2.0-4.1-9.1-7.1-2.1-5.0-2.0-1.0	154	224870	226181
HG002.verkko_filt_mat.fa:haplotype1-0000005_138228497_138636354_1	HG002.verkko_filt_mat.fa:haplotype1-0000005_138228497_138636354_1	226279	228319	7	12	1	11	0	2040	223885	221845	0-3-7-9-4-6-8-5-2-4-9-7-2-5-2-1	0.0-3.0-7.0-9.0-4.0-6.0-8.0-5.0-2.0-4.1-9.1-7.1-2.1-5.0-2.0-1.0	154	226125	228165
HG002.verkko_filt_mat.fa:haplotype1-0000005_138228497_138636354_1	HG002.verkko_filt_mat.fa:haplotype1-0000005_138228497_138636354_1	229781	257309	2	196	1	194	39	27528	251413	223885	0-3-7-9-4-6-8-5-2-4-9-7-2-5-2-1	0.0-3.0-7.0-9.0-4.0-6.0-8.0-5.0-2.0-4.1-9.1-7.1-2.1-5.0-2.0-1.0	154	229627	257155
HG002.verkko_filt_mat.fa:haplotype1-0000005_138228497_138636354_1	HG002.verkko_filt_mat.fa:haplotype1-0000005_138228497_138636354_1	258275	269963	5	79	0	5	77	11688	263101	251413	0-3-7-9-4-6-8-5-2-4-9-7-2-5-2-1	0.0-3.0-7.0-9.0-4.0-6.0-8.0-5.0-2.0-4.1-9.1-7.1-2.1-5.0-2.0-1.0	154	258121	269809
HG002.verkko_filt_mat.fa:haplotype1-0000005_138228497_138636354_1	HG002.verkko_filt_mat.fa:haplotype1-0000005_138228497_138636354_1	270570	304672	2	196	0	1	195	34102	297203	263101	0-3-7-9-4-6-8-5-2-4-9-7-2-5-2-1	0.0-3.0-7.0-9.0-4.0-6.0-8.0-5.0-2.0-4.1-9.1-7.1-2.1-5.0-2.0-1.0	154	270416	304518
HG002.verkko_filt_mat.fa:haplotype1-0000005_138228497_138636354_1	HG002.verkko_filt_mat.fa:haplotype1-0000005_138228497_138636354_1	304616	407841	1	612	0	0	611	103225	400428	297203	0-3-7-9-4-6-8-5-2-4-9-7-2-5-2-1	0.0-3.0-7.0-9.0-4.0-6.0-8.0-5.0-2.0-4.1-9.1-7.1-2.1-5.0-2.0-1.0	154	304462	407687
HG002.verkko_filt_pat.fa:haplotype2-0000649_147937390_148315979_1	HG002.verkko_filt_pat.fa:haplotype2-0000649_147937390_148315979_1	154	115513	0	672	0	0	671	115359	115359	0	0-3-7-9-4-6-8-5-2-2-5-2-1	0.0-3.0-7.0-9.0-4.0-6.0-8.0-5.0-2.0-2.1-5.0-2.0-1.0	154	0	115359
HG002.verkko_filt_pat.fa:haplotype2-0000649_147937390_148315979_1	HG002.verkko_filt_pat.fa:haplotype2-0000649_147937390_148315979_1	115604	138437	3	132	0	0	131	22833	138192	115359	0-3-7-9-4-6-8-5-2-2-5-2-1	0.0-3.0-7.0-9.0-4.0-6.0-8.0-5.0-2.0-2.1-5.0-2.0-1.0	154	115450	138283
HG002.verkko_filt_pat.fa:haplotype2-0000649_147937390_148315979_1	HG002.verkko_filt_pat.fa:haplotype2-0000649_147937390_148315979_1	139196	141236	7	12	0	0	11	2040	140232	138192	0-3-7-9-4-6-8-5-2-2-5-2-1	0.0-3.0-7.0-9.0-4.0-6.0-8.0-5.0-2.0-2.1-5.0-2.0-1.0	154	139042	141082
HG002.verkko_filt_pat.fa:haplotype2-0000649_147937390_148315979_1	HG002.verkko_filt_pat.fa:haplotype2-0000649_147937390_148315979_1	141180	142492	9	5	0	0	4	1312	141544	140232	0-3-7-9-4-6-8-5-2-2-5-2-1	0.0-3.0-7.0-9.0-4.0-6.0-8.0-5.0-2.0-2.1-5.0-2.0-1.0	154	141026	142338
HG002.verkko_filt_pat.fa:haplotype2-0000649_147937390_148315979_1	HG002.verkko_filt_pat.fa:haplotype2-0000649_147937390_148315979_1	142940	158745	4	84	0	0	83	15805	157349	141544	0-3-7-9-4-6-8-5-2-2-5-2-1	0.0-3.0-7.0-9.0-4.0-6.0-8.0-5.0-2.0-2.1-5.0-2.0-1.0	154	142786	158591
HG002.verkko_filt_pat.fa:haplotype2-0000649_147937390_148315979_1	HG002.verkko_filt_pat.fa:haplotype2-0000649_147937390_148315979_1	158689	161504	6	12	0	0	11	2815	160164	157349	0-3-7-9-4-6-8-5-2-2-5-2-1	0.0-3.0-7.0-9.0-4.0-6.0-8.0-5.0-2.0-2.1-5.0-2.0-1.0	154	158535	161350
HG002.verkko_filt_pat.fa:haplotype2-0000649_147937390_148315979_1	HG002.verkko_filt_pat.fa:haplotype2-0000649_147937390_148315979_1	161448	163218	8	8	0	0	7	1770	161934	160164	0-3-7-9-4-6-8-5-2-2-5-2-1	0.0-3.0-7.0-9.0-4.0-6.0-8.0-5.0-2.0-2.1-5.0-2.0-1.0	154	161294	163064
HG002.verkko_filt_pat.fa:haplotype2-0000649_147937390_148315979_1	HG002.verkko_filt_pat.fa:haplotype2-0000649_147937390_148315979_1	163162	175861	5	79	0	0	77	12699	174633	161934	0-3-7-9-4-6-8-5-2-2-5-2-1	0.0-3.0-7.0-9.0-4.0-6.0-8.0-5.0-2.0-2.1-5.0-2.0-1.0	154	163008	175707
HG002.verkko_filt_pat.fa:haplotype2-0000649_147937390_148315979_1	HG002.verkko_filt_pat.fa:haplotype2-0000649_147937390_148315979_1	176468	200792	2	196	0	1	137	24324	198957	174633	0-3-7-9-4-6-8-5-2-2-5-2-1	0.0-3.0-7.0-9.0-4.0-6.0-8.0-5.0-2.0-2.1-5.0-2.0-1.0	154	176314	200638
HG002.verkko_filt_pat.fa:haplotype2-0000649_147937390_148315979_1	HG002.verkko_filt_pat.fa:haplotype2-0000649_147937390_148315979_1	205874	229026	2	196	1	168	39	23152	222109	198957	0-3-7-9-4-6-8-5-2-2-5-2-1	0.0-3.0-7.0-9.0-4.0-6.0-8.0-5.0-2.0-2.1-5.0-2.0-1.0	154	205720	228872
HG002.verkko_filt_pat.fa:haplotype2-0000649_147937390_148315979_1	HG002.verkko_filt_pat.fa:haplotype2-0000649_147937390_148315979_1	229465	241680	5	79	0	3	77	12215	234324	222109	0-3-7-9-4-6-8-5-2-2-5-2-1	0.0-3.0-7.0-9.0-4.0-6.0-8.0-5.0-2.0-2.1-5.0-2.0-1.0	154	229311	241526
HG002.verkko_filt_pat.fa:haplotype2-0000649_147937390_148315979_1	HG002.verkko_filt_pat.fa:haplotype2-0000649_147937390_148315979_1	242287	276390	2	196	0	1	195	34103	268427	234324	0-3-7-9-4-6-8-5-2-2-5-2-1	0.0-3.0-7.0-9.0-4.0-6.0-8.0-5.0-2.0-2.1-5.0-2.0-1.0	154	242133	276236
HG002.verkko_filt_pat.fa:haplotype2-0000649_147937390_148315979_1	HG002.verkko_filt_pat.fa:haplotype2-0000649_147937390_148315979_1	276334	378527	1	612	0	0	605	102193	370620	268427	0-3-7-9-4-6-8-5-2-2-5-2-1	0.0-3.0-7.0-9.0-4.0-6.0-8.0-5.0-2.0-2.1-5.0-2.0-1.0	154	276180	378373
HG00438#1#JAHBCB010000015.1_33474867_33954171_0	HG00438	98	115453	0	672	0	0	671	115355	115355	0	0-3-7-9-4-6-8-5-2-4-9-7-2-5-8-6-4-9-7-2-5-2-1	0.0-3.0-7.0-9.0-4.0-6.0-8.0-5.0-2.0-4.1-9.1-7.1-2.1-5.1-8.1-6.1-4.1-9.1-7.1-2.1-5.1-2.0-1.0	98	0	115355
HG00438#1#JAHBCB010000015.1_33474867_33954171_0	HG00438	115544	138378	3	132	0	0	131	22834	138189	115355	0-3-7-9-4-6-8-5-2-4-9-7-2-5-8-6-4-9-7-2-5-2-1	0.0-3.0-7.0-9.0-4.0-6.0-8.0-5.0-2.0-4.1-9.1-7.1-2.1-5.1-8.1-6.1-4.1-9.1-7.1-2.1-5.1-2.0-1.0	98	115446	138280
HG00438#1#JAHBCB010000015.1_33474867_33954171_0	HG00438	139137	141177	7	12	0	0	11	2040	140229	138189	0-3-7-9-4-6-8-5-2-4-9-7-2-5-8-6-4-9-7-2-5-2-1	0.0-3.0-7.0-9.0-4.0-6.0-8.0-5.0-2.0-4.1-9.1-7.1-2.1-5.1-8.1-6.1-4.1-9.1-7.1-2.1-5.1-2.0-1.0	98	139039	141079
HG00438#1#JAHBCB010000015.1_33474867_33954171_0	HG00438	141121	142433	9	5	0	0	4	1312	141541	140229	0-3-7-9-4-6-8-5-2-4-9-7-2-5-8-6-4-9-7-2-5-2-1	0.0-3.0-7.0-9.0-4.0-6.0-8.0-5.0-2.0-4.1-9.1-7.1-2.1-5.1-8.1-6.1-4.1-9.1-7.1-2.1-5.1-2.0-1.0	98	141023	142335
HG00438#1#JAHBCB010000015.1_33474867_33954171_0	HG00438	142881	158687	4	84	0	0	83	15806	157347	141541	0-3-7-9-4-6-8-5-2-4-9-7-2-5-8-6-4-9-7-2-5-2-1	0.0-3.0-7.0-9.0-4.0-6.0-8.0-5.0-2.0-4.1-9.1-7.1-2.1-5.1-8.1-6.1-4.1-9.1-7.1-2.1-5.1-2.0-1.0	98	142783	158589
HG00438#1#JAHBCB010000015.1_33474867_33954171_0	HG00438	158631	161446	6	12	0	0	11	2815	160162	157347	0-3-7-9-4-6-8-5-2-4-9-7-2-5-8-6-4-9-7-2-5-2-1	0.0-3.0-7.0-9.0-4.0-6.0-8.0-5.0-2.0-4.1-9.1-7.1-2.1-5.1-8.1-6.1-4.1-9.1-7.1-2.1-5.1-2.0-1.0	98	158533	161348
HG00438#1#JAHBCB010000015.1_33474867_33954171_0	HG00438	161390	163160	8	8	0	0	7	1770	161932	160162	0-3-7-9-4-6-8-5-2-4-9-7-2-5-8-6-4-9-7-2-5-2-1	0.0-3.0-7.0-9.0-4.0-6.0-8.0-5.0-2.0-4.1-9.1-7.1-2.1-5.1-8.1-6.1-4.1-9.1-7.1-2.1-5.1-2.0-1.0	98	161292	163062
HG00438#1#JAHBCB010000015.1_33474867_33954171_0	HG00438	163104	175768	5	79	0	0	77	12664	174596	161932	0-3-7-9-4-6-8-5-2-4-9-7-2-5-8-6-4-9-7-2-5-2-1	0.0-3.0-7.0-9.0-4.0-6.0-8.0-5.0-2.0-4.1-9.1-7.1-2.1-5.1-8.1-6.1-4.1-9.1-7.1-2.1-5.1-2.0-1.0	98	163006	175670
HG00438#1#JAHBCB010000015.1_33474867_33954171_0	HG00438	176375	210474	2	196	0	1	195	34099	208695	174596	0-3-7-9-4-6-8-5-2-4-9-7-2-5-8-6-4-9-7-2-5-2-1	0.0-3.0-7.0-9.0-4.0-6.0-8.0-5.0-2.0-4.1-9.1-7.1-2.1-5.1-8.1-6.1-4.1-9.1-7.1-2.1-5.1-2.0-1.0	98	176277	210376
HG00438#1#JAHBCB010000015.1_33474867_33954171_0	HG00438	212340	223886	4	84	1	58	4	11546	220241	208695	0-3-7-9-4-6-8-5-2-4-9-7-2-5-8-6-4-9-7-2-5-2-1	0.0-3.0-7.0-9.0-4.0-6.0-8.0-5.0-2.0-4.1-9.1-7.1-2.1-5.1-8.1-6.1-4.1-9.1-7.1-2.1-5.1-2.0-1.0	98	212242	223788
HG00438#1#JAHBCB010000015.1_33474867_33954171_0	HG00438	224949	226261	9	5	1	4	0	1312	221553	220241	0-3-7-9-4-6-8-5-2-4-9-7-2-5-8-6-4-9-7-2-5-2-1	0.0-3.0-7.0-9.0-4.0-6.0-8.0-5.0-2.0-4.1-9.1-7.1-2.1-5.1-8.1-6.1-4.1-9.1-7.1-2.1-5.1-2.0-1.0	98	224851	226163
HG00438#1#JAHBCB010000015.1_33474867_33954171_0	HG00438	226205	228245	7	12	1	11	0	2040	223593	221553	0-3-7-9-4-6-8-5-2-4-9-7-2-5-8-6-4-9-7-2-5-2-1	0.0-3.0-7.0-9.0-4.0-6.0-8.0-5.0-2.0-4.1-9.1-7.1-2.1-5.1-8.1-6.1-4.1-9.1-7.1-2.1-5.1-2.0-1.0	98	226107	228147
HG00438#1#JAHBCB010000015.1_33474867_33954171_0	HG00438	229322	263419	2	196	1	195	1	34097	257690	223593	0-3-7-9-4-6-8-5-2-4-9-7-2-5-8-6-4-9-7-2-5-2-1	0.0-3.0-7.0-9.0-4.0-6.0-8.0-5.0-2.0-4.1-9.1-7.1-2.1-5.1-8.1-6.1-4.1-9.1-7.1-2.1-5.1-2.0-1.0	98	229224	263321
HG00438#1#JAHBCB010000015.1_33474867_33954171_0	HG00438	264026	276690	5	79	1	77	0	12664	270354	257690	0-3-7-9-4-6-8-5-2-4-9-7-2-5-8-6-4-9-7-2-5-2-1	0.0-3.0-7.0-9.0-4.0-6.0-8.0-5.0-2.0-4.1-9.1-7.1-2.1-5.1-8.1-6.1-4.1-9.1-7.1-2.1-5.1-2.0-1.0	98	263928	276592
HG00438#1#JAHBCB010000015.1_33474867_33954171_0	HG00438	276634	278404	8	8	1	7	0	1770	272124	270354	0-3-7-9-4-6-8-5-2-4-9-7-2-5-8-6-4-9-7-2-5-2-1	0.0-3.0-7.0-9.0-4.0-6.0-8.0-5.0-2.0-4.1-9.1-7.1-2.1-5.1-8.1-6.1-4.1-9.1-7.1-2.1-5.1-2.0-1.0	98	276536	278306
HG00438#1#JAHBCB010000015.1_33474867_33954171_0	HG00438	278348	281163	6	12	1	11	0	2815	274939	272124	0-3-7-9-4-6-8-5-2-4-9-7-2-5-8-6-4-9-7-2-5-2-1	0.0-3.0-7.0-9.0-4.0-6.0-8.0-5.0-2.0-4.1-9.1-7.1-2.1-5.1-8.1-6.1-4.1-9.1-7.1-2.1-5.1-2.0-1.0	98	278250	281065
HG00438#1#JAHBCB010000015.1_33474867_33954171_0	HG00438	281107	296913	4	84	1	83	0	15806	290745	274939	0-3-7-9-4-6-8-5-2-4-9-7-2-5-8-6-4-9-7-2-5-2-1	0.0-3.0-7.0-9.0-4.0-6.0-8.0-5.0-2.0-4.1-9.1-7.1-2.1-5.1-8.1-6.1-4.1-9.1-7.1-2.1-5.1-2.0-1.0	98	281009	296815
HG00438#1#JAHBCB010000015.1_33474867_33954171_0	HG00438	297361	298673	9	5	1	4	0	1312	292057	290745	0-3-7-9-4-6-8-5-2-4-9-7-2-5-8-6-4-9-7-2-5-2-1	0.0-3.0-7.0-9.0-4.0-6.0-8.0-5.0-2.0-4.1-9.1-7.1-2.1-5.1-8.1-6.1-4.1-9.1-7.1-2.1-5.1-2.0-1.0	98	297263	298575
HG00438#1#JAHBCB010000015.1_33474867_33954171_0	HG00438	298617	300657	7	12	1	11	0	2040	294097	292057	0-3-7-9-4-6-8-5-2-4-9-7-2-5-8-6-4-9-7-2-5-2-1	0.0-3.0-7.0-9.0-4.0-6.0-8.0-5.0-2.0-4.1-9.1-7.1-2.1-5.1-8.1-6.1-4.1-9.1-7.1-2.1-5.1-2.0-1.0	98	298519	300559
HG00438#1#JAHBCB010000015.1_33474867_33954171_0	HG00438	301734	335842	2	196	1	195	1	34108	328205	294097	0-3-7-9-4-6-8-5-2-4-9-7-2-5-8-6-4-9-7-2-5-2-1	0.0-3.0-7.0-9.0-4.0-6.0-8.0-5.0-2.0-4.1-9.1-7.1-2.1-5.1-8.1-6.1-4.1-9.1-7.1-2.1-5.1-2.0-1.0	98	301636	335744
HG00438#1#JAHBCB010000015.1_33474867_33954171_0	HG00438	336449	348664	5	79	1	77	3	12215	340420	328205	0-3-7-9-4-6-8-5-2-4-9-7-2-5-8-6-4-9-7-2-5-2-1	0.0-3.0-7.0-9.0-4.0-6.0-8.0-5.0-2.0-4.1-9.1-7.1-2.1-5.1-8.1-6.1-4.1-9.1-7.1-2.1-5.1-2.0-1.0	98	336351	348566
HG00438#1#JAHBCB010000015.1_33474867_33954171_0	HG00438	349103	377019	2	196	0	39	195	27916	368336	340420	0-3-7-9-4-6-8-5-2-4-9-7-2-5-8-6-4-9-7-2-5-2-1	0.0-3.0-7.0-9.0-4.0-6.0-8.0-5.0-2.0-4.1-9.1-7.1-2.1-5.1-8.1-6.1-4.1-9.1-7.1-2.1-5.1-2.0-1.0	98	349005	376921
HG00438#1#JAHBCB010000015.1_33474867_33954171_0	HG00438	376963	479360	1	612	0	0	606	102397	470733	368336	0-3-7-9-4-6-8-5-2-4-9-7-2-5-8-6-4-9-7-2-5-2-1	0.0-3.0-7.0-9.0-4.0-6.0-8.0-5.0-2.0-4.1-9.1-7.1-2.1-5.1-8.1-6.1-4.1-9.1-7.1-2.1-5.1-2.0-1.0	98	376865	479262
HG00438#2#JAHBCA010000012.1_51513023_51826723_0	HG00438	99	115448	0	672	0	0	671	115349	115349	0	0-3-7-9-4-6-8-5-2-1	0.0-3.0-7.0-9.0-4.0-6.0-8.0-5.0-2.0-1.0	99	0	115349
HG00438#2#JAHBCA010000012.1_51513023_51826723_0	HG00438	115539	138376	3	132	0	0	131	22837	138186	115349	0-3-7-9-4-6-8-5-2-1	0.0-3.0-7.0-9.0-4.0-6.0-8.0-5.0-2.0-1.0	99	115440	138277
HG00438#2#JAHBCA010000012.1_51513023_51826723_0	HG00438	139135	141175	7	12	0	0	11	2040	140226	138186	0-3-7-9-4-6-8-5-2-1	0.0-3.0-7.0-9.0-4.0-6.0-8.0-5.0-2.0-1.0	99	139036	141076
HG00438#2#JAHBCA010000012.1_51513023_51826723_0	HG00438	141119	142431	9	5	0	0	4	1312	141538	140226	0-3-7-9-4-6-8-5-2-1	0.0-3.0-7.0-9.0-4.0-6.0-8.0-5.0-2.0-1.0	99	141020	142332
HG00438#2#JAHBCA010000012.1_51513023_51826723_0	HG00438	142879	158675	4	84	0	0	83	15796	157334	141538	0-3-7-9-4-6-8-5-2-1	0.0-3.0-7.0-9.0-4.0-6.0-8.0-5.0-2.0-1.0	99	142780	158576
HG00438#2#JAHBCA010000012.1_51513023_51826723_0	HG00438	158619	161435	6	12	0	0	11	2816	160150	157334	0-3-7-9-4-6-8-5-2-1	0.0-3.0-7.0-9.0-4.0-6.0-8.0-5.0-2.0-1.0	99	158520	161336
HG00438#2#JAHBCA010000012.1_51513023_51826723_0	HG00438	161379	163149	8	8	0	0	7	1770	161920	160150	0-3-7-9-4-6-8-5-2-1	0.0-3.0-7.0-9.0-4.0-6.0-8.0-5.0-2.0-1.0	99	161280	163050
HG00438#2#JAHBCA010000012.1_51513023_51826723_0	HG00438	163093	175757	5	79	0	0	77	12664	174584	161920	0-3-7-9-4-6-8-5-2-1	0.0-3.0-7.0-9.0-4.0-6.0-8.0-5.0-2.0-1.0	99	162994	175658
HG00438#2#JAHBCA010000012.1_51513023_51826723_0	HG00438	176364	210472	2	196	0	1	195	34108	208692	174584	0-3-7-9-4-6-8-5-2-1	0.0-3.0-7.0-9.0-4.0-6.0-8.0-5.0-2.0-1.0	99	176265	210373
HG00438#2#JAHBCA010000012.1_51513023_51826723_0	HG00438	210416	313628	1	612	0	0	611	103212	311904	208692	0-3-7-9-4-6-8-5-2-1	0.0-3.0-7.0-9.0-4.0-6.0-8.0-5.0-2.0-1.0	99	210317	313529
HG005#1#JAHEPO010000002.1_51519219_51926067_0	HG005	98	115446	0	672	0	0	671	115348	115348	0	0-3-7-9-4-6-8-5-2-7-9-4-2-5-2-1	0.0-3.0-7.0-9.0-4.0-6.0-8.0-5.0-2.0-7.0-9.0-4.0-2.1-5.1-2.0-1.0	98	0	115348
HG005#1#JAHEPO010000002.1_51519219_51926067_0	HG005	115537	138371	3	132	0	0	131	22834	138182	115348	0-3-7-9-4-6-8-5-2-7-9-4-2-5-2-1	0.0-3.0-7.0-9.0-4.0-6.0-8.0-5.0-2.0-7.0-9.0-4.0-2.1-5.1-2.0-1.0	98	115439	138273
HG005#1#JAHEPO010000002.1_51519219_51926067_0	HG005	139130	141170	7	12	0	0	11	2040	140222	138182	0-3-7-9-4-6-8-5-2-7-9-4-2-5-2-1	0.0-3.0-7.0-9.0-4.0-6.0-8.0-5.0-2.0-7.0-9.0-4.0-2.1-5.1-2.0-1.0	98	139032	141072
HG005#1#JAHEPO010000002.1_51519219_51926067_0	HG005	141114	142426	9	5	0	0	4	1312	141534	140222	0-3-7-9-4-6-8-5-2-7-9-4-2-5-2-1	0.0-3.0-7.0-9.0-4.0-6.0-8.0-5.0-2.0-7.0-9.0-4.0-2.1-5.1-2.0-1.0	98	141016	142328
HG005#1#JAHEPO010000002.1_51519219_51926067_0	HG005	142874	158684	4	84	0	0	83	15810	157344	141534	0-3-7-9-4-6-8-5-2-7-9-4-2-5-2-1	0.0-3.0-7.0-9.0-4.0-6.0-8.0-5.0-2.0-7.0-9.0-4.0-2.1-5.1-2.0-1.0	98	142776	158586
HG005#1#JAHEPO010000002.1_51519219_51926067_0	HG005	158628	161443	6	12	0	0	11	2815	160159	157344	0-3-7-9-4-6-8-5-2-7-9-4-2-5-2-1	0.0-3.0-7.0-9.0-4.0-6.0-8.0-5.0-2.0-7.0-9.0-4.0-2.1-5.1-2.0-1.0	98	158530	161345
HG005#1#JAHEPO010000002.1_51519219_51926067_0	HG005	161387	163157	8	8	0	0	7	1770	161929	160159	0-3-7-9-4-6-8-5-2-7-9-4-2-5-2-1	0.0-3.0-7.0-9.0-4.0-6.0-8.0-5.0-2.0-7.0-9.0-4.0-2.1-5.1-2.0-1.0	98	161289	163059
HG005#1#JAHEPO010000002.1_51519219_51926067_0	HG005	163101	175765	5	79	0	0	77	12664	174593	161929	0-3-7-9-4-6-8-5-2-7-9-4-2-5-2-1	0.0-3.0-7.0-9.0-4.0-6.0-8.0-5.0-2.0-7.0-9.0-4.0-2.1-5.1-2.0-1.0	98	163003	175667
HG005#1#JAHEPO010000002.1_51519219_51926067_0	HG005	176372	210474	2	196	0	1	195	34102	208695	174593	0-3-7-9-4-6-8-5-2-7-9-4-2-5-2-1	0.0-3.0-7.0-9.0-4.0-6.0-8.0-5.0-2.0-7.0-9.0-4.0-2.1-5.1-2.0-1.0	98	176274	210376
HG005#1#JAHEPO010000002.1_51519219_51926067_0	HG005	211551	213591	7	12	0	0	11	2040	210735	208695	0-3-7-9-4-6-8-5-2-7-9-4-2-5-2-1	0.0-3.0-7.0-9.0-4.0-6.0-8.0-5.0-2.0-7.0-9.0-4.0-2.1-5.1-2.0-1.0	98	211453	213493
HG005#1#JAHEPO010000002.1_51519219_51926067_0	HG005	213535	214847	9	5	0	0	4	1312	212047	210735	0-3-7-9-4-6-8-5-2-7-9-4-2-5-2-1	0.0-3.0-7.0-9.0-4.0-6.0-8.0-5.0-2.0-7.0-9.0-4.0-2.1-5.1-2.0-1.0	98	213437	214749
HG005#1#JAHEPO010000002.1_51519219_51926067_0	HG005	215295	227451	4	84	0	0	58	12156	224203	212047	0-3-7-9-4-6-8-5-2-7-9-4-2-5-2-1	0.0-3.0-7.0-9.0-4.0-6.0-8.0-5.0-2.0-7.0-9.0-4.0-2.1-5.1-2.0-1.0	98	215197	227353
HG005#1#JAHEPO010000002.1_51519219_51926067_0	HG005	229317	263424	2	196	1	195	1	34107	258310	224203	0-3-7-9-4-6-8-5-2-7-9-4-2-5-2-1	0.0-3.0-7.0-9.0-4.0-6.0-8.0-5.0-2.0-7.0-9.0-4.0-2.1-5.1-2.0-1.0	98	229219	263326
HG005#1#JAHEPO010000002.1_51519219_51926067_0	HG005	264031	276246	5	79	1	77	3	12215	270525	258310	0-3-7-9-4-6-8-5-2-7-9-4-2-5-2-1	0.0-3.0-7.0-9.0-4.0-6.0-8.0-5.0-2.0-7.0-9.0-4.0-2.1-5.1-2.0-1.0	98	263933	276148
HG005#1#JAHEPO010000002.1_51519219_51926067_0	HG005	276685	304598	2	196	0	39	195	27913	298438	270525	0-3-7-9-4-6-8-5-2-7-9-4-2-5-2-1	0.0-3.0-7.0-9.0-4.0-6.0-8.0-5.0-2.0-7.0-9.0-4.0-2.1-5.1-2.0-1.0	98	276587	304500
HG005#1#JAHEPO010000002.1_51519219_51926067_0	HG005	304542	406904	1	612	0	0	606	102362	400800	298438	0-3-7-9-4-6-8-5-2-7-9-4-2-5-2-1	0.0-3.0-7.0-9.0-4.0-6.0-8.0-5.0-2.0-7.0-9.0-4.0-2.1-5.1-2.0-1.0	98	304444	406806
HG005#2#JAHEPN010000023.1_51542210_51950070_0	HG005	99	115463	0	672	0	0	671	115364	115364	0	0-3-7-9-4-6-8-5-2-4-9-7-2-5-2-1	0.0-3.0-7.0-9.0-4.0-6.0-8.0-5.0-2.0-4.1-9.1-7.1-2.1-5.0-2.0-1.0	99	0	115364
HG005#2#JAHEPN010000023.1_51542210_51950070_0	HG005	115554	138391	3	132	0	0	131	22837	138201	115364	0-3-7-9-4-6-8-5-2-4-9-7-2-5-2-1	0.0-3.0-7.0-9.0-4.0-6.0-8.0-5.0-2.0-4.1-9.1-7.1-2.1-5.0-2.0-1.0	99	115455	138292
HG005#2#JAHEPN010000023.1_51542210_51950070_0	HG005	139150	141190	7	12	0	0	11	2040	140241	138201	0-3-7-9-4-6-8-5-2-4-9-7-2-5-2-1	0.0-3.0-7.0-9.0-4.0-6.0-8.0-5.0-2.0-4.1-9.1-7.1-2.1-5.0-2.0-1.0	99	139051	141091
HG005#2#JAHEPN010000023.1_51542210_51950070_0	HG005	141134	142446	9	5	0	0	4	1312	141553	140241	0-3-7-9-4-6-8-5-2-4-9-7-2-5-2-1	0.0-3.0-7.0-9.0-4.0-6.0-8.0-5.0-2.0-4.1-9.1-7.1-2.1-5.0-2.0-1.0	99	141035	142347
HG005#2#JAHEPN010000023.1_51542210_51950070_0	HG005	142894	158686	4	84	0	0	83	15792	157345	141553	0-3-7-9-4-6-8-5-2-4-9-7-2-5-2-1	0.0-3.0-7.0-9.0-4.0-6.0-8.0-5.0-2.0-4.1-9.1-7.1-2.1-5.0-2.0-1.0	99	142795	158587
HG005#2#JAHEPN010000023.1_51542210_51950070_0	HG005	158630	161446	6	12	0	0	11	2816	160161	157345	0-3-7-9-4-6-8-5-2-4-9-7-2-5-2-1	0.0-3.0-7.0-9.0-4.0-6.0-8.0-5.0-2.0-4.1-9.1-7.1-2.1-5.0-2.0-1.0	99	158531	161347
HG005#2#JAHEPN010000023.1_51542210_51950070_0	HG005	161390	163160	8	8	0	0	7	1770	161931	160161	0-3-7-9-4-6-8-5-2-4-9-7-2-5-2-1	0.0-3.0-7.0-9.0-4.0-6.0-8.0-5.0-2.0-4.1-9.1-7.1-2.1-5.0-2.0-1.0	99	161291	163061
HG005#2#JAHEPN010000023.1_51542210_51950070_0	HG005	163104	176193	5	79	0	0	78	13089	175020	161931	0-3-7-9-4-6-8-5-2-4-9-7-2-5-2-1	0.0-3.0-7.0-9.0-4.0-6.0-8.0-5.0-2.0-4.1-9.1-7.1-2.1-5.0-2.0-1.0	99	163005	176094
HG005#2#JAHEPN010000023.1_51542210_51950070_0	HG005	176137	209752	2	196	0	0	191	33615	208635	175020	0-3-7-9-4-6-8-5-2-4-9-7-2-5-2-1	0.0-3.0-7.0-9.0-4.0-6.0-8.0-5.0-2.0-4.1-9.1-7.1-2.1-5.0-2.0-1.0	99	176038	209653
HG005#2#JAHEPN010000023.1_51542210_51950070_0	HG005	212344	223885	4	84	1	58	4	11541	220176	208635	0-3-7-9-4-6-8-5-2-4-9-7-2-5-2-1	0.0-3.0-7.0-9.0-4.0-6.0-8.0-5.0-2.0-4.1-9.1-7.1-2.1-5.0-2.0-1.0	99	212245	223786
HG005#2#JAHEPN010000023.1_51542210_51950070_0	HG005	224952	226263	9	5	1	4	0	1311	221487	220176	0-3-7-9-4-6-8-5-2-4-9-7-2-5-2-1	0.0-3.0-7.0-9.0-4.0-6.0-8.0-5.0-2.0-4.1-9.1-7.1-2.1-5.0-2.0-1.0	99	224853	226164
HG005#2#JAHEPN010000023.1_51542210_51950070_0	HG005	226207	228247	7	12	1	11	0	2040	223527	221487	0-3-7-9-4-6-8-5-2-4-9-7-2-5-2-1	0.0-3.0-7.0-9.0-4.0-6.0-8.0-5.0-2.0-4.1-9.1-7.1-2.1-5.0-2.0-1.0	99	226108	228148
HG005#2#JAHEPN010000023.1_51542210_51950070_0	HG005	229709	257243	2	196	1	194	39	27534	251061	223527	0-3-7-9-4-6-8-5-2-4-9-7-2-5-2-1	0.0-3.0-7.0-9.0-4.0-6.0-8.0-5.0-2.0-4.1-9.1-7.1-2.1-5.0-2.0-1.0	99	229610	257144
HG005#2#JAHEPN010000023.1_51542210_51950070_0	HG005	258209	270337	5	79	0	5	78	12128	263189	251061	0-3-7-9-4-6-8-5-2-4-9-7-2-5-2-1	0.0-3.0-7.0-9.0-4.0-6.0-8.0-5.0-2.0-4.1-9.1-7.1-2.1-5.0-2.0-1.0	99	258110	270238
HG005#2#JAHEPN010000023.1_51542210_51950070_0	HG005	270281	304622	2	196	0	0	195	34341	297530	263189	0-3-7-9-4-6-8-5-2-4-9-7-2-5-2-1	0.0-3.0-7.0-9.0-4.0-6.0-8.0-5.0-2.0-4.1-9.1-7.1-2.1-5.0-2.0-1.0	99	270182	304523
HG005#2#JAHEPN010000023.1_51542210_51950070_0	HG005	304566	407788	1	612	0	0	611	103222	400752	297530	0-3-7-9-4-6-8-5-2-4-9-7-2-5-2-1	0.0-3.0-7.0-9.0-4.0-6.0-8.0-5.0-2.0-4.1-9.1-7.1-2.1-5.0-2.0-1.0	99	304467	407689
HG00621#1#JAHBCD010000034.1_2122997_2624098_1	HG00621	155	115516	0	672	0	0	671	115361	115361	0	0-3-7-9-4-6-8-5-2-4-9-7-2-5-2-4-9-7-2-5-2-1	0.0-3.0-7.0-9.0-4.0-6.0-8.0-5.0-2.0-4.1-9.1-7.1-2.1-5.1-2.0-4.1-9.1-7.1-2.1-5.1-2.0-1.0	155	0	115361
HG00621#1#JAHBCD010000034.1_2122997_2624098_1	HG00621	115607	138444	3	132	0	0	131	22837	138198	115361	0-3-7-9-4-6-8-5-2-4-9-7-2-5-2-4-9-7-2-5-2-1	0.0-3.0-7.0-9.0-4.0-6.0-8.0-5.0-2.0-4.1-9.1-7.1-2.1-5.1-2.0-4.1-9.1-7.1-2.1-5.1-2.0-1.0	155	115452	138289
HG00621#1#JAHBCD010000034.1_2122997_2624098_1	HG00621	139203	141243	7	12	0	0	11	2040	140238	138198	0-3-7-9-4-6-8-5-2-4-9-7-2-5-2-4-9-7-2-5-2-1	0.0-3.0-7.0-9.0-4.0-6.0-8.0-5.0-2.0-4.1-9.1-7.1-2.1-5.1-2.0-4.1-9.1-7.1-2.1-5.1-2.0-1.0	155	139048	141088
HG00621#1#JAHBCD010000034.1_2122997_2624098_1	HG00621	141187	142499	9	5	0	0	4	1312	141550	140238	0-3-7-9-4-6-8-5-2-4-9-7-2-5-2-4-9-7-2-5-2-1	0.0-3.0-7.0-9.0-4.0-6.0-8.0-5.0-2.0-4.1-9.1-7.1-2.1-5.1-2.0-4.1-9.1-7.1-2.1-5.1-2.0-1.0	155	141032	142344
HG00621#1#JAHBCD010000034.1_2122997_2624098_1	HG00621	142947	158743	4	84	0	0	83	15796	157346	141550	0-3-7-9-4-6-8-5-2-4-9-7-2-5-2-4-9-7-2-5-2-1	0.0-3.0-7.0-9.0-4.0-6.0-8.0-5.0-2.0-4.1-9.1-7.1-2.1-5.1-2.0-4.1-9.1-7.1-2.1-5.1-2.0-1.0	155	142792	158588
HG00621#1#JAHBCD010000034.1_2122997_2624098_1	HG00621	158687	161503	6	12	0	0	11	2816	160162	157346	0-3-7-9-4-6-8-5-2-4-9-7-2-5-2-4-9-7-2-5-2-1	0.0-3.0-7.0-9.0-4.0-6.0-8.0-5.0-2.0-4.1-9.1-7.1-2.1-5.1-2.0-4.1-9.1-7.1-2.1-5.1-2.0-1.0	155	158532	161348
HG00621#1#JAHBCD010000034.1_2122997_2624098_1	HG00621	161447	163217	8	8	0	0	7	1770	161932	160162	0-3-7-9-4-6-8-5-2-4-9-7-2-5-2-4-9-7-2-5-2-1	0.0-3.0-7.0-9.0-4.0-6.0-8.0-5.0-2.0-4.1-9.1-7.1-2.1-5.1-2.0-4.1-9.1-7.1-2.1-5.1-2.0-1.0	155	161292	163062
HG00621#1#JAHBCD010000034.1_2122997_2624098_1	HG00621	163161	175825	5	79	0	0	77	12664	174596	161932	0-3-7-9-4-6-8-5-2-4-9-7-2-5-2-4-9-7-2-5-2-1	0.0-3.0-7.0-9.0-4.0-6.0-8.0-5.0-2.0-4.1-9.1-7.1-2.1-5.1-2.0-4.1-9.1-7.1-2.1-5.1-2.0-1.0	155	163006	175670
HG00621#1#JAHBCD010000034.1_2122997_2624098_1	HG00621	176209	210152	2	196	0	0	194	33943	208539	174596	0-3-7-9-4-6-8-5-2-4-9-7-2-5-2-4-9-7-2-5-2-1	0.0-3.0-7.0-9.0-4.0-6.0-8.0-5.0-2.0-4.1-9.1-7.1-2.1-5.1-2.0-4.1-9.1-7.1-2.1-5.1-2.0-1.0	155	176054	209997
HG00621#1#JAHBCD010000034.1_2122997_2624098_1	HG00621	212403	223947	4	84	1	58	4	11544	220083	208539	0-3-7-9-4-6-8-5-2-4-9-7-2-5-2-4-9-7-2-5-2-1	0.0-3.0-7.0-9.0-4.0-6.0-8.0-5.0-2.0-4.1-9.1-7.1-2.1-5.1-2.0-4.1-9.1-7.1-2.1-5.1-2.0-1.0	155	212248	223792
HG00621#1#JAHBCD010000034.1_2122997_2624098_1	HG00621	225012	226323	9	5	1	4	0	1311	221394	220083	0-3-7-9-4-6-8-5-2-4-9-7-2-5-2-4-9-7-2-5-2-1	0.0-3.0-7.0-9.0-4.0-6.0-8.0-5.0-2.0-4.1-9.1-7.1-2.1-5.1-2.0-4.1-9.1-7.1-2.1-5.1-2.0-1.0	155	224857	226168
HG00621#1#JAHBCD010000034.1_2122997_2624098_1	HG00621	226267	228307	7	12	1	11	0	2040	223434	221394	0-3-7-9-4-6-8-5-2-4-9-7-2-5-2-4-9-7-2-5-2-1	0.0-3.0-7.0-9.0-4.0-6.0-8.0-5.0-2.0-4.1-9.1-7.1-2.1-5.1-2.0-4.1-9.1-7.1-2.1-5.1-2.0-1.0	155	226112	228152
HG00621#1#JAHBCD010000034.1_2122997_2624098_1	HG00621	229769	263729	2	196	1	194	0	33960	257394	223434	0-3-7-9-4-6-8-5-2-4-9-7-2-5-2-4-9-7-2-5-2-1	0.0-3.0-7.0-9.0-4.0-6.0-8.0-5.0-2.0-4.1-9.1-7.1-2.1-5.1-2.0-4.1-9.1-7.1-2.1-5.1-2.0-1.0	155	229614	263574
HG00621#1#JAHBCD010000034.1_2122997_2624098_1	HG00621	263673	275801	5	79	1	78	5	12128	269522	257394	0-3-7-9-4-6-8-5-2-4-9-7-2-5-2-4-9-7-2-5-2-1	0.0-3.0-7.0-9.0-4.0-6.0-8.0-5.0-2.0-4.1-9.1-7.1-2.1-5.1-2.0-4.1-9.1-7.1-2.1-5.1-2.0-1.0	155	263518	275646
HG00621#1#JAHBCD010000034.1_2122997_2624098_1	HG00621	276767	303957	2	196	0	39	191	27190	296712	269522	0-3-7-9-4-6-8-5-2-4-9-7-2-5-2-4-9-7-2-5-2-1	0.0-3.0-7.0-9.0-4.0-6.0-8.0-5.0-2.0-4.1-9.1-7.1-2.1-5.1-2.0-4.1-9.1-7.1-2.1-5.1-2.0-1.0	155	276612	303802
HG00621#1#JAHBCD010000034.1_2122997_2624098_1	HG00621	306549	318099	4	84	1	58	4	11550	308262	296712	0-3-7-9-4-6-8-5-2-4-9-7-2-5-2-4-9-7-2-5-2-1	0.0-3.0-7.0-9.0-4.0-6.0-8.0-5.0-2.0-4.1-9.1-7.1-2.1-5.1-2.0-4.1-9.1-7.1-2.1-5.1-2.0-1.0	155	306394	317944
HG00621#1#JAHBCD010000034.1_2122997_2624098_1	HG00621	319166	320477	9	5	1	4	0	1311	309573	308262	0-3-7-9-4-6-8-5-2-4-9-7-2-5-2-4-9-7-2-5-2-1	0.0-3.0-7.0-9.0-4.0-6.0-8.0-5.0-2.0-4.1-9.1-7.1-2.1-5.1-2.0-4.1-9.1-7.1-2.1-5.1-2.0-1.0	155	319011	320322
HG00621#1#JAHBCD010000034.1_2122997_2624098_1	HG00621	320421	322461	7	12	1	11	0	2040	311613	309573	0-3-7-9-4-6-8-5-2-4-9-7-2-5-2-4-9-7-2-5-2-1	0.0-3.0-7.0-9.0-4.0-6.0-8.0-5.0-2.0-4.1-9.1-7.1-2.1-5.1-2.0-4.1-9.1-7.1-2.1-5.1-2.0-1.0	155	320266	322306
HG00621#1#JAHBCD010000034.1_2122997_2624098_1	HG00621	323923	357883	2	196	1	194	0	33960	345573	311613	0-3-7-9-4-6-8-5-2-4-9-7-2-5-2-4-9-7-2-5-2-1	0.0-3.0-7.0-9.0-4.0-6.0-8.0-5.0-2.0-4.1-9.1-7.1-2.1-5.1-2.0-4.1-9.1-7.1-2.1-5.1-2.0-1.0	155	323768	357728
HG00621#1#JAHBCD010000034.1_2122997_2624098_1	HG00621	357827	369955	5	79	1	78	5	12128	357701	345573	0-3-7-9-4-6-8-5-2-4-9-7-2-5-2-4-9-7-2-5-2-1	0.0-3.0-7.0-9.0-4.0-6.0-8.0-5.0-2.0-4.1-9.1-7.1-2.1-5.1-2.0-4.1-9.1-7.1-2.1-5.1-2.0-1.0	155	357672	369800
HG00621#1#JAHBCD010000034.1_2122997_2624098_1	HG00621	370921	398837	2	196	0	39	195	27916	385617	357701	0-3-7-9-4-6-8-5-2-4-9-7-2-5-2-4-9-7-2-5-2-1	0.0-3.0-7.0-9.0-4.0-6.0-8.0-5.0-2.0-4.1-9.1-7.1-2.1-5.1-2.0-4.1-9.1-7.1-2.1-5.1-2.0-1.0	155	370766	398682
HG00621#1#JAHBCD010000034.1_2122997_2624098_1	HG00621	398781	500897	1	612	0	0	604	102116	487733	385617	0-3-7-9-4-6-8-5-2-4-9-7-2-5-2-4-9-7-2-5-2-1	0.0-3.0-7.0-9.0-4.0-6.0-8.0-5.0-2.0-4.1-9.1-7.1-2.1-5.1-2.0-4.1-9.1-7.1-2.1-5.1-2.0-1.0	155	398626	500742
HG00621#2#JAHBCC010000031.1_16669999_17077865_0	HG00621	99	115498	0	672	0	0	671	115399	115399	0	0-3-7-9-4-6-8-5-2-4-9-7-2-5-2-1	0.0-3.0-7.0-9.0-4.0-6.0-8.0-5.0-2.0-4.1-9.1-7.1-2.1-5.0-2.0-1.0	99	0	115399
HG00621#2#JAHBCC010000031.1_16669999_17077865_0	HG00621	115589	138426	3	132	0	0	131	22837	138236	115399	0-3-7-9-4-6-8-5-2-4-9-7-2-5-2-1	0.0-3.0-7.0-9.0-4.0-6.0-8.0-5.0-2.0-4.1-9.1-7.1-2.1-5.0-2.0-1.0	99	115490	138327
HG00621#2#JAHBCC010000031.1_16669999_17077865_0	HG00621	139185	141225	7	12	0	0	11	2040	140276	138236	0-3-7-9-4-6-8-5-2-4-9-7-2-5-2-1	0.0-3.0-7.0-9.0-4.0-6.0-8.0-5.0-2.0-4.1-9.1-7.1-2.1-5.0-2.0-1.0	99	139086	141126
HG00621#2#JAHBCC010000031.1_16669999_17077865_0	HG00621	141169	142481	9	5	0	0	4	1312	141588	140276	0-3-7-9-4-6-8-5-2-4-9-7-2-5-2-1	0.0-3.0-7.0-9.0-4.0-6.0-8.0-5.0-2.0-4.1-9.1-7.1-2.1-5.0-2.0-1.0	99	141070	142382
HG00621#2#JAHBCC010000031.1_16669999_17077865_0	HG00621	142929	158725	4	84	0	0	83	15796	157384	141588	0-3-7-9-4-6-8-5-2-4-9-7-2-5-2-1	0.0-3.0-7.0-9.0-4.0-6.0-8.0-5.0-2.0-4.1-9.1-7.1-2.1-5.0-2.0-1.0	99	142830	158626
HG00621#2#JAHBCC010000031.1_16669999_17077865_0	HG00621	158669	161485	6	12	0	0	11	2816	160200	157384	0-3-7-9-4-6-8-5-2-4-9-7-2-5-2-1	0.0-3.0-7.0-9.0-4.0-6.0-8.0-5.0-2.0-4.1-9.1-7.1-2.1-5.0-2.0-1.0	99	158570	161386
HG00621#2#JAHBCC010000031.1_16669999_17077865_0	HG00621	161429	163199	8	8	0	0	7	1770	161970	160200	0-3-7-9-4-6-8-5-2-4-9-7-2-5-2-1	0.0-3.0-7.0-9.0-4.0-6.0-8.0-5.0-2.0-4.1-9.1-7.1-2.1-5.0-2.0-1.0	99	161330	163100
HG00621#2#JAHBCC010000031.1_16669999_17077865_0	HG00621	163143	176247	5	79	0	0	78	13104	175074	161970	0-3-7-9-4-6-8-5-2-4-9-7-2-5-2-1	0.0-3.0-7.0-9.0-4.0-6.0-8.0-5.0-2.0-4.1-9.1-7.1-2.1-5.0-2.0-1.0	99	163044	176148
HG00621#2#JAHBCC010000031.1_16669999_17077865_0	HG00621	176191	210117	2	196	0	0	194	33926	209000	175074	0-3-7-9-4-6-8-5-2-4-9-7-2-5-2-1	0.0-3.0-7.0-9.0-4.0-6.0-8.0-5.0-2.0-4.1-9.1-7.1-2.1-5.0-2.0-1.0	99	176092	210018
HG00621#2#JAHBCC010000031.1_16669999_17077865_0	HG00621	212368	223914	4	84	1	58	4	11546	220546	209000	0-3-7-9-4-6-8-5-2-4-9-7-2-5-2-1	0.0-3.0-7.0-9.0-4.0-6.0-8.0-5.0-2.0-4.1-9.1-7.1-2.1-5.0-2.0-1.0	99	212269	223815
HG00621#2#JAHBCC010000031.1_16669999_17077865_0	HG00621	224983	226294	9	5	1	4	0	1311	221857	220546	0-3-7-9-4-6-8-5-2-4-9-7-2-5-2-1	0.0-3.0-7.0-9.0-4.0-6.0-8.0-5.0-2.0-4.1-9.1-7.1-2.1-5.0-2.0-1.0	99	224884	226195
HG00621#2#JAHBCC010000031.1_16669999_17077865_0	HG00621	226238	228278	7	12	1	11	0	2040	223897	221857	0-3-7-9-4-6-8-5-2-4-9-7-2-5-2-1	0.0-3.0-7.0-9.0-4.0-6.0-8.0-5.0-2.0-4.1-9.1-7.1-2.1-5.0-2.0-1.0	99	226139	228179
HG00621#2#JAHBCC010000031.1_16669999_17077865_0	HG00621	229740	257267	2	196	1	194	39	27527	251424	223897	0-3-7-9-4-6-8-5-2-4-9-7-2-5-2-1	0.0-3.0-7.0-9.0-4.0-6.0-8.0-5.0-2.0-4.1-9.1-7.1-2.1-5.0-2.0-1.0	99	229641	257168
HG00621#2#JAHBCC010000031.1_16669999_17077865_0	HG00621	258233	269921	5	79	0	5	77	11688	263112	251424	0-3-7-9-4-6-8-5-2-4-9-7-2-5-2-1	0.0-3.0-7.0-9.0-4.0-6.0-8.0-5.0-2.0-4.1-9.1-7.1-2.1-5.0-2.0-1.0	99	258134	269822
HG00621#2#JAHBCC010000031.1_16669999_17077865_0	HG00621	270528	304635	2	196	0	1	195	34107	297219	263112	0-3-7-9-4-6-8-5-2-4-9-7-2-5-2-1	0.0-3.0-7.0-9.0-4.0-6.0-8.0-5.0-2.0-4.1-9.1-7.1-2.1-5.0-2.0-1.0	99	270429	304536
HG00621#2#JAHBCC010000031.1_16669999_17077865_0	HG00621	304579	407794	1	612	0	0	611	103215	400434	297219	0-3-7-9-4-6-8-5-2-4-9-7-2-5-2-1	0.0-3.0-7.0-9.0-4.0-6.0-8.0-5.0-2.0-4.1-9.1-7.1-2.1-5.0-2.0-1.0	99	304480	407695
HG00733#1#JAHEPQ010000019.1_46106835_46420495_0	HG00733	99	115407	0	672	0	0	671	115308	115308	0	0-3-7-9-4-6-8-5-2-1	0.0-3.0-7.0-9.0-4.0-6.0-8.0-5.0-2.0-1.0	99	0	115308
HG00733#1#JAHEPQ010000019.1_46106835_46420495_0	HG00733	115498	138333	3	132	0	0	131	22835	138143	115308	0-3-7-9-4-6-8-5-2-1	0.0-3.0-7.0-9.0-4.0-6.0-8.0-5.0-2.0-1.0	99	115399	138234
HG00733#1#JAHEPQ010000019.1_46106835_46420495_0	HG00733	139092	141132	7	12	0	0	11	2040	140183	138143	0-3-7-9-4-6-8-5-2-1	0.0-3.0-7.0-9.0-4.0-6.0-8.0-5.0-2.0-1.0	99	138993	141033
HG00733#1#JAHEPQ010000019.1_46106835_46420495_0	HG00733	141076	142388	9	5	0	0	4	1312	141495	140183	0-3-7-9-4-6-8-5-2-1	0.0-3.0-7.0-9.0-4.0-6.0-8.0-5.0-2.0-1.0	99	140977	142289
HG00733#1#JAHEPQ010000019.1_46106835_46420495_0	HG00733	142836	158631	4	84	0	0	83	15795	157290	141495	0-3-7-9-4-6-8-5-2-1	0.0-3.0-7.0-9.0-4.0-6.0-8.0-5.0-2.0-1.0	99	142737	158532
HG00733#1#JAHEPQ010000019.1_46106835_46420495_0	HG00733	158575	161392	6	12	0	0	11	2817	160107	157290	0-3-7-9-4-6-8-5-2-1	0.0-3.0-7.0-9.0-4.0-6.0-8.0-5.0-2.0-1.0	99	158476	161293
HG00733#1#JAHEPQ010000019.1_46106835_46420495_0	HG00733	161336	163106	8	8	0	0	7	1770	161877	160107	0-3-7-9-4-6-8-5-2-1	0.0-3.0-7.0-9.0-4.0-6.0-8.0-5.0-2.0-1.0	99	161237	163007
HG00733#1#JAHEPQ010000019.1_46106835_46420495_0	HG00733	163050	176154	5	79	0	0	78	13104	174981	161877	0-3-7-9-4-6-8-5-2-1	0.0-3.0-7.0-9.0-4.0-6.0-8.0-5.0-2.0-1.0	99	162951	176055
HG00733#1#JAHEPQ010000019.1_46106835_46420495_0	HG00733	176098	210420	2	196	0	0	195	34322	209303	174981	0-3-7-9-4-6-8-5-2-1	0.0-3.0-7.0-9.0-4.0-6.0-8.0-5.0-2.0-1.0	99	175999	210321
HG00733#1#JAHEPQ010000019.1_46106835_46420495_0	HG00733	210364	313272	1	612	0	0	608	102908	312211	209303	0-3-7-9-4-6-8-5-2-1	0.0-3.0-7.0-9.0-4.0-6.0-8.0-5.0-2.0-1.0	99	210265	313173
HG00741#1#JAHALY010000007.1_18781197_19307680_1	HG00741	154	115531	0	672	0	0	671	115377	115377	0	0-3-7-9-4-6-8-5-2-4-0-3-7-9-4-6-8-5-2-4-4-2-5-2-1	0.0-3.0-7.0-9.0-4.0-6.0-8.0-5.0-2.0-4.1-0.0-3.0-7.0-9.0-4.0-6.0-8.0-5.0-2.0-4.1-4.0-2.1-5.0-2.0-1.0	154	0	115377
HG00741#1#JAHALY010000007.1_18781197_19307680_1	HG00741	115622	138454	3	132	0	0	131	22832	138209	115377	0-3-7-9-4-6-8-5-2-4-0-3-7-9-4-6-8-5-2-4-4-2-5-2-1	0.0-3.0-7.0-9.0-4.0-6.0-8.0-5.0-2.0-4.1-0.0-3.0-7.0-9.0-4.0-6.0-8.0-5.0-2.0-4.1-4.0-2.1-5.0-2.0-1.0	154	115468	138300
HG00741#1#JAHALY010000007.1_18781197_19307680_1	HG00741	139213	141254	7	12	0	0	11	2041	140250	138209	0-3-7-9-4-6-8-5-2-4-0-3-7-9-4-6-8-5-2-4-4-2-5-2-1	0.0-3.0-7.0-9.0-4.0-6.0-8.0-5.0-2.0-4.1-0.0-3.0-7.0-9.0-4.0-6.0-8.0-5.0-2.0-4.1-4.0-2.1-5.0-2.0-1.0	154	139059	141100
HG00741#1#JAHALY010000007.1_18781197_19307680_1	HG00741	141198	142509	9	5	0	0	4	1311	141561	140250	0-3-7-9-4-6-8-5-2-4-0-3-7-9-4-6-8-5-2-4-4-2-5-2-1	0.0-3.0-7.0-9.0-4.0-6.0-8.0-5.0-2.0-4.1-0.0-3.0-7.0-9.0-4.0-6.0-8.0-5.0-2.0-4.1-4.0-2.1-5.0-2.0-1.0	154	141044	142355
HG00741#1#JAHALY010000007.1_18781197_19307680_1	HG00741	142957	158766	4	84	0	0	83	15809	157370	141561	0-3-7-9-4-6-8-5-2-4-0-3-7-9-4-6-8-5-2-4-4-2-5-2-1	0.0-3.0-7.0-9.0-4.0-6.0-8.0-5.0-2.0-4.1-0.0-3.0-7.0-9.0-4.0-6.0-8.0-5.0-2.0-4.1-4.0-2.1-5.0-2.0-1.0	154	142803	158612
HG00741#1#JAHALY010000007.1_18781197_19307680_1	HG00741	158710	161525	6	12	0	0	11	2815	160185	157370	0-3-7-9-4-6-8-5-2-4-0-3-7-9-4-6-8-5-2-4-4-2-5-2-1	0.0-3.0-7.0-9.0-4.0-6.0-8.0-5.0-2.0-4.1-0.0-3.0-7.0-9.0-4.0-6.0-8.0-5.0-2.0-4.1-4.0-2.1-5.0-2.0-1.0	154	158556	161371
HG00741#1#JAHALY010000007.1_18781197_19307680_1	HG00741	161469	163239	8	8	0	0	7	1770	161955	160185	0-3-7-9-4-6-8-5-2-4-0-3-7-9-4-6-8-5-2-4-4-2-5-2-1	0.0-3.0-7.0-9.0-4.0-6.0-8.0-5.0-2.0-4.1-0.0-3.0-7.0-9.0-4.0-6.0-8.0-5.0-2.0-4.1-4.0-2.1-5.0-2.0-1.0	154	161315	163085
HG00741#1#JAHALY010000007.1_18781197_19307680_1	HG00741	163183	176287	5	79	0	0	78	13104	175059	161955	0-3-7-9-4-6-8-5-2-4-0-3-7-9-4-6-8-5-2-4-4-2-5-2-1	0.0-3.0-7.0-9.0-4.0-6.0-8.0-5.0-2.0-4.1-0.0-3.0-7.0-9.0-4.0-6.0-8.0-5.0-2.0-4.1-4.0-2.1-5.0-2.0-1.0	154	163029	176133
HG00741#1#JAHALY010000007.1_18781197_19307680_1	HG00741	176231	210539	2	196	0	0	195	34308	209367	175059	0-3-7-9-4-6-8-5-2-4-0-3-7-9-4-6-8-5-2-4-4-2-5-2-1	0.0-3.0-7.0-9.0-4.0-6.0-8.0-5.0-2.0-4.1-0.0-3.0-7.0-9.0-4.0-6.0-8.0-5.0-2.0-4.1-4.0-2.1-5.0-2.0-1.0	154	176077	210385
HG00741#1#JAHALY010000007.1_18781197_19307680_1	HG00741	212405	220885	4	84	1	58	22	8480	217847	209367	0-3-7-9-4-6-8-5-2-4-0-3-7-9-4-6-8-5-2-4-4-2-5-2-1	0.0-3.0-7.0-9.0-4.0-6.0-8.0-5.0-2.0-4.1-0.0-3.0-7.0-9.0-4.0-6.0-8.0-5.0-2.0-4.1-4.0-2.1-5.0-2.0-1.0	154	212251	220731
HG00741#1#JAHALY010000007.1_18781197_19307680_1	HG00741	221062	231273	0	672	0	604	671	10211	228058	217847	0-3-7-9-4-6-8-5-2-4-0-3-7-9-4-6-8-5-2-4-4-2-5-2-1	0.0-3.0-7.0-9.0-4.0-6.0-8.0-5.0-2.0-4.1-0.0-3.0-7.0-9.0-4.0-6.0-8.0-5.0-2.0-4.1-4.0-2.1-5.0-2.0-1.0	154	220908	231119
HG00741#1#JAHALY010000007.1_18781197_19307680_1	HG00741	231364	254196	3	132	0	0	131	22832	250890	228058	0-3-7-9-4-6-8-5-2-4-0-3-7-9-4-6-8-5-2-4-4-2-5-2-1	0.0-3.0-7.0-9.0-4.0-6.0-8.0-5.0-2.0-4.1-0.0-3.0-7.0-9.0-4.0-6.0-8.0-5.0-2.0-4.1-4.0-2.1-5.0-2.0-1.0	154	231210	254042
HG00741#1#JAHALY010000007.1_18781197_19307680_1	HG00741	254955	256996	7	12	0	0	11	2041	252931	250890	0-3-7-9-4-6-8-5-2-4-0-3-7-9-4-6-8-5-2-4-4-2-5-2-1	0.0-3.0-7.0-9.0-4.0-6.0-8.0-5.0-2.0-4.1-0.0-3.0-7.0-9.0-4.0-6.0-8.0-5.0-2.0-4.1-4.0-2.1-5.0-2.0-1.0	154	254801	256842
HG00741#1#JAHALY010000007.1_18781197_19307680_1	HG00741	256940	258251	9	5	0	0	4	1311	254242	252931	0-3-7-9-4-6-8-5-2-4-0-3-7-9-4-6-8-5-2-4-4-2-5-2-1	0.0-3.0-7.0-9.0-4.0-6.0-8.0-5.0-2.0-4.1-0.0-3.0-7.0-9.0-4.0-6.0-8.0-5.0-2.0-4.1-4.0-2.1-5.0-2.0-1.0	154	256786	258097
HG00741#1#JAHALY010000007.1_18781197_19307680_1	HG00741	258699	274510	4	84	0	0	83	15811	270053	254242	0-3-7-9-4-6-8-5-2-4-0-3-7-9-4-6-8-5-2-4-4-2-5-2-1	0.0-3.0-7.0-9.0-4.0-6.0-8.0-5.0-2.0-4.1-0.0-3.0-7.0-9.0-4.0-6.0-8.0-5.0-2.0-4.1-4.0-2.1-5.0-2.0-1.0	154	258545	274356
HG00741#1#JAHALY010000007.1_18781197_19307680_1	HG00741	274454	277269	6	12	0	0	11	2815	272868	270053	0-3-7-9-4-6-8-5-2-4-0-3-7-9-4-6-8-5-2-4-4-2-5-2-1	0.0-3.0-7.0-9.0-4.0-6.0-8.0-5.0-2.0-4.1-0.0-3.0-7.0-9.0-4.0-6.0-8.0-5.0-2.0-4.1-4.0-2.1-5.0-2.0-1.0	154	274300	277115
HG00741#1#JAHALY010000007.1_18781197_19307680_1	HG00741	277213	278983	8	8	0	0	7	1770	274638	272868	0-3-7-9-4-6-8-5-2-4-0-3-7-9-4-6-8-5-2-4-4-2-5-2-1	0.0-3.0-7.0-9.0-4.0-6.0-8.0-5.0-2.0-4.1-0.0-3.0-7.0-9.0-4.0-6.0-8.0-5.0-2.0-4.1-4.0-2.1-5.0-2.0-1.0	154	277059	278829
HG00741#1#JAHALY010000007.1_18781197_19307680_1	HG00741	278927	292066	5	79	0	0	78	13139	287777	274638	0-3-7-9-4-6-8-5-2-4-0-3-7-9-4-6-8-5-2-4-4-2-5-2-1	0.0-3.0-7.0-9.0-4.0-6.0-8.0-5.0-2.0-4.1-0.0-3.0-7.0-9.0-4.0-6.0-8.0-5.0-2.0-4.1-4.0-2.1-5.0-2.0-1.0	154	278773	291912
HG00741#1#JAHALY010000007.1_18781197_19307680_1	HG00741	292010	326321	2	196	0	0	195	34311	322088	287777	0-3-7-9-4-6-8-5-2-4-0-3-7-9-4-6-8-5-2-4-4-2-5-2-1	0.0-3.0-7.0-9.0-4.0-6.0-8.0-5.0-2.0-4.1-0.0-3.0-7.0-9.0-4.0-6.0-8.0-5.0-2.0-4.1-4.0-2.1-5.0-2.0-1.0	154	291856	326167
HG00741#1#JAHALY010000007.1_18781197_19307680_1	HG00741	328187	336668	4	84	1	58	22	8481	330569	322088	0-3-7-9-4-6-8-5-2-4-0-3-7-9-4-6-8-5-2-4-4-2-5-2-1	0.0-3.0-7.0-9.0-4.0-6.0-8.0-5.0-2.0-4.1-0.0-3.0-7.0-9.0-4.0-6.0-8.0-5.0-2.0-4.1-4.0-2.1-5.0-2.0-1.0	154	328033	336514
HG00741#1#JAHALY010000007.1_18781197_19307680_1	HG00741	336976	346209	4	84	0	20	58	9233	339802	330569	0-3-7-9-4-6-8-5-2-4-0-3-7-9-4-6-8-5-2-4-4-2-5-2-1	0.0-3.0-7.0-9.0-4.0-6.0-8.0-5.0-2.0-4.1-0.0-3.0-7.0-9.0-4.0-6.0-8.0-5.0-2.0-4.1-4.0-2.1-5.0-2.0-1.0	154	336822	346055
HG00741#1#JAHALY010000007.1_18781197_19307680_1	HG00741	348075	375982	2	196	1	195	39	27907	367709	339802	0-3-7-9-4-6-8-5-2-4-0-3-7-9-4-6-8-5-2-4-4-2-5-2-1	0.0-3.0-7.0-9.0-4.0-6.0-8.0-5.0-2.0-4.1-0.0-3.0-7.0-9.0-4.0-6.0-8.0-5.0-2.0-4.1-4.0-2.1-5.0-2.0-1.0	154	347921	375828
HG00741#1#JAHALY010000007.1_18781197_19307680_1	HG00741	376421	389076	5	79	0	3	78	12655	380364	367709	0-3-7-9-4-6-8-5-2-4-0-3-7-9-4-6-8-5-2-4-4-2-5-2-1	0.0-3.0-7.0-9.0-4.0-6.0-8.0-5.0-2.0-4.1-0.0-3.0-7.0-9.0-4.0-6.0-8.0-5.0-2.0-4.1-4.0-2.1-5.0-2.0-1.0	154	376267	388922
HG00741#1#JAHALY010000007.1_18781197_19307680_1	HG00741	389020	423341	2	196	0	0	195	34321	414685	380364	0-3-7-9-4-6-8-5-2-4-0-3-7-9-4-6-8-5-2-4-4-2-5-2-1	0.0-3.0-7.0-9.0-4.0-6.0-8.0-5.0-2.0-4.1-0.0-3.0-7.0-9.0-4.0-6.0-8.0-5.0-2.0-4.1-4.0-2.1-5.0-2.0-1.0	154	388866	423187
HG00741#1#JAHALY010000007.1_18781197_19307680_1	HG00741	423285	526467	1	612	0	0	611	103182	517867	414685	0-3-7-9-4-6-8-5-2-4-0-3-7-9-4-6-8-5-2-4-4-2-5-2-1	0.0-3.0-7.0-9.0-4.0-6.0-8.0-5.0-2.0-4.1-0.0-3.0-7.0-9.0-4.0-6.0-8.0-5.0-2.0-4.1-4.0-2.1-5.0-2.0-1.0	154	423131	526313
HG00741#2#JAHALX010000013.1_51574319_51981226_0	HG00741	98	115506	0	672	0	0	671	115408	115408	0	0-3-7-9-4-6-8-5-2-7-9-4-2-5-2-1	0.0-3.0-7.0-9.0-4.0-6.0-8.0-5.0-2.0-7.0-9.0-4.0-2.1-5.1-2.0-1.0	98	0	115408
HG00741#2#JAHALX010000013.1_51574319_51981226_0	HG00741	115597	138431	3	132	0	0	131	22834	138242	115408	0-3-7-9-4-6-8-5-2-7-9-4-2-5-2-1	0.0-3.0-7.0-9.0-4.0-6.0-8.0-5.0-2.0-7.0-9.0-4.0-2.1-5.1-2.0-1.0	98	115499	138333
HG00741#2#JAHALX010000013.1_51574319_51981226_0	HG00741	139190	141230	7	12	0	0	11	2040	140282	138242	0-3-7-9-4-6-8-5-2-7-9-4-2-5-2-1	0.0-3.0-7.0-9.0-4.0-6.0-8.0-5.0-2.0-7.0-9.0-4.0-2.1-5.1-2.0-1.0	98	139092	141132
HG00741#2#JAHALX010000013.1_51574319_51981226_0	HG00741	141174	142486	9	5	0	0	4	1312	141594	140282	0-3-7-9-4-6-8-5-2-7-9-4-2-5-2-1	0.0-3.0-7.0-9.0-4.0-6.0-8.0-5.0-2.0-7.0-9.0-4.0-2.1-5.1-2.0-1.0	98	141076	142388
HG00741#2#JAHALX010000013.1_51574319_51981226_0	HG00741	142934	158721	4	84	0	0	83	15787	157381	141594	0-3-7-9-4-6-8-5-2-7-9-4-2-5-2-1	0.0-3.0-7.0-9.0-4.0-6.0-8.0-5.0-2.0-7.0-9.0-4.0-2.1-5.1-2.0-1.0	98	142836	158623
HG00741#2#JAHALX010000013.1_51574319_51981226_0	HG00741	158665	161480	6	12	0	0	11	2815	160196	157381	0-3-7-9-4-6-8-5-2-7-9-4-2-5-2-1	0.0-3.0-7.0-9.0-4.0-6.0-8.0-5.0-2.0-7.0-9.0-4.0-2.1-5.1-2.0-1.0	98	158567	161382
HG00741#2#JAHALX010000013.1_51574319_51981226_0	HG00741	161424	163194	8	8	0	0	7	1770	161966	160196	0-3-7-9-4-6-8-5-2-7-9-4-2-5-2-1	0.0-3.0-7.0-9.0-4.0-6.0-8.0-5.0-2.0-7.0-9.0-4.0-2.1-5.1-2.0-1.0	98	161326	163096
HG00741#2#JAHALX010000013.1_51574319_51981226_0	HG00741	163138	175802	5	79	0	0	77	12664	174630	161966	0-3-7-9-4-6-8-5-2-7-9-4-2-5-2-1	0.0-3.0-7.0-9.0-4.0-6.0-8.0-5.0-2.0-7.0-9.0-4.0-2.1-5.1-2.0-1.0	98	163040	175704
HG00741#2#JAHALX010000013.1_51574319_51981226_0	HG00741	176409	210520	2	196	0	1	195	34111	208741	174630	0-3-7-9-4-6-8-5-2-7-9-4-2-5-2-1	0.0-3.0-7.0-9.0-4.0-6.0-8.0-5.0-2.0-7.0-9.0-4.0-2.1-5.1-2.0-1.0	98	176311	210422
HG00741#2#JAHALX010000013.1_51574319_51981226_0	HG00741	211597	213637	7	12	0	0	11	2040	210781	208741	0-3-7-9-4-6-8-5-2-7-9-4-2-5-2-1	0.0-3.0-7.0-9.0-4.0-6.0-8.0-5.0-2.0-7.0-9.0-4.0-2.1-5.1-2.0-1.0	98	211499	213539
HG00741#2#JAHALX010000013.1_51574319_51981226_0	HG00741	213581	214893	9	5	0	0	4	1312	212093	210781	0-3-7-9-4-6-8-5-2-7-9-4-2-5-2-1	0.0-3.0-7.0-9.0-4.0-6.0-8.0-5.0-2.0-7.0-9.0-4.0-2.1-5.1-2.0-1.0	98	213483	214795
HG00741#2#JAHALX010000013.1_51574319_51981226_0	HG00741	215956	227501	4	84	0	4	58	11545	223638	212093	0-3-7-9-4-6-8-5-2-7-9-4-2-5-2-1	0.0-3.0-7.0-9.0-4.0-6.0-8.0-5.0-2.0-7.0-9.0-4.0-2.1-5.1-2.0-1.0	98	215858	227403
HG00741#2#JAHALX010000013.1_51574319_51981226_0	HG00741	229367	263475	2	196	1	195	1	34108	257746	223638	0-3-7-9-4-6-8-5-2-7-9-4-2-5-2-1	0.0-3.0-7.0-9.0-4.0-6.0-8.0-5.0-2.0-7.0-9.0-4.0-2.1-5.1-2.0-1.0	98	229269	263377
HG00741#2#JAHALX010000013.1_51574319_51981226_0	HG00741	264082	276297	5	79	1	77	3	12215	269961	257746	0-3-7-9-4-6-8-5-2-7-9-4-2-5-2-1	0.0-3.0-7.0-9.0-4.0-6.0-8.0-5.0-2.0-7.0-9.0-4.0-2.1-5.1-2.0-1.0	98	263984	276199
HG00741#2#JAHALX010000013.1_51574319_51981226_0	HG00741	276736	304649	2	196	0	39	195	27913	297874	269961	0-3-7-9-4-6-8-5-2-7-9-4-2-5-2-1	0.0-3.0-7.0-9.0-4.0-6.0-8.0-5.0-2.0-7.0-9.0-4.0-2.1-5.1-2.0-1.0	98	276638	304551
HG00741#2#JAHALX010000013.1_51574319_51981226_0	HG00741	304593	406963	1	612	0	0	606	102370	400244	297874	0-3-7-9-4-6-8-5-2-7-9-4-2-5-2-1	0.0-3.0-7.0-9.0-4.0-6.0-8.0-5.0-2.0-7.0-9.0-4.0-2.1-5.1-2.0-1.0	98	304495	406865
HG01071#1#JAHBCF010000053.1_26607100_27108065_1	HG01071	155	115478	0	672	0	0	671	115323	115323	0	0-3-7-9-4-6-8-5-2-4-9-7-2-5-2-7-9-4-2-5-2-1	0.0-3.0-7.0-9.0-4.0-6.0-8.0-5.0-2.0-4.1-9.1-7.1-2.1-5.0-2.0-7.0-9.0-4.0-2.1-5.1-2.0-1.0	155	0	115323
HG01071#1#JAHBCF010000053.1_26607100_27108065_1	HG01071	115569	138405	3	132	0	0	131	22836	138159	115323	0-3-7-9-4-6-8-5-2-4-9-7-2-5-2-7-9-4-2-5-2-1	0.0-3.0-7.0-9.0-4.0-6.0-8.0-5.0-2.0-4.1-9.1-7.1-2.1-5.0-2.0-7.0-9.0-4.0-2.1-5.1-2.0-1.0	155	115414	138250
HG01071#1#JAHBCF010000053.1_26607100_27108065_1	HG01071	139164	141204	7	12	0	0	11	2040	140199	138159	0-3-7-9-4-6-8-5-2-4-9-7-2-5-2-7-9-4-2-5-2-1	0.0-3.0-7.0-9.0-4.0-6.0-8.0-5.0-2.0-4.1-9.1-7.1-2.1-5.0-2.0-7.0-9.0-4.0-2.1-5.1-2.0-1.0	155	139009	141049
HG01071#1#JAHBCF010000053.1_26607100_27108065_1	HG01071	141148	142460	9	5	0	0	4	1312	141511	140199	0-3-7-9-4-6-8-5-2-4-9-7-2-5-2-7-9-4-2-5-2-1	0.0-3.0-7.0-9.0-4.0-6.0-8.0-5.0-2.0-4.1-9.1-7.1-2.1-5.0-2.0-7.0-9.0-4.0-2.1-5.1-2.0-1.0	155	140993	142305
HG01071#1#JAHBCF010000053.1_26607100_27108065_1	HG01071	142908	158706	4	84	0	0	83	15798	157309	141511	0-3-7-9-4-6-8-5-2-4-9-7-2-5-2-7-9-4-2-5-2-1	0.0-3.0-7.0-9.0-4.0-6.0-8.0-5.0-2.0-4.1-9.1-7.1-2.1-5.0-2.0-7.0-9.0-4.0-2.1-5.1-2.0-1.0	155	142753	158551
HG01071#1#JAHBCF010000053.1_26607100_27108065_1	HG01071	158650	161466	6	12	0	0	11	2816	160125	157309	0-3-7-9-4-6-8-5-2-4-9-7-2-5-2-7-9-4-2-5-2-1	0.0-3.0-7.0-9.0-4.0-6.0-8.0-5.0-2.0-4.1-9.1-7.1-2.1-5.0-2.0-7.0-9.0-4.0-2.1-5.1-2.0-1.0	155	158495	161311
HG01071#1#JAHBCF010000053.1_26607100_27108065_1	HG01071	161410	163180	8	8	0	0	7	1770	161895	160125	0-3-7-9-4-6-8-5-2-4-9-7-2-5-2-7-9-4-2-5-2-1	0.0-3.0-7.0-9.0-4.0-6.0-8.0-5.0-2.0-4.1-9.1-7.1-2.1-5.0-2.0-7.0-9.0-4.0-2.1-5.1-2.0-1.0	155	161255	163025
HG01071#1#JAHBCF010000053.1_26607100_27108065_1	HG01071	163124	176228	5	79	0	0	78	13104	174999	161895	0-3-7-9-4-6-8-5-2-4-9-7-2-5-2-7-9-4-2-5-2-1	0.0-3.0-7.0-9.0-4.0-6.0-8.0-5.0-2.0-4.1-9.1-7.1-2.1-5.0-2.0-7.0-9.0-4.0-2.1-5.1-2.0-1.0	155	162969	176073
HG01071#1#JAHBCF010000053.1_26607100_27108065_1	HG01071	176172	210112	2	196	0	0	194	33940	208939	174999	0-3-7-9-4-6-8-5-2-4-9-7-2-5-2-7-9-4-2-5-2-1	0.0-3.0-7.0-9.0-4.0-6.0-8.0-5.0-2.0-4.1-9.1-7.1-2.1-5.0-2.0-7.0-9.0-4.0-2.1-5.1-2.0-1.0	155	176017	209957
HG01071#1#JAHBCF010000053.1_26607100_27108065_1	HG01071	212363	223909	4	84	1	58	4	11546	220485	208939	0-3-7-9-4-6-8-5-2-4-9-7-2-5-2-7-9-4-2-5-2-1	0.0-3.0-7.0-9.0-4.0-6.0-8.0-5.0-2.0-4.1-9.1-7.1-2.1-5.0-2.0-7.0-9.0-4.0-2.1-5.1-2.0-1.0	155	212208	223754
HG01071#1#JAHBCF010000053.1_26607100_27108065_1	HG01071	224974	226285	9	5	1	4	0	1311	221796	220485	0-3-7-9-4-6-8-5-2-4-9-7-2-5-2-7-9-4-2-5-2-1	0.0-3.0-7.0-9.0-4.0-6.0-8.0-5.0-2.0-4.1-9.1-7.1-2.1-5.0-2.0-7.0-9.0-4.0-2.1-5.1-2.0-1.0	155	224819	226130
HG01071#1#JAHBCF010000053.1_26607100_27108065_1	HG01071	226229	228269	7	12	1	11	0	2040	223836	221796	0-3-7-9-4-6-8-5-2-4-9-7-2-5-2-7-9-4-2-5-2-1	0.0-3.0-7.0-9.0-4.0-6.0-8.0-5.0-2.0-4.1-9.1-7.1-2.1-5.0-2.0-7.0-9.0-4.0-2.1-5.1-2.0-1.0	155	226074	228114
HG01071#1#JAHBCF010000053.1_26607100_27108065_1	HG01071	229731	257259	2	196	1	194	39	27528	251364	223836	0-3-7-9-4-6-8-5-2-4-9-7-2-5-2-7-9-4-2-5-2-1	0.0-3.0-7.0-9.0-4.0-6.0-8.0-5.0-2.0-4.1-9.1-7.1-2.1-5.0-2.0-7.0-9.0-4.0-2.1-5.1-2.0-1.0	155	229576	257104
HG01071#1#JAHBCF010000053.1_26607100_27108065_1	HG01071	258225	269913	5	79	0	5	77	11688	263052	251364	0-3-7-9-4-6-8-5-2-4-9-7-2-5-2-7-9-4-2-5-2-1	0.0-3.0-7.0-9.0-4.0-6.0-8.0-5.0-2.0-4.1-9.1-7.1-2.1-5.0-2.0-7.0-9.0-4.0-2.1-5.1-2.0-1.0	155	258070	269758
HG01071#1#JAHBCF010000053.1_26607100_27108065_1	HG01071	270520	304623	2	196	0	1	195	34103	297155	263052	0-3-7-9-4-6-8-5-2-4-9-7-2-5-2-7-9-4-2-5-2-1	0.0-3.0-7.0-9.0-4.0-6.0-8.0-5.0-2.0-4.1-9.1-7.1-2.1-5.0-2.0-7.0-9.0-4.0-2.1-5.1-2.0-1.0	155	270365	304468
HG01071#1#JAHBCF010000053.1_26607100_27108065_1	HG01071	305700	307740	7	12	0	0	11	2040	299195	297155	0-3-7-9-4-6-8-5-2-4-9-7-2-5-2-7-9-4-2-5-2-1	0.0-3.0-7.0-9.0-4.0-6.0-8.0-5.0-2.0-4.1-9.1-7.1-2.1-5.0-2.0-7.0-9.0-4.0-2.1-5.1-2.0-1.0	155	305545	307585
HG01071#1#JAHBCF010000053.1_26607100_27108065_1	HG01071	307684	308996	9	5	0	0	4	1312	300507	299195	0-3-7-9-4-6-8-5-2-4-9-7-2-5-2-7-9-4-2-5-2-1	0.0-3.0-7.0-9.0-4.0-6.0-8.0-5.0-2.0-4.1-9.1-7.1-2.1-5.0-2.0-7.0-9.0-4.0-2.1-5.1-2.0-1.0	155	307529	308841
HG01071#1#JAHBCF010000053.1_26607100_27108065_1	HG01071	310059	321608	4	84	0	4	58	11549	312056	300507	0-3-7-9-4-6-8-5-2-4-9-7-2-5-2-7-9-4-2-5-2-1	0.0-3.0-7.0-9.0-4.0-6.0-8.0-5.0-2.0-4.1-9.1-7.1-2.1-5.0-2.0-7.0-9.0-4.0-2.1-5.1-2.0-1.0	155	309904	321453
HG01071#1#JAHBCF010000053.1_26607100_27108065_1	HG01071	323474	357580	2	196	1	195	1	34106	346162	312056	0-3-7-9-4-6-8-5-2-4-9-7-2-5-2-7-9-4-2-5-2-1	0.0-3.0-7.0-9.0-4.0-6.0-8.0-5.0-2.0-4.1-9.1-7.1-2.1-5.0-2.0-7.0-9.0-4.0-2.1-5.1-2.0-1.0	155	323319	357425
HG01071#1#JAHBCF010000053.1_26607100_27108065_1	HG01071	358187	370402	5	79	1	77	3	12215	358377	346162	0-3-7-9-4-6-8-5-2-4-9-7-2-5-2-7-9-4-2-5-2-1	0.0-3.0-7.0-9.0-4.0-6.0-8.0-5.0-2.0-4.1-9.1-7.1-2.1-5.0-2.0-7.0-9.0-4.0-2.1-5.1-2.0-1.0	155	358032	370247
HG01071#1#JAHBCF010000053.1_26607100_27108065_1	HG01071	370840	398757	2	196	0	39	195	27917	386294	358377	0-3-7-9-4-6-8-5-2-4-9-7-2-5-2-7-9-4-2-5-2-1	0.0-3.0-7.0-9.0-4.0-6.0-8.0-5.0-2.0-4.1-9.1-7.1-2.1-5.0-2.0-7.0-9.0-4.0-2.1-5.1-2.0-1.0	155	370685	398602
HG01071#1#JAHBCF010000053.1_26607100_27108065_1	HG01071	398701	500903	1	612	0	0	605	102202	488496	386294	0-3-7-9-4-6-8-5-2-4-9-7-2-5-2-7-9-4-2-5-2-1	0.0-3.0-7.0-9.0-4.0-6.0-8.0-5.0-2.0-4.1-9.1-7.1-2.1-5.0-2.0-7.0-9.0-4.0-2.1-5.1-2.0-1.0	155	398546	500748
HG01099.verkko_filt_mat.fa:haplotype1-0000034_142513097_142920876_1	HG01099.verkko_filt_mat.fa:haplotype1-0000034_142513097_142920876_1	154	115523	0	672	0	0	671	115369	115369	0	0-3-7-9-4-6-8-5-2-4-9-7-2-5-2-1	0.0-3.0-7.0-9.0-4.0-6.0-8.0-5.0-2.0-4.1-9.1-7.1-2.1-5.1-2.0-1.0	154	0	115369
HG01099.verkko_filt_mat.fa:haplotype1-0000034_142513097_142920876_1	HG01099.verkko_filt_mat.fa:haplotype1-0000034_142513097_142920876_1	115614	138445	3	132	0	0	131	22831	138200	115369	0-3-7-9-4-6-8-5-2-4-9-7-2-5-2-1	0.0-3.0-7.0-9.0-4.0-6.0-8.0-5.0-2.0-4.1-9.1-7.1-2.1-5.1-2.0-1.0	154	115460	138291
HG01099.verkko_filt_mat.fa:haplotype1-0000034_142513097_142920876_1	HG01099.verkko_filt_mat.fa:haplotype1-0000034_142513097_142920876_1	139204	141244	7	12	0	0	11	2040	140240	138200	0-3-7-9-4-6-8-5-2-4-9-7-2-5-2-1	0.0-3.0-7.0-9.0-4.0-6.0-8.0-5.0-2.0-4.1-9.1-7.1-2.1-5.1-2.0-1.0	154	139050	141090
HG01099.verkko_filt_mat.fa:haplotype1-0000034_142513097_142920876_1	HG01099.verkko_filt_mat.fa:haplotype1-0000034_142513097_142920876_1	141188	142499	9	5	0	0	4	1311	141551	140240	0-3-7-9-4-6-8-5-2-4-9-7-2-5-2-1	0.0-3.0-7.0-9.0-4.0-6.0-8.0-5.0-2.0-4.1-9.1-7.1-2.1-5.1-2.0-1.0	154	141034	142345
HG01099.verkko_filt_mat.fa:haplotype1-0000034_142513097_142920876_1	HG01099.verkko_filt_mat.fa:haplotype1-0000034_142513097_142920876_1	143290	158742	4	84	0	1	83	15452	157003	141551	0-3-7-9-4-6-8-5-2-4-9-7-2-5-2-1	0.0-3.0-7.0-9.0-4.0-6.0-8.0-5.0-2.0-4.1-9.1-7.1-2.1-5.1-2.0-1.0	154	143136	158588
HG01099.verkko_filt_mat.fa:haplotype1-0000034_142513097_142920876_1	HG01099.verkko_filt_mat.fa:haplotype1-0000034_142513097_142920876_1	158686	161501	6	12	0	0	11	2815	159818	157003	0-3-7-9-4-6-8-5-2-4-9-7-2-5-2-1	0.0-3.0-7.0-9.0-4.0-6.0-8.0-5.0-2.0-4.1-9.1-7.1-2.1-5.1-2.0-1.0	154	158532	161347
HG01099.verkko_filt_mat.fa:haplotype1-0000034_142513097_142920876_1	HG01099.verkko_filt_mat.fa:haplotype1-0000034_142513097_142920876_1	161445	163215	8	8	0	0	7	1770	161588	159818	0-3-7-9-4-6-8-5-2-4-9-7-2-5-2-1	0.0-3.0-7.0-9.0-4.0-6.0-8.0-5.0-2.0-4.1-9.1-7.1-2.1-5.1-2.0-1.0	154	161291	163061
HG01099.verkko_filt_mat.fa:haplotype1-0000034_142513097_142920876_1	HG01099.verkko_filt_mat.fa:haplotype1-0000034_142513097_142920876_1	163159	176263	5	79	0	0	78	13104	174692	161588	0-3-7-9-4-6-8-5-2-4-9-7-2-5-2-1	0.0-3.0-7.0-9.0-4.0-6.0-8.0-5.0-2.0-4.1-9.1-7.1-2.1-5.1-2.0-1.0	154	163005	176109
HG01099.verkko_filt_mat.fa:haplotype1-0000034_142513097_142920876_1	HG01099.verkko_filt_mat.fa:haplotype1-0000034_142513097_142920876_1	176207	210529	2	196	0	0	195	34322	209014	174692	0-3-7-9-4-6-8-5-2-4-9-7-2-5-2-1	0.0-3.0-7.0-9.0-4.0-6.0-8.0-5.0-2.0-4.1-9.1-7.1-2.1-5.1-2.0-1.0	154	176053	210375
HG01099.verkko_filt_mat.fa:haplotype1-0000034_142513097_142920876_1	HG01099.verkko_filt_mat.fa:haplotype1-0000034_142513097_142920876_1	212395	224206	4	84	1	58	1	11811	220825	209014	0-3-7-9-4-6-8-5-2-4-9-7-2-5-2-1	0.0-3.0-7.0-9.0-4.0-6.0-8.0-5.0-2.0-4.1-9.1-7.1-2.1-5.1-2.0-1.0	154	212241	224052
HG01099.verkko_filt_mat.fa:haplotype1-0000034_142513097_142920876_1	HG01099.verkko_filt_mat.fa:haplotype1-0000034_142513097_142920876_1	224997	226308	9	5	1	4	0	1311	222136	220825	0-3-7-9-4-6-8-5-2-4-9-7-2-5-2-1	0.0-3.0-7.0-9.0-4.0-6.0-8.0-5.0-2.0-4.1-9.1-7.1-2.1-5.1-2.0-1.0	154	224843	226154
HG01099.verkko_filt_mat.fa:haplotype1-0000034_142513097_142920876_1	HG01099.verkko_filt_mat.fa:haplotype1-0000034_142513097_142920876_1	226252	228292	7	12	1	11	0	2040	224176	222136	0-3-7-9-4-6-8-5-2-4-9-7-2-5-2-1	0.0-3.0-7.0-9.0-4.0-6.0-8.0-5.0-2.0-4.1-9.1-7.1-2.1-5.1-2.0-1.0	154	226098	228138
HG01099.verkko_filt_mat.fa:haplotype1-0000034_142513097_142920876_1	HG01099.verkko_filt_mat.fa:haplotype1-0000034_142513097_142920876_1	229369	263474	2	196	1	195	1	34105	258281	224176	0-3-7-9-4-6-8-5-2-4-9-7-2-5-2-1	0.0-3.0-7.0-9.0-4.0-6.0-8.0-5.0-2.0-4.1-9.1-7.1-2.1-5.1-2.0-1.0	154	229215	263320
HG01099.verkko_filt_mat.fa:haplotype1-0000034_142513097_142920876_1	HG01099.verkko_filt_mat.fa:haplotype1-0000034_142513097_142920876_1	264081	276296	5	79	1	77	3	12215	270496	258281	0-3-7-9-4-6-8-5-2-4-9-7-2-5-2-1	0.0-3.0-7.0-9.0-4.0-6.0-8.0-5.0-2.0-4.1-9.1-7.1-2.1-5.1-2.0-1.0	154	263927	276142
HG01099.verkko_filt_mat.fa:haplotype1-0000034_142513097_142920876_1	HG01099.verkko_filt_mat.fa:haplotype1-0000034_142513097_142920876_1	276735	304635	2	196	0	39	195	27900	298396	270496	0-3-7-9-4-6-8-5-2-4-9-7-2-5-2-1	0.0-3.0-7.0-9.0-4.0-6.0-8.0-5.0-2.0-4.1-9.1-7.1-2.1-5.1-2.0-1.0	154	276581	304481
HG01099.verkko_filt_mat.fa:haplotype1-0000034_142513097_142920876_1	HG01099.verkko_filt_mat.fa:haplotype1-0000034_142513097_142920876_1	304579	407763	1	612	0	0	611	103184	401580	298396	0-3-7-9-4-6-8-5-2-4-9-7-2-5-2-1	0.0-3.0-7.0-9.0-4.0-6.0-8.0-5.0-2.0-4.1-9.1-7.1-2.1-5.1-2.0-1.0	154	304425	407609
HG01099.verkko_filt_pat.fa:haplotype2-0000583_143544270_144046196_1	HG01099.verkko_filt_pat.fa:haplotype2-0000583_143544270_144046196_1	154	115543	0	672	0	0	671	115389	115389	0	0-3-7-9-4-6-8-5-2-4-9-7-2-5-2-4-9-7-2-5-2-1	0.0-3.0-7.0-9.0-4.0-6.0-8.0-5.0-2.0-4.1-9.1-7.1-2.1-5.0-2.0-4.1-9.1-7.1-2.1-5.1-2.0-1.0	154	0	115389
HG01099.verkko_filt_pat.fa:haplotype2-0000583_143544270_144046196_1	HG01099.verkko_filt_pat.fa:haplotype2-0000583_143544270_144046196_1	115634	138467	3	132	0	0	131	22833	138222	115389	0-3-7-9-4-6-8-5-2-4-9-7-2-5-2-4-9-7-2-5-2-1	0.0-3.0-7.0-9.0-4.0-6.0-8.0-5.0-2.0-4.1-9.1-7.1-2.1-5.0-2.0-4.1-9.1-7.1-2.1-5.1-2.0-1.0	154	115480	138313
HG01099.verkko_filt_pat.fa:haplotype2-0000583_143544270_144046196_1	HG01099.verkko_filt_pat.fa:haplotype2-0000583_143544270_144046196_1	139226	141266	7	12	0	0	11	2040	140262	138222	0-3-7-9-4-6-8-5-2-4-9-7-2-5-2-4-9-7-2-5-2-1	0.0-3.0-7.0-9.0-4.0-6.0-8.0-5.0-2.0-4.1-9.1-7.1-2.1-5.0-2.0-4.1-9.1-7.1-2.1-5.1-2.0-1.0	154	139072	141112
HG01099.verkko_filt_pat.fa:haplotype2-0000583_143544270_144046196_1	HG01099.verkko_filt_pat.fa:haplotype2-0000583_143544270_144046196_1	141210	142521	9	5	0	0	4	1311	141573	140262	0-3-7-9-4-6-8-5-2-4-9-7-2-5-2-4-9-7-2-5-2-1	0.0-3.0-7.0-9.0-4.0-6.0-8.0-5.0-2.0-4.1-9.1-7.1-2.1-5.0-2.0-4.1-9.1-7.1-2.1-5.1-2.0-1.0	154	141056	142367
HG01099.verkko_filt_pat.fa:haplotype2-0000583_143544270_144046196_1	HG01099.verkko_filt_pat.fa:haplotype2-0000583_143544270_144046196_1	142969	158774	4	84	0	0	83	15805	157378	141573	0-3-7-9-4-6-8-5-2-4-9-7-2-5-2-4-9-7-2-5-2-1	0.0-3.0-7.0-9.0-4.0-6.0-8.0-5.0-2.0-4.1-9.1-7.1-2.1-5.0-2.0-4.1-9.1-7.1-2.1-5.1-2.0-1.0	154	142815	158620
HG01099.verkko_filt_pat.fa:haplotype2-0000583_143544270_144046196_1	HG01099.verkko_filt_pat.fa:haplotype2-0000583_143544270_144046196_1	158718	161533	6	12	0	0	11	2815	160193	157378	0-3-7-9-4-6-8-5-2-4-9-7-2-5-2-4-9-7-2-5-2-1	0.0-3.0-7.0-9.0-4.0-6.0-8.0-5.0-2.0-4.1-9.1-7.1-2.1-5.0-2.0-4.1-9.1-7.1-2.1-5.1-2.0-1.0	154	158564	161379
HG01099.verkko_filt_pat.fa:haplotype2-0000583_143544270_144046196_1	HG01099.verkko_filt_pat.fa:haplotype2-0000583_143544270_144046196_1	161477	163247	8	8	0	0	7	1770	161963	160193	0-3-7-9-4-6-8-5-2-4-9-7-2-5-2-4-9-7-2-5-2-1	0.0-3.0-7.0-9.0-4.0-6.0-8.0-5.0-2.0-4.1-9.1-7.1-2.1-5.0-2.0-4.1-9.1-7.1-2.1-5.1-2.0-1.0	154	161323	163093
HG01099.verkko_filt_pat.fa:haplotype2-0000583_143544270_144046196_1	HG01099.verkko_filt_pat.fa:haplotype2-0000583_143544270_144046196_1	163191	175381	5	79	0	0	75	12190	174153	161963	0-3-7-9-4-6-8-5-2-4-9-7-2-5-2-4-9-7-2-5-2-1	0.0-3.0-7.0-9.0-4.0-6.0-8.0-5.0-2.0-4.1-9.1-7.1-2.1-5.0-2.0-4.1-9.1-7.1-2.1-5.1-2.0-1.0	154	163037	175227
HG01099.verkko_filt_pat.fa:haplotype2-0000583_143544270_144046196_1	HG01099.verkko_filt_pat.fa:haplotype2-0000583_143544270_144046196_1	176462	210565	2	196	0	1	195	34103	208256	174153	0-3-7-9-4-6-8-5-2-4-9-7-2-5-2-4-9-7-2-5-2-1	0.0-3.0-7.0-9.0-4.0-6.0-8.0-5.0-2.0-4.1-9.1-7.1-2.1-5.0-2.0-4.1-9.1-7.1-2.1-5.1-2.0-1.0	154	176308	210411
HG01099.verkko_filt_pat.fa:haplotype2-0000583_143544270_144046196_1	HG01099.verkko_filt_pat.fa:haplotype2-0000583_143544270_144046196_1	212431	223976	4	84	1	58	4	11545	219801	208256	0-3-7-9-4-6-8-5-2-4-9-7-2-5-2-4-9-7-2-5-2-1	0.0-3.0-7.0-9.0-4.0-6.0-8.0-5.0-2.0-4.1-9.1-7.1-2.1-5.0-2.0-4.1-9.1-7.1-2.1-5.1-2.0-1.0	154	212277	223822
HG01099.verkko_filt_pat.fa:haplotype2-0000583_143544270_144046196_1	HG01099.verkko_filt_pat.fa:haplotype2-0000583_143544270_144046196_1	225041	226352	9	5	1	4	0	1311	221112	219801	0-3-7-9-4-6-8-5-2-4-9-7-2-5-2-4-9-7-2-5-2-1	0.0-3.0-7.0-9.0-4.0-6.0-8.0-5.0-2.0-4.1-9.1-7.1-2.1-5.0-2.0-4.1-9.1-7.1-2.1-5.1-2.0-1.0	154	224887	226198
HG01099.verkko_filt_pat.fa:haplotype2-0000583_143544270_144046196_1	HG01099.verkko_filt_pat.fa:haplotype2-0000583_143544270_144046196_1	226296	228336	7	12	1	11	0	2040	223152	221112	0-3-7-9-4-6-8-5-2-4-9-7-2-5-2-4-9-7-2-5-2-1	0.0-3.0-7.0-9.0-4.0-6.0-8.0-5.0-2.0-4.1-9.1-7.1-2.1-5.0-2.0-4.1-9.1-7.1-2.1-5.1-2.0-1.0	154	226142	228182
HG01099.verkko_filt_pat.fa:haplotype2-0000583_143544270_144046196_1	HG01099.verkko_filt_pat.fa:haplotype2-0000583_143544270_144046196_1	229413	257334	2	196	1	195	39	27921	251073	223152	0-3-7-9-4-6-8-5-2-4-9-7-2-5-2-4-9-7-2-5-2-1	0.0-3.0-7.0-9.0-4.0-6.0-8.0-5.0-2.0-4.1-9.1-7.1-2.1-5.0-2.0-4.1-9.1-7.1-2.1-5.1-2.0-1.0	154	229259	257180
HG01099.verkko_filt_pat.fa:haplotype2-0000583_143544270_144046196_1	HG01099.verkko_filt_pat.fa:haplotype2-0000583_143544270_144046196_1	257773	269515	5	79	0	3	75	11742	262815	251073	0-3-7-9-4-6-8-5-2-4-9-7-2-5-2-4-9-7-2-5-2-1	0.0-3.0-7.0-9.0-4.0-6.0-8.0-5.0-2.0-4.1-9.1-7.1-2.1-5.0-2.0-4.1-9.1-7.1-2.1-5.1-2.0-1.0	154	257619	269361
HG01099.verkko_filt_pat.fa:haplotype2-0000583_143544270_144046196_1	HG01099.verkko_filt_pat.fa:haplotype2-0000583_143544270_144046196_1	270596	304696	2	196	0	1	195	34100	296915	262815	0-3-7-9-4-6-8-5-2-4-9-7-2-5-2-4-9-7-2-5-2-1	0.0-3.0-7.0-9.0-4.0-6.0-8.0-5.0-2.0-4.1-9.1-7.1-2.1-5.0-2.0-4.1-9.1-7.1-2.1-5.1-2.0-1.0	154	270442	304542
HG01099.verkko_filt_pat.fa:haplotype2-0000583_143544270_144046196_1	HG01099.verkko_filt_pat.fa:haplotype2-0000583_143544270_144046196_1	306562	317683	4	84	1	58	6	11121	308036	296915	0-3-7-9-4-6-8-5-2-4-9-7-2-5-2-4-9-7-2-5-2-1	0.0-3.0-7.0-9.0-4.0-6.0-8.0-5.0-2.0-4.1-9.1-7.1-2.1-5.0-2.0-4.1-9.1-7.1-2.1-5.1-2.0-1.0	154	306408	317529
HG01099.verkko_filt_pat.fa:haplotype2-0000583_143544270_144046196_1	HG01099.verkko_filt_pat.fa:haplotype2-0000583_143544270_144046196_1	319174	320485	9	5	1	4	0	1311	309347	308036	0-3-7-9-4-6-8-5-2-4-9-7-2-5-2-4-9-7-2-5-2-1	0.0-3.0-7.0-9.0-4.0-6.0-8.0-5.0-2.0-4.1-9.1-7.1-2.1-5.0-2.0-4.1-9.1-7.1-2.1-5.1-2.0-1.0	154	319020	320331
HG01099.verkko_filt_pat.fa:haplotype2-0000583_143544270_144046196_1	HG01099.verkko_filt_pat.fa:haplotype2-0000583_143544270_144046196_1	320429	322469	7	12	1	11	0	2040	311387	309347	0-3-7-9-4-6-8-5-2-4-9-7-2-5-2-4-9-7-2-5-2-1	0.0-3.0-7.0-9.0-4.0-6.0-8.0-5.0-2.0-4.1-9.1-7.1-2.1-5.0-2.0-4.1-9.1-7.1-2.1-5.1-2.0-1.0	154	320275	322315
HG01099.verkko_filt_pat.fa:haplotype2-0000583_143544270_144046196_1	HG01099.verkko_filt_pat.fa:haplotype2-0000583_143544270_144046196_1	323931	357659	2	196	1	194	1	33728	345115	311387	0-3-7-9-4-6-8-5-2-4-9-7-2-5-2-4-9-7-2-5-2-1	0.0-3.0-7.0-9.0-4.0-6.0-8.0-5.0-2.0-4.1-9.1-7.1-2.1-5.0-2.0-4.1-9.1-7.1-2.1-5.1-2.0-1.0	154	323777	357505
HG01099.verkko_filt_pat.fa:haplotype2-0000583_143544270_144046196_1	HG01099.verkko_filt_pat.fa:haplotype2-0000583_143544270_144046196_1	358740	370480	5	79	1	75	3	11740	356855	345115	0-3-7-9-4-6-8-5-2-4-9-7-2-5-2-4-9-7-2-5-2-1	0.0-3.0-7.0-9.0-4.0-6.0-8.0-5.0-2.0-4.1-9.1-7.1-2.1-5.0-2.0-4.1-9.1-7.1-2.1-5.1-2.0-1.0	154	358586	370326
HG01099.verkko_filt_pat.fa:haplotype2-0000583_143544270_144046196_1	HG01099.verkko_filt_pat.fa:haplotype2-0000583_143544270_144046196_1	370919	398831	2	196	0	39	195	27912	384767	356855	0-3-7-9-4-6-8-5-2-4-9-7-2-5-2-4-9-7-2-5-2-1	0.0-3.0-7.0-9.0-4.0-6.0-8.0-5.0-2.0-4.1-9.1-7.1-2.1-5.0-2.0-4.1-9.1-7.1-2.1-5.1-2.0-1.0	154	370765	398677
HG01099.verkko_filt_pat.fa:haplotype2-0000583_143544270_144046196_1	HG01099.verkko_filt_pat.fa:haplotype2-0000583_143544270_144046196_1	398775	501910	1	612	0	0	611	103135	487902	384767	0-3-7-9-4-6-8-5-2-4-9-7-2-5-2-4-9-7-2-5-2-1	0.0-3.0-7.0-9.0-4.0-6.0-8.0-5.0-2.0-4.1-9.1-7.1-2.1-5.0-2.0-4.1-9.1-7.1-2.1-5.1-2.0-1.0	154	398621	501756
HG01109#1#JAHEPA010000099.1_2104245_2511104_1	HG01109	155	115513	0	672	0	0	671	115358	115358	0	0-3-7-9-4-6-8-5-2-7-9-4-2-5-2-1	0.0-3.0-7.0-9.0-4.0-6.0-8.0-5.0-2.0-7.0-9.0-4.0-2.1-5.1-2.0-1.0	155	0	115358
HG01109#1#JAHEPA010000099.1_2104245_2511104_1	HG01109	115604	138440	3	132	0	0	131	22836	138194	115358	0-3-7-9-4-6-8-5-2-7-9-4-2-5-2-1	0.0-3.0-7.0-9.0-4.0-6.0-8.0-5.0-2.0-7.0-9.0-4.0-2.1-5.1-2.0-1.0	155	115449	138285
HG01109#1#JAHEPA010000099.1_2104245_2511104_1	HG01109	139199	141239	7	12	0	0	11	2040	140234	138194	0-3-7-9-4-6-8-5-2-7-9-4-2-5-2-1	0.0-3.0-7.0-9.0-4.0-6.0-8.0-5.0-2.0-7.0-9.0-4.0-2.1-5.1-2.0-1.0	155	139044	141084
HG01109#1#JAHEPA010000099.1_2104245_2511104_1	HG01109	141183	142495	9	5	0	0	4	1312	141546	140234	0-3-7-9-4-6-8-5-2-7-9-4-2-5-2-1	0.0-3.0-7.0-9.0-4.0-6.0-8.0-5.0-2.0-7.0-9.0-4.0-2.1-5.1-2.0-1.0	155	141028	142340
HG01109#1#JAHEPA010000099.1_2104245_2511104_1	HG01109	142943	158739	4	84	0	0	83	15796	157342	141546	0-3-7-9-4-6-8-5-2-7-9-4-2-5-2-1	0.0-3.0-7.0-9.0-4.0-6.0-8.0-5.0-2.0-7.0-9.0-4.0-2.1-5.1-2.0-1.0	155	142788	158584
HG01109#1#JAHEPA010000099.1_2104245_2511104_1	HG01109	158683	161499	6	12	0	0	11	2816	160158	157342	0-3-7-9-4-6-8-5-2-7-9-4-2-5-2-1	0.0-3.0-7.0-9.0-4.0-6.0-8.0-5.0-2.0-7.0-9.0-4.0-2.1-5.1-2.0-1.0	155	158528	161344
HG01109#1#JAHEPA010000099.1_2104245_2511104_1	HG01109	161443	163213	8	8	0	0	7	1770	161928	160158	0-3-7-9-4-6-8-5-2-7-9-4-2-5-2-1	0.0-3.0-7.0-9.0-4.0-6.0-8.0-5.0-2.0-7.0-9.0-4.0-2.1-5.1-2.0-1.0	155	161288	163058
HG01109#1#JAHEPA010000099.1_2104245_2511104_1	HG01109	163157	176261	5	79	0	0	78	13104	175032	161928	0-3-7-9-4-6-8-5-2-7-9-4-2-5-2-1	0.0-3.0-7.0-9.0-4.0-6.0-8.0-5.0-2.0-7.0-9.0-4.0-2.1-5.1-2.0-1.0	155	163002	176106
HG01109#1#JAHEPA010000099.1_2104245_2511104_1	HG01109	176205	210525	2	196	0	0	195	34320	209352	175032	0-3-7-9-4-6-8-5-2-7-9-4-2-5-2-1	0.0-3.0-7.0-9.0-4.0-6.0-8.0-5.0-2.0-7.0-9.0-4.0-2.1-5.1-2.0-1.0	155	176050	210370
HG01109#1#JAHEPA010000099.1_2104245_2511104_1	HG01109	211602	213642	7	12	0	0	11	2040	211392	209352	0-3-7-9-4-6-8-5-2-7-9-4-2-5-2-1	0.0-3.0-7.0-9.0-4.0-6.0-8.0-5.0-2.0-7.0-9.0-4.0-2.1-5.1-2.0-1.0	155	211447	213487
HG01109#1#JAHEPA010000099.1_2104245_2511104_1	HG01109	213586	214898	9	5	0	0	4	1312	212704	211392	0-3-7-9-4-6-8-5-2-7-9-4-2-5-2-1	0.0-3.0-7.0-9.0-4.0-6.0-8.0-5.0-2.0-7.0-9.0-4.0-2.1-5.1-2.0-1.0	155	213431	214743
HG01109#1#JAHEPA010000099.1_2104245_2511104_1	HG01109	215961	227507	4	84	0	4	58	11546	224250	212704	0-3-7-9-4-6-8-5-2-7-9-4-2-5-2-1	0.0-3.0-7.0-9.0-4.0-6.0-8.0-5.0-2.0-7.0-9.0-4.0-2.1-5.1-2.0-1.0	155	215806	227352
HG01109#1#JAHEPA010000099.1_2104245_2511104_1	HG01109	229373	263478	2	196	1	195	1	34105	258355	224250	0-3-7-9-4-6-8-5-2-7-9-4-2-5-2-1	0.0-3.0-7.0-9.0-4.0-6.0-8.0-5.0-2.0-7.0-9.0-4.0-2.1-5.1-2.0-1.0	155	229218	263323
HG01109#1#JAHEPA010000099.1_2104245_2511104_1	HG01109	264085	276300	5	79	1	77	3	12215	270570	258355	0-3-7-9-4-6-8-5-2-7-9-4-2-5-2-1	0.0-3.0-7.0-9.0-4.0-6.0-8.0-5.0-2.0-7.0-9.0-4.0-2.1-5.1-2.0-1.0	155	263930	276145
HG01109#1#JAHEPA010000099.1_2104245_2511104_1	HG01109	276739	304663	2	196	0	39	195	27924	298494	270570	0-3-7-9-4-6-8-5-2-7-9-4-2-5-2-1	0.0-3.0-7.0-9.0-4.0-6.0-8.0-5.0-2.0-7.0-9.0-4.0-2.1-5.1-2.0-1.0	155	276584	304508
HG01109#1#JAHEPA010000099.1_2104245_2511104_1	HG01109	304607	406797	1	612	0	0	605	102190	400684	298494	0-3-7-9-4-6-8-5-2-7-9-4-2-5-2-1	0.0-3.0-7.0-9.0-4.0-6.0-8.0-5.0-2.0-7.0-9.0-4.0-2.1-5.1-2.0-1.0	155	304452	406642
HG01109#2#JAHEOZ010000047.1_16671232_17151375_0	HG01109	98	115416	0	672	0	0	671	115318	115318	0	0-3-7-9-4-6-8-5-2-7-9-4-6-8-5-2-7-4-2-5-2-1	0.0-3.0-7.0-9.0-4.0-6.0-8.0-5.0-2.0-7.0-9.0-4.0-6.0-8.0-5.0-2.0-7.0-4.0-2.1-5.0-2.0-1.0	98	0	115318
HG01109#2#JAHEOZ010000047.1_16671232_17151375_0	HG01109	115507	138338	3	132	0	0	131	22831	138149	115318	0-3-7-9-4-6-8-5-2-7-9-4-6-8-5-2-7-4-2-5-2-1	0.0-3.0-7.0-9.0-4.0-6.0-8.0-5.0-2.0-7.0-9.0-4.0-6.0-8.0-5.0-2.0-7.0-4.0-2.1-5.0-2.0-1.0	98	115409	138240
HG01109#2#JAHEOZ010000047.1_16671232_17151375_0	HG01109	139097	141137	7	12	0	0	11	2040	140189	138149	0-3-7-9-4-6-8-5-2-7-9-4-6-8-5-2-7-4-2-5-2-1	0.0-3.0-7.0-9.0-4.0-6.0-8.0-5.0-2.0-7.0-9.0-4.0-6.0-8.0-5.0-2.0-7.0-4.0-2.1-5.0-2.0-1.0	98	138999	141039
HG01109#2#JAHEOZ010000047.1_16671232_17151375_0	HG01109	141081	142392	9	5	0	0	4	1311	141500	140189	0-3-7-9-4-6-8-5-2-7-9-4-6-8-5-2-7-4-2-5-2-1	0.0-3.0-7.0-9.0-4.0-6.0-8.0-5.0-2.0-7.0-9.0-4.0-6.0-8.0-5.0-2.0-7.0-4.0-2.1-5.0-2.0-1.0	98	140983	142294
HG01109#2#JAHEOZ010000047.1_16671232_17151375_0	HG01109	142840	158641	4	84	0	0	83	15801	157301	141500	0-3-7-9-4-6-8-5-2-7-9-4-6-8-5-2-7-4-2-5-2-1	0.0-3.0-7.0-9.0-4.0-6.0-8.0-5.0-2.0-7.0-9.0-4.0-6.0-8.0-5.0-2.0-7.0-4.0-2.1-5.0-2.0-1.0	98	142742	158543
HG01109#2#JAHEOZ010000047.1_16671232_17151375_0	HG01109	158585	161400	6	12	0	0	11	2815	160116	157301	0-3-7-9-4-6-8-5-2-7-9-4-6-8-5-2-7-4-2-5-2-1	0.0-3.0-7.0-9.0-4.0-6.0-8.0-5.0-2.0-7.0-9.0-4.0-6.0-8.0-5.0-2.0-7.0-4.0-2.1-5.0-2.0-1.0	98	158487	161302
HG01109#2#JAHEOZ010000047.1_16671232_17151375_0	HG01109	161344	163114	8	8	0	0	7	1770	161886	160116	0-3-7-9-4-6-8-5-2-7-9-4-6-8-5-2-7-4-2-5-2-1	0.0-3.0-7.0-9.0-4.0-6.0-8.0-5.0-2.0-7.0-9.0-4.0-6.0-8.0-5.0-2.0-7.0-4.0-2.1-5.0-2.0-1.0	98	161246	163016
HG01109#2#JAHEOZ010000047.1_16671232_17151375_0	HG01109	163058	175715	5	79	0	0	77	12657	174543	161886	0-3-7-9-4-6-8-5-2-7-9-4-6-8-5-2-7-4-2-5-2-1	0.0-3.0-7.0-9.0-4.0-6.0-8.0-5.0-2.0-7.0-9.0-4.0-6.0-8.0-5.0-2.0-7.0-4.0-2.1-5.0-2.0-1.0	98	162960	175617
HG01109#2#JAHEOZ010000047.1_16671232_17151375_0	HG01109	176322	210418	2	196	0	1	195	34096	208639	174543	0-3-7-9-4-6-8-5-2-7-9-4-6-8-5-2-7-4-2-5-2-1	0.0-3.0-7.0-9.0-4.0-6.0-8.0-5.0-2.0-7.0-9.0-4.0-6.0-8.0-5.0-2.0-7.0-4.0-2.1-5.0-2.0-1.0	98	176224	210320
HG01109#2#JAHEOZ010000047.1_16671232_17151375_0	HG01109	211495	213535	7	12	0	0	11	2040	210679	208639	0-3-7-9-4-6-8-5-2-7-9-4-6-8-5-2-7-4-2-5-2-1	0.0-3.0-7.0-9.0-4.0-6.0-8.0-5.0-2.0-7.0-9.0-4.0-6.0-8.0-5.0-2.0-7.0-4.0-2.1-5.0-2.0-1.0	98	211397	213437
HG01109#2#JAHEOZ010000047.1_16671232_17151375_0	HG01109	213479	214790	9	5	0	0	4	1311	211990	210679	0-3-7-9-4-6-8-5-2-7-9-4-6-8-5-2-7-4-2-5-2-1	0.0-3.0-7.0-9.0-4.0-6.0-8.0-5.0-2.0-7.0-9.0-4.0-6.0-8.0-5.0-2.0-7.0-4.0-2.1-5.0-2.0-1.0	98	213381	214692
HG01109#2#JAHEOZ010000047.1_16671232_17151375_0	HG01109	215238	231040	4	84	0	0	83	15802	227792	211990	0-3-7-9-4-6-8-5-2-7-9-4-6-8-5-2-7-4-2-5-2-1	0.0-3.0-7.0-9.0-4.0-6.0-8.0-5.0-2.0-7.0-9.0-4.0-6.0-8.0-5.0-2.0-7.0-4.0-2.1-5.0-2.0-1.0	98	215140	230942
HG01109#2#JAHEOZ010000047.1_16671232_17151375_0	HG01109	230984	233799	6	12	0	0	11	2815	230607	227792	0-3-7-9-4-6-8-5-2-7-9-4-6-8-5-2-7-4-2-5-2-1	0.0-3.0-7.0-9.0-4.0-6.0-8.0-5.0-2.0-7.0-9.0-4.0-6.0-8.0-5.0-2.0-7.0-4.0-2.1-5.0-2.0-1.0	98	230886	233701
HG01109#2#JAHEOZ010000047.1_16671232_17151375_0	HG01109	233743	235269	8	8	0	0	6	1526	232133	230607	0-3-7-9-4-6-8-5-2-7-9-4-6-8-5-2-7-4-2-5-2-1	0.0-3.0-7.0-9.0-4.0-6.0-8.0-5.0-2.0-7.0-9.0-4.0-6.0-8.0-5.0-2.0-7.0-4.0-2.1-5.0-2.0-1.0	98	233645	235171
HG01109#2#JAHEOZ010000047.1_16671232_17151375_0	HG01109	235457	248114	5	79	0	0	77	12657	244790	232133	0-3-7-9-4-6-8-5-2-7-9-4-6-8-5-2-7-4-2-5-2-1	0.0-3.0-7.0-9.0-4.0-6.0-8.0-5.0-2.0-7.0-9.0-4.0-6.0-8.0-5.0-2.0-7.0-4.0-2.1-5.0-2.0-1.0	98	235359	248016
HG01109#2#JAHEOZ010000047.1_16671232_17151375_0	HG01109	248498	282820	2	196	0	0	195	34322	279112	244790	0-3-7-9-4-6-8-5-2-7-9-4-6-8-5-2-7-4-2-5-2-1	0.0-3.0-7.0-9.0-4.0-6.0-8.0-5.0-2.0-7.0-9.0-4.0-6.0-8.0-5.0-2.0-7.0-4.0-2.1-5.0-2.0-1.0	98	248400	282722
HG01109#2#JAHEOZ010000047.1_16671232_17151375_0	HG01109	283897	285739	7	12	0	0	10	1842	280954	279112	0-3-7-9-4-6-8-5-2-7-9-4-6-8-5-2-7-4-2-5-2-1	0.0-3.0-7.0-9.0-4.0-6.0-8.0-5.0-2.0-7.0-9.0-4.0-6.0-8.0-5.0-2.0-7.0-4.0-2.1-5.0-2.0-1.0	98	283799	285641
HG01109#2#JAHEOZ010000047.1_16671232_17151375_0	HG01109	288259	299806	4	84	0	4	58	11547	292501	280954	0-3-7-9-4-6-8-5-2-7-9-4-6-8-5-2-7-4-2-5-2-1	0.0-3.0-7.0-9.0-4.0-6.0-8.0-5.0-2.0-7.0-9.0-4.0-6.0-8.0-5.0-2.0-7.0-4.0-2.1-5.0-2.0-1.0	98	288161	299708
HG01109#2#JAHEOZ010000047.1_16671232_17151375_0	HG01109	301672	329587	2	196	1	195	39	27915	320416	292501	0-3-7-9-4-6-8-5-2-7-9-4-6-8-5-2-7-4-2-5-2-1	0.0-3.0-7.0-9.0-4.0-6.0-8.0-5.0-2.0-7.0-9.0-4.0-6.0-8.0-5.0-2.0-7.0-4.0-2.1-5.0-2.0-1.0	98	301574	329489
HG01109#2#JAHEOZ010000047.1_16671232_17151375_0	HG01109	330026	342234	5	79	0	3	77	12208	332624	320416	0-3-7-9-4-6-8-5-2-7-9-4-6-8-5-2-7-4-2-5-2-1	0.0-3.0-7.0-9.0-4.0-6.0-8.0-5.0-2.0-7.0-9.0-4.0-6.0-8.0-5.0-2.0-7.0-4.0-2.1-5.0-2.0-1.0	98	329928	342136
HG01109#2#JAHEOZ010000047.1_16671232_17151375_0	HG01109	342618	376940	2	196	0	0	195	34322	366946	332624	0-3-7-9-4-6-8-5-2-7-9-4-6-8-5-2-7-4-2-5-2-1	0.0-3.0-7.0-9.0-4.0-6.0-8.0-5.0-2.0-7.0-9.0-4.0-6.0-8.0-5.0-2.0-7.0-4.0-2.1-5.0-2.0-1.0	98	342520	376842
HG01109#2#JAHEOZ010000047.1_16671232_17151375_0	HG01109	376884	480071	1	612	0	0	611	103187	470133	366946	0-3-7-9-4-6-8-5-2-7-9-4-6-8-5-2-7-4-2-5-2-1	0.0-3.0-7.0-9.0-4.0-6.0-8.0-5.0-2.0-7.0-9.0-4.0-6.0-8.0-5.0-2.0-7.0-4.0-2.1-5.0-2.0-1.0	98	376786	479973
HG01123#1#JAGYYZ010000015.1_51528240_51935090_0	HG01123	98	115453	0	672	0	0	671	115355	115355	0	0-3-7-9-4-6-8-5-2-7-9-4-2-5-2-1	0.0-3.0-7.0-9.0-4.0-6.0-8.0-5.0-2.0-7.0-9.0-4.0-2.1-5.1-2.0-1.0	98	0	115355
HG01123#1#JAGYYZ010000015.1_51528240_51935090_0	HG01123	115544	138378	3	132	0	0	131	22834	138189	115355	0-3-7-9-4-6-8-5-2-7-9-4-2-5-2-1	0.0-3.0-7.0-9.0-4.0-6.0-8.0-5.0-2.0-7.0-9.0-4.0-2.1-5.1-2.0-1.0	98	115446	138280
HG01123#1#JAGYYZ010000015.1_51528240_51935090_0	HG01123	139137	141177	7	12	0	0	11	2040	140229	138189	0-3-7-9-4-6-8-5-2-7-9-4-2-5-2-1	0.0-3.0-7.0-9.0-4.0-6.0-8.0-5.0-2.0-7.0-9.0-4.0-2.1-5.1-2.0-1.0	98	139039	141079
HG01123#1#JAGYYZ010000015.1_51528240_51935090_0	HG01123	141121	142433	9	5	0	0	4	1312	141541	140229	0-3-7-9-4-6-8-5-2-7-9-4-2-5-2-1	0.0-3.0-7.0-9.0-4.0-6.0-8.0-5.0-2.0-7.0-9.0-4.0-2.1-5.1-2.0-1.0	98	141023	142335
HG01123#1#JAGYYZ010000015.1_51528240_51935090_0	HG01123	143496	158674	4	84	0	4	83	15178	156719	141541	0-3-7-9-4-6-8-5-2-7-9-4-2-5-2-1	0.0-3.0-7.0-9.0-4.0-6.0-8.0-5.0-2.0-7.0-9.0-4.0-2.1-5.1-2.0-1.0	98	143398	158576
HG01123#1#JAGYYZ010000015.1_51528240_51935090_0	HG01123	158618	161433	6	12	0	0	11	2815	159534	156719	0-3-7-9-4-6-8-5-2-7-9-4-2-5-2-1	0.0-3.0-7.0-9.0-4.0-6.0-8.0-5.0-2.0-7.0-9.0-4.0-2.1-5.1-2.0-1.0	98	158520	161335
HG01123#1#JAGYYZ010000015.1_51528240_51935090_0	HG01123	161377	163147	8	8	0	0	7	1770	161304	159534	0-3-7-9-4-6-8-5-2-7-9-4-2-5-2-1	0.0-3.0-7.0-9.0-4.0-6.0-8.0-5.0-2.0-7.0-9.0-4.0-2.1-5.1-2.0-1.0	98	161279	163049
HG01123#1#JAGYYZ010000015.1_51528240_51935090_0	HG01123	163091	175755	5	79	0	0	77	12664	173968	161304	0-3-7-9-4-6-8-5-2-7-9-4-2-5-2-1	0.0-3.0-7.0-9.0-4.0-6.0-8.0-5.0-2.0-7.0-9.0-4.0-2.1-5.1-2.0-1.0	98	162993	175657
HG01123#1#JAGYYZ010000015.1_51528240_51935090_0	HG01123	176362	210469	2	196	0	1	195	34107	208075	173968	0-3-7-9-4-6-8-5-2-7-9-4-2-5-2-1	0.0-3.0-7.0-9.0-4.0-6.0-8.0-5.0-2.0-7.0-9.0-4.0-2.1-5.1-2.0-1.0	98	176264	210371
HG01123#1#JAGYYZ010000015.1_51528240_51935090_0	HG01123	211546	213586	7	12	0	0	11	2040	210115	208075	0-3-7-9-4-6-8-5-2-7-9-4-2-5-2-1	0.0-3.0-7.0-9.0-4.0-6.0-8.0-5.0-2.0-7.0-9.0-4.0-2.1-5.1-2.0-1.0	98	211448	213488
HG01123#1#JAGYYZ010000015.1_51528240_51935090_0	HG01123	213530	214842	9	5	0	0	4	1312	211427	210115	0-3-7-9-4-6-8-5-2-7-9-4-2-5-2-1	0.0-3.0-7.0-9.0-4.0-6.0-8.0-5.0-2.0-7.0-9.0-4.0-2.1-5.1-2.0-1.0	98	213432	214744
HG01123#1#JAGYYZ010000015.1_51528240_51935090_0	HG01123	215905	227451	4	84	0	4	58	11546	222973	211427	0-3-7-9-4-6-8-5-2-7-9-4-2-5-2-1	0.0-3.0-7.0-9.0-4.0-6.0-8.0-5.0-2.0-7.0-9.0-4.0-2.1-5.1-2.0-1.0	98	215807	227353
HG01123#1#JAGYYZ010000015.1_51528240_51935090_0	HG01123	229317	263432	2	196	1	195	1	34115	257088	222973	0-3-7-9-4-6-8-5-2-7-9-4-2-5-2-1	0.0-3.0-7.0-9.0-4.0-6.0-8.0-5.0-2.0-7.0-9.0-4.0-2.1-5.1-2.0-1.0	98	229219	263334
HG01123#1#JAGYYZ010000015.1_51528240_51935090_0	HG01123	264039	276254	5	79	1	77	3	12215	269303	257088	0-3-7-9-4-6-8-5-2-7-9-4-2-5-2-1	0.0-3.0-7.0-9.0-4.0-6.0-8.0-5.0-2.0-7.0-9.0-4.0-2.1-5.1-2.0-1.0	98	263941	276156
HG01123#1#JAGYYZ010000015.1_51528240_51935090_0	HG01123	276693	304603	2	196	0	39	195	27910	297213	269303	0-3-7-9-4-6-8-5-2-7-9-4-2-5-2-1	0.0-3.0-7.0-9.0-4.0-6.0-8.0-5.0-2.0-7.0-9.0-4.0-2.1-5.1-2.0-1.0	98	276595	304505
HG01123#1#JAGYYZ010000015.1_51528240_51935090_0	HG01123	304547	406906	1	612	0	0	606	102359	399572	297213	0-3-7-9-4-6-8-5-2-7-9-4-2-5-2-1	0.0-3.0-7.0-9.0-4.0-6.0-8.0-5.0-2.0-7.0-9.0-4.0-2.1-5.1-2.0-1.0	98	304449	406808
HG01123#2#JAGYYY010000006.1_51579630_51892388_0	HG01123	99	115455	0	672	0	0	671	115356	115356	0	0-3-7-9-4-6-8-5-2-1	0.0-3.0-7.0-9.0-4.0-6.0-8.0-5.0-2.0-1.0	99	0	115356
HG01123#2#JAGYYY010000006.1_51579630_51892388_0	HG01123	115546	138383	3	132	0	0	131	22837	138193	115356	0-3-7-9-4-6-8-5-2-1	0.0-3.0-7.0-9.0-4.0-6.0-8.0-5.0-2.0-1.0	99	115447	138284
HG01123#2#JAGYYY010000006.1_51579630_51892388_0	HG01123	139142	141182	7	12	0	0	11	2040	140233	138193	0-3-7-9-4-6-8-5-2-1	0.0-3.0-7.0-9.0-4.0-6.0-8.0-5.0-2.0-1.0	99	139043	141083
HG01123#2#JAGYYY010000006.1_51579630_51892388_0	HG01123	141126	142438	9	5	0	0	4	1312	141545	140233	0-3-7-9-4-6-8-5-2-1	0.0-3.0-7.0-9.0-4.0-6.0-8.0-5.0-2.0-1.0	99	141027	142339
HG01123#2#JAGYYY010000006.1_51579630_51892388_0	HG01123	143232	158685	4	84	0	1	83	15453	156998	141545	0-3-7-9-4-6-8-5-2-1	0.0-3.0-7.0-9.0-4.0-6.0-8.0-5.0-2.0-1.0	99	143133	158586
HG01123#2#JAGYYY010000006.1_51579630_51892388_0	HG01123	158629	161445	6	12	0	0	11	2816	159814	156998	0-3-7-9-4-6-8-5-2-1	0.0-3.0-7.0-9.0-4.0-6.0-8.0-5.0-2.0-1.0	99	158530	161346
HG01123#2#JAGYYY010000006.1_51579630_51892388_0	HG01123	161389	163159	8	8	0	0	7	1770	161584	159814	0-3-7-9-4-6-8-5-2-1	0.0-3.0-7.0-9.0-4.0-6.0-8.0-5.0-2.0-1.0	99	161290	163060
HG01123#2#JAGYYY010000006.1_51579630_51892388_0	HG01123	163103	176207	5	79	0	0	78	13104	174688	161584	0-3-7-9-4-6-8-5-2-1	0.0-3.0-7.0-9.0-4.0-6.0-8.0-5.0-2.0-1.0	99	163004	176108
HG01123#2#JAGYYY010000006.1_51579630_51892388_0	HG01123	176151	210469	2	196	0	0	195	34318	209006	174688	0-3-7-9-4-6-8-5-2-1	0.0-3.0-7.0-9.0-4.0-6.0-8.0-5.0-2.0-1.0	99	176052	210370
HG01123#2#JAGYYY010000006.1_51579630_51892388_0	HG01123	210413	312814	1	612	0	0	606	102401	311407	209006	0-3-7-9-4-6-8-5-2-1	0.0-3.0-7.0-9.0-4.0-6.0-8.0-5.0-2.0-1.0	99	210314	312715
HG01243#1#JAHEOY010000013.1_90081_424495_0	HG01243	98	115458	0	672	0	0	671	115360	115360	0	0-3-7-9-4-2-5-2-1	0.0-3.0-7.0-9.0-4.0-2.1-5.1-2.0-1.0	98	0	115360
HG01243#1#JAHEOY010000013.1_90081_424495_0	HG01243	115549	138382	3	132	0	0	131	22833	138193	115360	0-3-7-9-4-2-5-2-1	0.0-3.0-7.0-9.0-4.0-2.1-5.1-2.0-1.0	98	115451	138284
HG01243#1#JAHEOY010000013.1_90081_424495_0	HG01243	139141	141181	7	12	0	0	11	2040	140233	138193	0-3-7-9-4-2-5-2-1	0.0-3.0-7.0-9.0-4.0-2.1-5.1-2.0-1.0	98	139043	141083
HG01243#1#JAHEOY010000013.1_90081_424495_0	HG01243	141125	142437	9	5	0	0	4	1312	141545	140233	0-3-7-9-4-2-5-2-1	0.0-3.0-7.0-9.0-4.0-2.1-5.1-2.0-1.0	98	141027	142339
HG01243#1#JAHEOY010000013.1_90081_424495_0	HG01243	142885	155042	4	84	0	0	58	12157	153702	141545	0-3-7-9-4-2-5-2-1	0.0-3.0-7.0-9.0-4.0-2.1-5.1-2.0-1.0	98	142787	154944
HG01243#1#JAHEOY010000013.1_90081_424495_0	HG01243	156908	191018	2	196	1	195	1	34110	187812	153702	0-3-7-9-4-2-5-2-1	0.0-3.0-7.0-9.0-4.0-2.1-5.1-2.0-1.0	98	156810	190920
HG01243#1#JAHEOY010000013.1_90081_424495_0	HG01243	191625	203840	5	79	1	77	3	12215	200027	187812	0-3-7-9-4-2-5-2-1	0.0-3.0-7.0-9.0-4.0-2.1-5.1-2.0-1.0	98	191527	203742
HG01243#1#JAHEOY010000013.1_90081_424495_0	HG01243	204279	231807	2	196	0	39	194	27528	227555	200027	0-3-7-9-4-2-5-2-1	0.0-3.0-7.0-9.0-4.0-2.1-5.1-2.0-1.0	98	204181	231709
HG01243#1#JAHEOY010000013.1_90081_424495_0	HG01243	232231	334470	1	612	0	1	606	102239	329794	227555	0-3-7-9-4-2-5-2-1	0.0-3.0-7.0-9.0-4.0-2.1-5.1-2.0-1.0	98	232133	334372
HG01258#1#JAGYYV010000004.1_56955948_57456952_1	HG01258	155	115533	0	672	0	0	671	115378	115378	0	0-3-7-9-4-6-8-5-2-4-9-7-2-5-2-7-9-4-2-5-2-1	0.0-3.0-7.0-9.0-4.0-6.0-8.0-5.0-2.0-4.1-9.1-7.1-2.1-5.0-2.0-7.0-9.0-4.0-2.1-5.0-2.0-1.0	155	0	115378
HG01258#1#JAGYYV010000004.1_56955948_57456952_1	HG01258	115624	138460	3	132	0	0	131	22836	138214	115378	0-3-7-9-4-6-8-5-2-4-9-7-2-5-2-7-9-4-2-5-2-1	0.0-3.0-7.0-9.0-4.0-6.0-8.0-5.0-2.0-4.1-9.1-7.1-2.1-5.0-2.0-7.0-9.0-4.0-2.1-5.0-2.0-1.0	155	115469	138305
HG01258#1#JAGYYV010000004.1_56955948_57456952_1	HG01258	139219	141259	7	12	0	0	11	2040	140254	138214	0-3-7-9-4-6-8-5-2-4-9-7-2-5-2-7-9-4-2-5-2-1	0.0-3.0-7.0-9.0-4.0-6.0-8.0-5.0-2.0-4.1-9.1-7.1-2.1-5.0-2.0-7.0-9.0-4.0-2.1-5.0-2.0-1.0	155	139064	141104
HG01258#1#JAGYYV010000004.1_56955948_57456952_1	HG01258	141203	142515	9	5	0	0	4	1312	141566	140254	0-3-7-9-4-6-8-5-2-4-9-7-2-5-2-7-9-4-2-5-2-1	0.0-3.0-7.0-9.0-4.0-6.0-8.0-5.0-2.0-4.1-9.1-7.1-2.1-5.0-2.0-7.0-9.0-4.0-2.1-5.0-2.0-1.0	155	141048	142360
HG01258#1#JAGYYV010000004.1_56955948_57456952_1	HG01258	142963	158761	4	84	0	0	83	15798	157364	141566	0-3-7-9-4-6-8-5-2-4-9-7-2-5-2-7-9-4-2-5-2-1	0.0-3.0-7.0-9.0-4.0-6.0-8.0-5.0-2.0-4.1-9.1-7.1-2.1-5.0-2.0-7.0-9.0-4.0-2.1-5.0-2.0-1.0	155	142808	158606
HG01258#1#JAGYYV010000004.1_56955948_57456952_1	HG01258	158705	161521	6	12	0	0	11	2816	160180	157364	0-3-7-9-4-6-8-5-2-4-9-7-2-5-2-7-9-4-2-5-2-1	0.0-3.0-7.0-9.0-4.0-6.0-8.0-5.0-2.0-4.1-9.1-7.1-2.1-5.0-2.0-7.0-9.0-4.0-2.1-5.0-2.0-1.0	155	158550	161366
HG01258#1#JAGYYV010000004.1_56955948_57456952_1	HG01258	161465	163235	8	8	0	0	7	1770	161950	160180	0-3-7-9-4-6-8-5-2-4-9-7-2-5-2-7-9-4-2-5-2-1	0.0-3.0-7.0-9.0-4.0-6.0-8.0-5.0-2.0-4.1-9.1-7.1-2.1-5.0-2.0-7.0-9.0-4.0-2.1-5.0-2.0-1.0	155	161310	163080
HG01258#1#JAGYYV010000004.1_56955948_57456952_1	HG01258	163179	176283	5	79	0	0	78	13104	175054	161950	0-3-7-9-4-6-8-5-2-4-9-7-2-5-2-7-9-4-2-5-2-1	0.0-3.0-7.0-9.0-4.0-6.0-8.0-5.0-2.0-4.1-9.1-7.1-2.1-5.0-2.0-7.0-9.0-4.0-2.1-5.0-2.0-1.0	155	163024	176128
HG01258#1#JAGYYV010000004.1_56955948_57456952_1	HG01258	176227	210165	2	196	0	0	194	33938	208992	175054	0-3-7-9-4-6-8-5-2-4-9-7-2-5-2-7-9-4-2-5-2-1	0.0-3.0-7.0-9.0-4.0-6.0-8.0-5.0-2.0-4.1-9.1-7.1-2.1-5.0-2.0-7.0-9.0-4.0-2.1-5.0-2.0-1.0	155	176072	210010
HG01258#1#JAGYYV010000004.1_56955948_57456952_1	HG01258	212416	223963	4	84	1	58	4	11547	220539	208992	0-3-7-9-4-6-8-5-2-4-9-7-2-5-2-7-9-4-2-5-2-1	0.0-3.0-7.0-9.0-4.0-6.0-8.0-5.0-2.0-4.1-9.1-7.1-2.1-5.0-2.0-7.0-9.0-4.0-2.1-5.0-2.0-1.0	155	212261	223808
HG01258#1#JAGYYV010000004.1_56955948_57456952_1	HG01258	225028	226340	9	5	1	4	0	1312	221851	220539	0-3-7-9-4-6-8-5-2-4-9-7-2-5-2-7-9-4-2-5-2-1	0.0-3.0-7.0-9.0-4.0-6.0-8.0-5.0-2.0-4.1-9.1-7.1-2.1-5.0-2.0-7.0-9.0-4.0-2.1-5.0-2.0-1.0	155	224873	226185
HG01258#1#JAGYYV010000004.1_56955948_57456952_1	HG01258	226284	228324	7	12	1	11	0	2040	223891	221851	0-3-7-9-4-6-8-5-2-4-9-7-2-5-2-7-9-4-2-5-2-1	0.0-3.0-7.0-9.0-4.0-6.0-8.0-5.0-2.0-4.1-9.1-7.1-2.1-5.0-2.0-7.0-9.0-4.0-2.1-5.0-2.0-1.0	155	226129	228169
HG01258#1#JAGYYV010000004.1_56955948_57456952_1	HG01258	229786	257316	2	196	1	194	39	27530	251421	223891	0-3-7-9-4-6-8-5-2-4-9-7-2-5-2-7-9-4-2-5-2-1	0.0-3.0-7.0-9.0-4.0-6.0-8.0-5.0-2.0-4.1-9.1-7.1-2.1-5.0-2.0-7.0-9.0-4.0-2.1-5.0-2.0-1.0	155	229631	257161
HG01258#1#JAGYYV010000004.1_56955948_57456952_1	HG01258	258282	269970	5	79	0	5	77	11688	263109	251421	0-3-7-9-4-6-8-5-2-4-9-7-2-5-2-7-9-4-2-5-2-1	0.0-3.0-7.0-9.0-4.0-6.0-8.0-5.0-2.0-4.1-9.1-7.1-2.1-5.0-2.0-7.0-9.0-4.0-2.1-5.0-2.0-1.0	155	258127	269815
HG01258#1#JAGYYV010000004.1_56955948_57456952_1	HG01258	270577	304675	2	196	0	1	195	34098	297207	263109	0-3-7-9-4-6-8-5-2-4-9-7-2-5-2-7-9-4-2-5-2-1	0.0-3.0-7.0-9.0-4.0-6.0-8.0-5.0-2.0-4.1-9.1-7.1-2.1-5.0-2.0-7.0-9.0-4.0-2.1-5.0-2.0-1.0	155	270422	304520
HG01258#1#JAGYYV010000004.1_56955948_57456952_1	HG01258	305752	307792	7	12	0	0	11	2040	299247	297207	0-3-7-9-4-6-8-5-2-4-9-7-2-5-2-7-9-4-2-5-2-1	0.0-3.0-7.0-9.0-4.0-6.0-8.0-5.0-2.0-4.1-9.1-7.1-2.1-5.0-2.0-7.0-9.0-4.0-2.1-5.0-2.0-1.0	155	305597	307637
HG01258#1#JAGYYV010000004.1_56955948_57456952_1	HG01258	307736	309048	9	5	0	0	4	1312	300559	299247	0-3-7-9-4-6-8-5-2-4-9-7-2-5-2-7-9-4-2-5-2-1	0.0-3.0-7.0-9.0-4.0-6.0-8.0-5.0-2.0-4.1-9.1-7.1-2.1-5.0-2.0-7.0-9.0-4.0-2.1-5.0-2.0-1.0	155	307581	308893
HG01258#1#JAGYYV010000004.1_56955948_57456952_1	HG01258	310113	321658	4	84	0	4	58	11545	312104	300559	0-3-7-9-4-6-8-5-2-4-9-7-2-5-2-7-9-4-2-5-2-1	0.0-3.0-7.0-9.0-4.0-6.0-8.0-5.0-2.0-4.1-9.1-7.1-2.1-5.0-2.0-7.0-9.0-4.0-2.1-5.0-2.0-1.0	155	309958	321503
HG01258#1#JAGYYV010000004.1_56955948_57456952_1	HG01258	323524	351439	2	196	1	195	39	27915	340019	312104	0-3-7-9-4-6-8-5-2-4-9-7-2-5-2-7-9-4-2-5-2-1	0.0-3.0-7.0-9.0-4.0-6.0-8.0-5.0-2.0-4.1-9.1-7.1-2.1-5.0-2.0-7.0-9.0-4.0-2.1-5.0-2.0-1.0	155	323369	351284
HG01258#1#JAGYYV010000004.1_56955948_57456952_1	HG01258	351878	364093	5	79	0	3	77	12215	352234	340019	0-3-7-9-4-6-8-5-2-4-9-7-2-5-2-7-9-4-2-5-2-1	0.0-3.0-7.0-9.0-4.0-6.0-8.0-5.0-2.0-4.1-9.1-7.1-2.1-5.0-2.0-7.0-9.0-4.0-2.1-5.0-2.0-1.0	155	351723	363938
HG01258#1#JAGYYV010000004.1_56955948_57456952_1	HG01258	364700	398805	2	196	0	1	195	34105	386339	352234	0-3-7-9-4-6-8-5-2-4-9-7-2-5-2-7-9-4-2-5-2-1	0.0-3.0-7.0-9.0-4.0-6.0-8.0-5.0-2.0-4.1-9.1-7.1-2.1-5.0-2.0-7.0-9.0-4.0-2.1-5.0-2.0-1.0	155	364545	398650
HG01258#1#JAGYYV010000004.1_56955948_57456952_1	HG01258	398749	500942	1	612	0	0	605	102193	488532	386339	0-3-7-9-4-6-8-5-2-4-9-7-2-5-2-7-9-4-2-5-2-1	0.0-3.0-7.0-9.0-4.0-6.0-8.0-5.0-2.0-4.1-9.1-7.1-2.1-5.0-2.0-7.0-9.0-4.0-2.1-5.0-2.0-1.0	155	398594	500787
HG01258#2#JAGYYU010000072.1_51562603_51970395_0	HG01258	98	115466	0	672	0	0	671	115368	115368	0	0-3-7-9-4-6-8-5-2-7-9-4-2-5-2-1	0.0-3.0-7.0-9.0-4.0-6.0-8.0-5.0-2.0-7.0-9.0-4.0-2.1-5.1-2.0-1.0	98	0	115368
HG01258#2#JAGYYU010000072.1_51562603_51970395_0	HG01258	115557	138391	3	132	0	0	131	22834	138202	115368	0-3-7-9-4-6-8-5-2-7-9-4-2-5-2-1	0.0-3.0-7.0-9.0-4.0-6.0-8.0-5.0-2.0-7.0-9.0-4.0-2.1-5.1-2.0-1.0	98	115459	138293
HG01258#2#JAGYYU010000072.1_51562603_51970395_0	HG01258	139150	141190	7	12	0	0	11	2040	140242	138202	0-3-7-9-4-6-8-5-2-7-9-4-2-5-2-1	0.0-3.0-7.0-9.0-4.0-6.0-8.0-5.0-2.0-7.0-9.0-4.0-2.1-5.1-2.0-1.0	98	139052	141092
HG01258#2#JAGYYU010000072.1_51562603_51970395_0	HG01258	141134	142446	9	5	0	0	4	1312	141554	140242	0-3-7-9-4-6-8-5-2-7-9-4-2-5-2-1	0.0-3.0-7.0-9.0-4.0-6.0-8.0-5.0-2.0-7.0-9.0-4.0-2.1-5.1-2.0-1.0	98	141036	142348
HG01258#2#JAGYYU010000072.1_51562603_51970395_0	HG01258	142894	158702	4	84	0	0	83	15808	157362	141554	0-3-7-9-4-6-8-5-2-7-9-4-2-5-2-1	0.0-3.0-7.0-9.0-4.0-6.0-8.0-5.0-2.0-7.0-9.0-4.0-2.1-5.1-2.0-1.0	98	142796	158604
HG01258#2#JAGYYU010000072.1_51562603_51970395_0	HG01258	158646	161461	6	12	0	0	11	2815	160177	157362	0-3-7-9-4-6-8-5-2-7-9-4-2-5-2-1	0.0-3.0-7.0-9.0-4.0-6.0-8.0-5.0-2.0-7.0-9.0-4.0-2.1-5.1-2.0-1.0	98	158548	161363
HG01258#2#JAGYYU010000072.1_51562603_51970395_0	HG01258	161405	163175	8	8	0	0	7	1770	161947	160177	0-3-7-9-4-6-8-5-2-7-9-4-2-5-2-1	0.0-3.0-7.0-9.0-4.0-6.0-8.0-5.0-2.0-7.0-9.0-4.0-2.1-5.1-2.0-1.0	98	161307	163077
HG01258#2#JAGYYU010000072.1_51562603_51970395_0	HG01258	163119	175783	5	79	0	0	77	12664	174611	161947	0-3-7-9-4-6-8-5-2-7-9-4-2-5-2-1	0.0-3.0-7.0-9.0-4.0-6.0-8.0-5.0-2.0-7.0-9.0-4.0-2.1-5.1-2.0-1.0	98	163021	175685
HG01258#2#JAGYYU010000072.1_51562603_51970395_0	HG01258	176390	210488	2	196	0	1	195	34098	208709	174611	0-3-7-9-4-6-8-5-2-7-9-4-2-5-2-1	0.0-3.0-7.0-9.0-4.0-6.0-8.0-5.0-2.0-7.0-9.0-4.0-2.1-5.1-2.0-1.0	98	176292	210390
HG01258#2#JAGYYU010000072.1_51562603_51970395_0	HG01258	211565	213605	7	12	0	0	11	2040	210749	208709	0-3-7-9-4-6-8-5-2-7-9-4-2-5-2-1	0.0-3.0-7.0-9.0-4.0-6.0-8.0-5.0-2.0-7.0-9.0-4.0-2.1-5.1-2.0-1.0	98	211467	213507
HG01258#2#JAGYYU010000072.1_51562603_51970395_0	HG01258	213549	214861	9	5	0	0	4	1312	212061	210749	0-3-7-9-4-6-8-5-2-7-9-4-2-5-2-1	0.0-3.0-7.0-9.0-4.0-6.0-8.0-5.0-2.0-7.0-9.0-4.0-2.1-5.1-2.0-1.0	98	213451	214763
HG01258#2#JAGYYU010000072.1_51562603_51970395_0	HG01258	215926	227471	4	84	0	4	58	11545	223606	212061	0-3-7-9-4-6-8-5-2-7-9-4-2-5-2-1	0.0-3.0-7.0-9.0-4.0-6.0-8.0-5.0-2.0-7.0-9.0-4.0-2.1-5.1-2.0-1.0	98	215828	227373
HG01258#2#JAGYYU010000072.1_51562603_51970395_0	HG01258	229337	263446	2	196	1	195	1	34109	257715	223606	0-3-7-9-4-6-8-5-2-7-9-4-2-5-2-1	0.0-3.0-7.0-9.0-4.0-6.0-8.0-5.0-2.0-7.0-9.0-4.0-2.1-5.1-2.0-1.0	98	229239	263348
HG01258#2#JAGYYU010000072.1_51562603_51970395_0	HG01258	264053	276268	5	79	1	77	3	12215	269930	257715	0-3-7-9-4-6-8-5-2-7-9-4-2-5-2-1	0.0-3.0-7.0-9.0-4.0-6.0-8.0-5.0-2.0-7.0-9.0-4.0-2.1-5.1-2.0-1.0	98	263955	276170
HG01258#2#JAGYYU010000072.1_51562603_51970395_0	HG01258	276707	304624	2	196	0	39	195	27917	297847	269930	0-3-7-9-4-6-8-5-2-7-9-4-2-5-2-1	0.0-3.0-7.0-9.0-4.0-6.0-8.0-5.0-2.0-7.0-9.0-4.0-2.1-5.1-2.0-1.0	98	276609	304526
HG01258#2#JAGYYU010000072.1_51562603_51970395_0	HG01258	304568	407720	1	612	0	0	611	103152	400999	297847	0-3-7-9-4-6-8-5-2-7-9-4-2-5-2-1	0.0-3.0-7.0-9.0-4.0-6.0-8.0-5.0-2.0-7.0-9.0-4.0-2.1-5.1-2.0-1.0	98	304470	407622
HG01358#1#JAGYZB010000020.1_27445742_27855492_1	HG01358	154	115517	0	672	0	0	671	115363	115363	0	0-3-7-9-4-6-8-5-2-4-4-2-5-2-1	0.0-3.0-7.0-9.0-4.0-6.0-8.0-5.0-2.0-4.1-4.0-2.1-5.1-2.0-1.0	154	0	115363
HG01358#1#JAGYZB010000020.1_27445742_27855492_1	HG01358	115608	138441	3	132	0	0	131	22833	138196	115363	0-3-7-9-4-6-8-5-2-4-4-2-5-2-1	0.0-3.0-7.0-9.0-4.0-6.0-8.0-5.0-2.0-4.1-4.0-2.1-5.1-2.0-1.0	154	115454	138287
HG01358#1#JAGYZB010000020.1_27445742_27855492_1	HG01358	139200	141240	7	12	0	0	11	2040	140236	138196	0-3-7-9-4-6-8-5-2-4-4-2-5-2-1	0.0-3.0-7.0-9.0-4.0-6.0-8.0-5.0-2.0-4.1-4.0-2.1-5.1-2.0-1.0	154	139046	141086
HG01358#1#JAGYZB010000020.1_27445742_27855492_1	HG01358	141184	142495	9	5	0	0	4	1311	141547	140236	0-3-7-9-4-6-8-5-2-4-4-2-5-2-1	0.0-3.0-7.0-9.0-4.0-6.0-8.0-5.0-2.0-4.1-4.0-2.1-5.1-2.0-1.0	154	141030	142341
HG01358#1#JAGYZB010000020.1_27445742_27855492_1	HG01358	142943	158753	4	84	0	0	83	15810	157357	141547	0-3-7-9-4-6-8-5-2-4-4-2-5-2-1	0.0-3.0-7.0-9.0-4.0-6.0-8.0-5.0-2.0-4.1-4.0-2.1-5.1-2.0-1.0	154	142789	158599
HG01358#1#JAGYZB010000020.1_27445742_27855492_1	HG01358	158697	161511	6	12	0	0	11	2814	160171	157357	0-3-7-9-4-6-8-5-2-4-4-2-5-2-1	0.0-3.0-7.0-9.0-4.0-6.0-8.0-5.0-2.0-4.1-4.0-2.1-5.1-2.0-1.0	154	158543	161357
HG01358#1#JAGYZB010000020.1_27445742_27855492_1	HG01358	161455	163225	8	8	0	0	7	1770	161941	160171	0-3-7-9-4-6-8-5-2-4-4-2-5-2-1	0.0-3.0-7.0-9.0-4.0-6.0-8.0-5.0-2.0-4.1-4.0-2.1-5.1-2.0-1.0	154	161301	163071
HG01358#1#JAGYZB010000020.1_27445742_27855492_1	HG01358	163169	176273	5	79	0	0	78	13104	175045	161941	0-3-7-9-4-6-8-5-2-4-4-2-5-2-1	0.0-3.0-7.0-9.0-4.0-6.0-8.0-5.0-2.0-4.1-4.0-2.1-5.1-2.0-1.0	154	163015	176119
HG01358#1#JAGYZB010000020.1_27445742_27855492_1	HG01358	176217	210527	2	196	0	0	195	34310	209355	175045	0-3-7-9-4-6-8-5-2-4-4-2-5-2-1	0.0-3.0-7.0-9.0-4.0-6.0-8.0-5.0-2.0-4.1-4.0-2.1-5.1-2.0-1.0	154	176063	210373
HG01358#1#JAGYZB010000020.1_27445742_27855492_1	HG01358	212393	221622	4	84	1	58	20	9229	218584	209355	0-3-7-9-4-6-8-5-2-4-4-2-5-2-1	0.0-3.0-7.0-9.0-4.0-6.0-8.0-5.0-2.0-4.1-4.0-2.1-5.1-2.0-1.0	154	212239	221468
HG01358#1#JAGYZB010000020.1_27445742_27855492_1	HG01358	221930	230407	4	84	0	22	58	8477	227061	218584	0-3-7-9-4-6-8-5-2-4-4-2-5-2-1	0.0-3.0-7.0-9.0-4.0-6.0-8.0-5.0-2.0-4.1-4.0-2.1-5.1-2.0-1.0	154	221776	230253
HG01358#1#JAGYZB010000020.1_27445742_27855492_1	HG01358	232273	266379	2	196	1	195	1	34106	261167	227061	0-3-7-9-4-6-8-5-2-4-4-2-5-2-1	0.0-3.0-7.0-9.0-4.0-6.0-8.0-5.0-2.0-4.1-4.0-2.1-5.1-2.0-1.0	154	232119	266225
HG01358#1#JAGYZB010000020.1_27445742_27855492_1	HG01358	266986	279201	5	79	1	77	3	12215	273382	261167	0-3-7-9-4-6-8-5-2-4-4-2-5-2-1	0.0-3.0-7.0-9.0-4.0-6.0-8.0-5.0-2.0-4.1-4.0-2.1-5.1-2.0-1.0	154	266832	279047
HG01358#1#JAGYZB010000020.1_27445742_27855492_1	HG01358	279640	307549	2	196	0	39	195	27909	301291	273382	0-3-7-9-4-6-8-5-2-4-4-2-5-2-1	0.0-3.0-7.0-9.0-4.0-6.0-8.0-5.0-2.0-4.1-4.0-2.1-5.1-2.0-1.0	154	279486	307395
HG01358#1#JAGYZB010000020.1_27445742_27855492_1	HG01358	307493	409688	1	612	0	0	605	102195	403486	301291	0-3-7-9-4-6-8-5-2-4-4-2-5-2-1	0.0-3.0-7.0-9.0-4.0-6.0-8.0-5.0-2.0-4.1-4.0-2.1-5.1-2.0-1.0	154	307339	409534
HG01891#1#JAGYVO010000014.1_22855818_23168577_1	HG01891	154	115518	0	672	0	0	671	115364	115364	0	0-3-7-9-4-6-8-5-2-1	0.0-3.0-7.0-9.0-4.0-6.0-8.0-5.0-2.0-1.0	154	0	115364
HG01891#1#JAGYVO010000014.1_22855818_23168577_1	HG01891	115609	138440	3	132	0	0	131	22831	138195	115364	0-3-7-9-4-6-8-5-2-1	0.0-3.0-7.0-9.0-4.0-6.0-8.0-5.0-2.0-1.0	154	115455	138286
HG01891#1#JAGYVO010000014.1_22855818_23168577_1	HG01891	139199	141239	7	12	0	0	11	2040	140235	138195	0-3-7-9-4-6-8-5-2-1	0.0-3.0-7.0-9.0-4.0-6.0-8.0-5.0-2.0-1.0	154	139045	141085
HG01891#1#JAGYVO010000014.1_22855818_23168577_1	HG01891	141183	142494	9	5	0	0	4	1311	141546	140235	0-3-7-9-4-6-8-5-2-1	0.0-3.0-7.0-9.0-4.0-6.0-8.0-5.0-2.0-1.0	154	141029	142340
HG01891#1#JAGYVO010000014.1_22855818_23168577_1	HG01891	142942	158511	4	84	0	0	81	15569	157115	141546	0-3-7-9-4-6-8-5-2-1	0.0-3.0-7.0-9.0-4.0-6.0-8.0-5.0-2.0-1.0	154	142788	158357
HG01891#1#JAGYVO010000014.1_22855818_23168577_1	HG01891	158696	161511	6	12	0	0	11	2815	159930	157115	0-3-7-9-4-6-8-5-2-1	0.0-3.0-7.0-9.0-4.0-6.0-8.0-5.0-2.0-1.0	154	158542	161357
HG01891#1#JAGYVO010000014.1_22855818_23168577_1	HG01891	161455	163225	8	8	0	0	7	1770	161700	159930	0-3-7-9-4-6-8-5-2-1	0.0-3.0-7.0-9.0-4.0-6.0-8.0-5.0-2.0-1.0	154	161301	163071
HG01891#1#JAGYVO010000014.1_22855818_23168577_1	HG01891	163169	175826	5	79	0	0	77	12657	174357	161700	0-3-7-9-4-6-8-5-2-1	0.0-3.0-7.0-9.0-4.0-6.0-8.0-5.0-2.0-1.0	154	163015	175672
HG01891#1#JAGYVO010000014.1_22855818_23168577_1	HG01891	176433	210535	2	196	0	1	195	34102	208459	174357	0-3-7-9-4-6-8-5-2-1	0.0-3.0-7.0-9.0-4.0-6.0-8.0-5.0-2.0-1.0	154	176279	210381
HG01891#1#JAGYVO010000014.1_22855818_23168577_1	HG01891	210479	312697	1	612	0	0	605	102218	310677	208459	0-3-7-9-4-6-8-5-2-1	0.0-3.0-7.0-9.0-4.0-6.0-8.0-5.0-2.0-1.0	154	210325	312543
HG01928#1#JAGYVQ010000053.1_16676493_17083407_0	HG01928	99	115441	0	672	0	0	671	115342	115342	0	0-3-7-9-4-6-8-5-2-4-9-7-2-5-2-1	0.0-3.0-7.0-9.0-4.0-6.0-8.0-5.0-2.0-4.1-9.1-7.1-2.1-5.1-2.0-1.0	99	0	115342
HG01928#1#JAGYVQ010000053.1_16676493_17083407_0	HG01928	115532	138365	3	132	0	0	131	22833	138175	115342	0-3-7-9-4-6-8-5-2-4-9-7-2-5-2-1	0.0-3.0-7.0-9.0-4.0-6.0-8.0-5.0-2.0-4.1-9.1-7.1-2.1-5.1-2.0-1.0	99	115433	138266
HG01928#1#JAGYVQ010000053.1_16676493_17083407_0	HG01928	139124	141164	7	12	0	0	11	2040	140215	138175	0-3-7-9-4-6-8-5-2-4-9-7-2-5-2-1	0.0-3.0-7.0-9.0-4.0-6.0-8.0-5.0-2.0-4.1-9.1-7.1-2.1-5.1-2.0-1.0	99	139025	141065
HG01928#1#JAGYVQ010000053.1_16676493_17083407_0	HG01928	141108	142420	9	5	0	0	4	1312	141527	140215	0-3-7-9-4-6-8-5-2-4-9-7-2-5-2-1	0.0-3.0-7.0-9.0-4.0-6.0-8.0-5.0-2.0-4.1-9.1-7.1-2.1-5.1-2.0-1.0	99	141009	142321
HG01928#1#JAGYVQ010000053.1_16676493_17083407_0	HG01928	142868	158664	4	84	0	0	83	15796	157323	141527	0-3-7-9-4-6-8-5-2-4-9-7-2-5-2-1	0.0-3.0-7.0-9.0-4.0-6.0-8.0-5.0-2.0-4.1-9.1-7.1-2.1-5.1-2.0-1.0	99	142769	158565
HG01928#1#JAGYVQ010000053.1_16676493_17083407_0	HG01928	158608	161424	6	12	0	0	11	2816	160139	157323	0-3-7-9-4-6-8-5-2-4-9-7-2-5-2-1	0.0-3.0-7.0-9.0-4.0-6.0-8.0-5.0-2.0-4.1-9.1-7.1-2.1-5.1-2.0-1.0	99	158509	161325
HG01928#1#JAGYVQ010000053.1_16676493_17083407_0	HG01928	161368	163138	8	8	0	0	7	1770	161909	160139	0-3-7-9-4-6-8-5-2-4-9-7-2-5-2-1	0.0-3.0-7.0-9.0-4.0-6.0-8.0-5.0-2.0-4.1-9.1-7.1-2.1-5.1-2.0-1.0	99	161269	163039
HG01928#1#JAGYVQ010000053.1_16676493_17083407_0	HG01928	163082	176186	5	79	0	0	78	13104	175013	161909	0-3-7-9-4-6-8-5-2-4-9-7-2-5-2-1	0.0-3.0-7.0-9.0-4.0-6.0-8.0-5.0-2.0-4.1-9.1-7.1-2.1-5.1-2.0-1.0	99	162983	176087
HG01928#1#JAGYVQ010000053.1_16676493_17083407_0	HG01928	176130	210067	2	196	0	0	194	33937	208950	175013	0-3-7-9-4-6-8-5-2-4-9-7-2-5-2-1	0.0-3.0-7.0-9.0-4.0-6.0-8.0-5.0-2.0-4.1-9.1-7.1-2.1-5.1-2.0-1.0	99	176031	209968
HG01928#1#JAGYVQ010000053.1_16676493_17083407_0	HG01928	212318	223867	4	84	1	58	4	11549	220499	208950	0-3-7-9-4-6-8-5-2-4-9-7-2-5-2-1	0.0-3.0-7.0-9.0-4.0-6.0-8.0-5.0-2.0-4.1-9.1-7.1-2.1-5.1-2.0-1.0	99	212219	223768
HG01928#1#JAGYVQ010000053.1_16676493_17083407_0	HG01928	224932	226243	9	5	1	4	0	1311	221810	220499	0-3-7-9-4-6-8-5-2-4-9-7-2-5-2-1	0.0-3.0-7.0-9.0-4.0-6.0-8.0-5.0-2.0-4.1-9.1-7.1-2.1-5.1-2.0-1.0	99	224833	226144
HG01928#1#JAGYVQ010000053.1_16676493_17083407_0	HG01928	226187	228227	7	12	1	11	0	2040	223850	221810	0-3-7-9-4-6-8-5-2-4-9-7-2-5-2-1	0.0-3.0-7.0-9.0-4.0-6.0-8.0-5.0-2.0-4.1-9.1-7.1-2.1-5.1-2.0-1.0	99	226088	228128
HG01928#1#JAGYVQ010000053.1_16676493_17083407_0	HG01928	229689	263646	2	196	1	194	0	33957	257807	223850	0-3-7-9-4-6-8-5-2-4-9-7-2-5-2-1	0.0-3.0-7.0-9.0-4.0-6.0-8.0-5.0-2.0-4.1-9.1-7.1-2.1-5.1-2.0-1.0	99	229590	263547
HG01928#1#JAGYVQ010000053.1_16676493_17083407_0	HG01928	263590	275718	5	79	1	78	5	12128	269935	257807	0-3-7-9-4-6-8-5-2-4-9-7-2-5-2-1	0.0-3.0-7.0-9.0-4.0-6.0-8.0-5.0-2.0-4.1-9.1-7.1-2.1-5.1-2.0-1.0	99	263491	275619
HG01928#1#JAGYVQ010000053.1_16676493_17083407_0	HG01928	276684	304604	2	196	0	39	195	27920	297855	269935	0-3-7-9-4-6-8-5-2-4-9-7-2-5-2-1	0.0-3.0-7.0-9.0-4.0-6.0-8.0-5.0-2.0-4.1-9.1-7.1-2.1-5.1-2.0-1.0	99	276585	304505
HG01928#1#JAGYVQ010000053.1_16676493_17083407_0	HG01928	304548	406970	1	612	0	0	606	102422	400277	297855	0-3-7-9-4-6-8-5-2-4-9-7-2-5-2-1	0.0-3.0-7.0-9.0-4.0-6.0-8.0-5.0-2.0-4.1-9.1-7.1-2.1-5.1-2.0-1.0	99	304449	406871
HG01978#1#JAGYVS010000002.1_51519970_52021951_0	HG01978	99	115460	0	672	0	0	671	115361	115361	0	0-3-7-9-4-6-8-5-2-4-9-7-2-5-2-4-9-7-2-5-2-1	0.0-3.0-7.0-9.0-4.0-6.0-8.0-5.0-2.0-4.1-9.1-7.1-2.1-5.1-2.0-4.1-9.1-7.1-2.1-5.0-2.0-1.0	99	0	115361
HG01978#1#JAGYVS010000002.1_51519970_52021951_0	HG01978	115551	138384	3	132	0	0	131	22833	138194	115361	0-3-7-9-4-6-8-5-2-4-9-7-2-5-2-4-9-7-2-5-2-1	0.0-3.0-7.0-9.0-4.0-6.0-8.0-5.0-2.0-4.1-9.1-7.1-2.1-5.1-2.0-4.1-9.1-7.1-2.1-5.0-2.0-1.0	99	115452	138285
HG01978#1#JAGYVS010000002.1_51519970_52021951_0	HG01978	139143	141183	7	12	0	0	11	2040	140234	138194	0-3-7-9-4-6-8-5-2-4-9-7-2-5-2-4-9-7-2-5-2-1	0.0-3.0-7.0-9.0-4.0-6.0-8.0-5.0-2.0-4.1-9.1-7.1-2.1-5.1-2.0-4.1-9.1-7.1-2.1-5.0-2.0-1.0	99	139044	141084
HG01978#1#JAGYVS010000002.1_51519970_52021951_0	HG01978	141127	142439	9	5	0	0	4	1312	141546	140234	0-3-7-9-4-6-8-5-2-4-9-7-2-5-2-4-9-7-2-5-2-1	0.0-3.0-7.0-9.0-4.0-6.0-8.0-5.0-2.0-4.1-9.1-7.1-2.1-5.1-2.0-4.1-9.1-7.1-2.1-5.0-2.0-1.0	99	141028	142340
HG01978#1#JAGYVS010000002.1_51519970_52021951_0	HG01978	143233	158685	4	84	0	1	83	15452	156998	141546	0-3-7-9-4-6-8-5-2-4-9-7-2-5-2-4-9-7-2-5-2-1	0.0-3.0-7.0-9.0-4.0-6.0-8.0-5.0-2.0-4.1-9.1-7.1-2.1-5.1-2.0-4.1-9.1-7.1-2.1-5.0-2.0-1.0	99	143134	158586
HG01978#1#JAGYVS010000002.1_51519970_52021951_0	HG01978	158629	161445	6	12	0	0	11	2816	159814	156998	0-3-7-9-4-6-8-5-2-4-9-7-2-5-2-4-9-7-2-5-2-1	0.0-3.0-7.0-9.0-4.0-6.0-8.0-5.0-2.0-4.1-9.1-7.1-2.1-5.1-2.0-4.1-9.1-7.1-2.1-5.0-2.0-1.0	99	158530	161346
HG01978#1#JAGYVS010000002.1_51519970_52021951_0	HG01978	161389	163159	8	8	0	0	7	1770	161584	159814	0-3-7-9-4-6-8-5-2-4-9-7-2-5-2-4-9-7-2-5-2-1	0.0-3.0-7.0-9.0-4.0-6.0-8.0-5.0-2.0-4.1-9.1-7.1-2.1-5.1-2.0-4.1-9.1-7.1-2.1-5.0-2.0-1.0	99	161290	163060
HG01978#1#JAGYVS010000002.1_51519970_52021951_0	HG01978	163103	176207	5	79	0	0	78	13104	174688	161584	0-3-7-9-4-6-8-5-2-4-9-7-2-5-2-4-9-7-2-5-2-1	0.0-3.0-7.0-9.0-4.0-6.0-8.0-5.0-2.0-4.1-9.1-7.1-2.1-5.1-2.0-4.1-9.1-7.1-2.1-5.0-2.0-1.0	99	163004	176108
HG01978#1#JAGYVS010000002.1_51519970_52021951_0	HG01978	176151	210086	2	196	0	0	194	33935	208623	174688	0-3-7-9-4-6-8-5-2-4-9-7-2-5-2-4-9-7-2-5-2-1	0.0-3.0-7.0-9.0-4.0-6.0-8.0-5.0-2.0-4.1-9.1-7.1-2.1-5.1-2.0-4.1-9.1-7.1-2.1-5.0-2.0-1.0	99	176052	209987
HG01978#1#JAGYVS010000002.1_51519970_52021951_0	HG01978	212337	223884	4	84	1	58	4	11547	220170	208623	0-3-7-9-4-6-8-5-2-4-9-7-2-5-2-4-9-7-2-5-2-1	0.0-3.0-7.0-9.0-4.0-6.0-8.0-5.0-2.0-4.1-9.1-7.1-2.1-5.1-2.0-4.1-9.1-7.1-2.1-5.0-2.0-1.0	99	212238	223785
HG01978#1#JAGYVS010000002.1_51519970_52021951_0	HG01978	224951	226263	9	5	1	4	0	1312	221482	220170	0-3-7-9-4-6-8-5-2-4-9-7-2-5-2-4-9-7-2-5-2-1	0.0-3.0-7.0-9.0-4.0-6.0-8.0-5.0-2.0-4.1-9.1-7.1-2.1-5.1-2.0-4.1-9.1-7.1-2.1-5.0-2.0-1.0	99	224852	226164
HG01978#1#JAGYVS010000002.1_51519970_52021951_0	HG01978	226207	228247	7	12	1	11	0	2040	223522	221482	0-3-7-9-4-6-8-5-2-4-9-7-2-5-2-4-9-7-2-5-2-1	0.0-3.0-7.0-9.0-4.0-6.0-8.0-5.0-2.0-4.1-9.1-7.1-2.1-5.1-2.0-4.1-9.1-7.1-2.1-5.0-2.0-1.0	99	226108	228148
HG01978#1#JAGYVS010000002.1_51519970_52021951_0	HG01978	229709	263666	2	196	1	194	0	33957	257479	223522	0-3-7-9-4-6-8-5-2-4-9-7-2-5-2-4-9-7-2-5-2-1	0.0-3.0-7.0-9.0-4.0-6.0-8.0-5.0-2.0-4.1-9.1-7.1-2.1-5.1-2.0-4.1-9.1-7.1-2.1-5.0-2.0-1.0	99	229610	263567
HG01978#1#JAGYVS010000002.1_51519970_52021951_0	HG01978	263610	275738	5	79	1	78	5	12128	269607	257479	0-3-7-9-4-6-8-5-2-4-9-7-2-5-2-4-9-7-2-5-2-1	0.0-3.0-7.0-9.0-4.0-6.0-8.0-5.0-2.0-4.1-9.1-7.1-2.1-5.1-2.0-4.1-9.1-7.1-2.1-5.0-2.0-1.0	99	263511	275639
HG01978#1#JAGYVS010000002.1_51519970_52021951_0	HG01978	276704	303895	2	196	0	39	191	27191	296798	269607	0-3-7-9-4-6-8-5-2-4-9-7-2-5-2-4-9-7-2-5-2-1	0.0-3.0-7.0-9.0-4.0-6.0-8.0-5.0-2.0-4.1-9.1-7.1-2.1-5.1-2.0-4.1-9.1-7.1-2.1-5.0-2.0-1.0	99	276605	303796
HG01978#1#JAGYVS010000002.1_51519970_52021951_0	HG01978	306487	318039	4	84	1	58	4	11552	308350	296798	0-3-7-9-4-6-8-5-2-4-9-7-2-5-2-4-9-7-2-5-2-1	0.0-3.0-7.0-9.0-4.0-6.0-8.0-5.0-2.0-4.1-9.1-7.1-2.1-5.1-2.0-4.1-9.1-7.1-2.1-5.0-2.0-1.0	99	306388	317940
HG01978#1#JAGYVS010000002.1_51519970_52021951_0	HG01978	319106	320417	9	5	1	4	0	1311	309661	308350	0-3-7-9-4-6-8-5-2-4-9-7-2-5-2-4-9-7-2-5-2-1	0.0-3.0-7.0-9.0-4.0-6.0-8.0-5.0-2.0-4.1-9.1-7.1-2.1-5.1-2.0-4.1-9.1-7.1-2.1-5.0-2.0-1.0	99	319007	320318
HG01978#1#JAGYVS010000002.1_51519970_52021951_0	HG01978	320361	322401	7	12	1	11	0	2040	311701	309661	0-3-7-9-4-6-8-5-2-4-9-7-2-5-2-4-9-7-2-5-2-1	0.0-3.0-7.0-9.0-4.0-6.0-8.0-5.0-2.0-4.1-9.1-7.1-2.1-5.1-2.0-4.1-9.1-7.1-2.1-5.0-2.0-1.0	99	320262	322302
HG01978#1#JAGYVS010000002.1_51519970_52021951_0	HG01978	323863	351387	2	196	1	194	39	27524	339225	311701	0-3-7-9-4-6-8-5-2-4-9-7-2-5-2-4-9-7-2-5-2-1	0.0-3.0-7.0-9.0-4.0-6.0-8.0-5.0-2.0-4.1-9.1-7.1-2.1-5.1-2.0-4.1-9.1-7.1-2.1-5.0-2.0-1.0	99	323764	351288
HG01978#1#JAGYVS010000002.1_51519970_52021951_0	HG01978	352834	364041	5	79	0	8	77	11207	350432	339225	0-3-7-9-4-6-8-5-2-4-9-7-2-5-2-4-9-7-2-5-2-1	0.0-3.0-7.0-9.0-4.0-6.0-8.0-5.0-2.0-4.1-9.1-7.1-2.1-5.1-2.0-4.1-9.1-7.1-2.1-5.0-2.0-1.0	99	352735	363942
HG01978#1#JAGYVS010000002.1_51519970_52021951_0	HG01978	364648	398750	2	196	0	1	195	34102	384534	350432	0-3-7-9-4-6-8-5-2-4-9-7-2-5-2-4-9-7-2-5-2-1	0.0-3.0-7.0-9.0-4.0-6.0-8.0-5.0-2.0-4.1-9.1-7.1-2.1-5.1-2.0-4.1-9.1-7.1-2.1-5.0-2.0-1.0	99	364549	398651
HG01978#1#JAGYVS010000002.1_51519970_52021951_0	HG01978	398694	501909	1	612	0	0	611	103215	487749	384534	0-3-7-9-4-6-8-5-2-4-9-7-2-5-2-4-9-7-2-5-2-1	0.0-3.0-7.0-9.0-4.0-6.0-8.0-5.0-2.0-4.1-9.1-7.1-2.1-5.1-2.0-4.1-9.1-7.1-2.1-5.0-2.0-1.0	99	398595	501810
HG01978#2#JAGYVR010000007.1_51532241_51939176_0	HG01978	99	115452	0	672	0	0	671	115353	115353	0	0-3-7-9-4-6-8-5-2-4-9-7-2-5-2-1	0.0-3.0-7.0-9.0-4.0-6.0-8.0-5.0-2.0-4.1-9.1-7.1-2.1-5.1-2.0-1.0	99	0	115353
HG01978#2#JAGYVR010000007.1_51532241_51939176_0	HG01978	115543	138376	3	132	0	0	131	22833	138186	115353	0-3-7-9-4-6-8-5-2-4-9-7-2-5-2-1	0.0-3.0-7.0-9.0-4.0-6.0-8.0-5.0-2.0-4.1-9.1-7.1-2.1-5.1-2.0-1.0	99	115444	138277
HG01978#2#JAGYVR010000007.1_51532241_51939176_0	HG01978	139135	141175	7	12	0	0	11	2040	140226	138186	0-3-7-9-4-6-8-5-2-4-9-7-2-5-2-1	0.0-3.0-7.0-9.0-4.0-6.0-8.0-5.0-2.0-4.1-9.1-7.1-2.1-5.1-2.0-1.0	99	139036	141076
HG01978#2#JAGYVR010000007.1_51532241_51939176_0	HG01978	141119	142431	9	5	0	0	4	1312	141538	140226	0-3-7-9-4-6-8-5-2-4-9-7-2-5-2-1	0.0-3.0-7.0-9.0-4.0-6.0-8.0-5.0-2.0-4.1-9.1-7.1-2.1-5.1-2.0-1.0	99	141020	142332
HG01978#2#JAGYVR010000007.1_51532241_51939176_0	HG01978	142879	158680	4	84	0	0	83	15801	157339	141538	0-3-7-9-4-6-8-5-2-4-9-7-2-5-2-1	0.0-3.0-7.0-9.0-4.0-6.0-8.0-5.0-2.0-4.1-9.1-7.1-2.1-5.1-2.0-1.0	99	142780	158581
HG01978#2#JAGYVR010000007.1_51532241_51939176_0	HG01978	158624	161440	6	12	0	0	11	2816	160155	157339	0-3-7-9-4-6-8-5-2-4-9-7-2-5-2-1	0.0-3.0-7.0-9.0-4.0-6.0-8.0-5.0-2.0-4.1-9.1-7.1-2.1-5.1-2.0-1.0	99	158525	161341
HG01978#2#JAGYVR010000007.1_51532241_51939176_0	HG01978	161384	163154	8	8	0	0	7	1770	161925	160155	0-3-7-9-4-6-8-5-2-4-9-7-2-5-2-1	0.0-3.0-7.0-9.0-4.0-6.0-8.0-5.0-2.0-4.1-9.1-7.1-2.1-5.1-2.0-1.0	99	161285	163055
HG01978#2#JAGYVR010000007.1_51532241_51939176_0	HG01978	163098	176202	5	79	0	0	78	13104	175029	161925	0-3-7-9-4-6-8-5-2-4-9-7-2-5-2-1	0.0-3.0-7.0-9.0-4.0-6.0-8.0-5.0-2.0-4.1-9.1-7.1-2.1-5.1-2.0-1.0	99	162999	176103
HG01978#2#JAGYVR010000007.1_51532241_51939176_0	HG01978	176146	210088	2	196	0	0	194	33942	208971	175029	0-3-7-9-4-6-8-5-2-4-9-7-2-5-2-1	0.0-3.0-7.0-9.0-4.0-6.0-8.0-5.0-2.0-4.1-9.1-7.1-2.1-5.1-2.0-1.0	99	176047	209989
HG01978#2#JAGYVR010000007.1_51532241_51939176_0	HG01978	212339	223890	4	84	1	58	4	11551	220522	208971	0-3-7-9-4-6-8-5-2-4-9-7-2-5-2-1	0.0-3.0-7.0-9.0-4.0-6.0-8.0-5.0-2.0-4.1-9.1-7.1-2.1-5.1-2.0-1.0	99	212240	223791
HG01978#2#JAGYVR010000007.1_51532241_51939176_0	HG01978	224957	226268	9	5	1	4	0	1311	221833	220522	0-3-7-9-4-6-8-5-2-4-9-7-2-5-2-1	0.0-3.0-7.0-9.0-4.0-6.0-8.0-5.0-2.0-4.1-9.1-7.1-2.1-5.1-2.0-1.0	99	224858	226169
HG01978#2#JAGYVR010000007.1_51532241_51939176_0	HG01978	226212	228252	7	12	1	11	0	2040	223873	221833	0-3-7-9-4-6-8-5-2-4-9-7-2-5-2-1	0.0-3.0-7.0-9.0-4.0-6.0-8.0-5.0-2.0-4.1-9.1-7.1-2.1-5.1-2.0-1.0	99	226113	228153
HG01978#2#JAGYVR010000007.1_51532241_51939176_0	HG01978	229714	263671	2	196	1	194	0	33957	257830	223873	0-3-7-9-4-6-8-5-2-4-9-7-2-5-2-1	0.0-3.0-7.0-9.0-4.0-6.0-8.0-5.0-2.0-4.1-9.1-7.1-2.1-5.1-2.0-1.0	99	229615	263572
HG01978#2#JAGYVR010000007.1_51532241_51939176_0	HG01978	263615	275743	5	79	1	78	5	12128	269958	257830	0-3-7-9-4-6-8-5-2-4-9-7-2-5-2-1	0.0-3.0-7.0-9.0-4.0-6.0-8.0-5.0-2.0-4.1-9.1-7.1-2.1-5.1-2.0-1.0	99	263516	275644
HG01978#2#JAGYVR010000007.1_51532241_51939176_0	HG01978	276709	304621	2	196	0	39	195	27912	297870	269958	0-3-7-9-4-6-8-5-2-4-9-7-2-5-2-1	0.0-3.0-7.0-9.0-4.0-6.0-8.0-5.0-2.0-4.1-9.1-7.1-2.1-5.1-2.0-1.0	99	276610	304522
HG01978#2#JAGYVR010000007.1_51532241_51939176_0	HG01978	304565	406991	1	612	0	0	606	102426	400296	297870	0-3-7-9-4-6-8-5-2-4-9-7-2-5-2-1	0.0-3.0-7.0-9.0-4.0-6.0-8.0-5.0-2.0-4.1-9.1-7.1-2.1-5.1-2.0-1.0	99	304466	406892
HG02004.verkko_filt_mat.fa:haplotype1-0000022_97828542_98235483_0	HG02004.verkko_filt_mat.fa:haplotype1-0000022_97828542_98235483_0	99	115453	0	672	0	0	671	115354	115354	0	0-3-7-9-4-6-8-5-2-4-9-7-2-5-2-1	0.0-3.0-7.0-9.0-4.0-6.0-8.0-5.0-2.0-4.1-9.1-7.1-2.1-5.1-2.0-1.0	99	0	115354
HG02004.verkko_filt_mat.fa:haplotype1-0000022_97828542_98235483_0	HG02004.verkko_filt_mat.fa:haplotype1-0000022_97828542_98235483_0	115544	138377	3	132	0	0	131	22833	138187	115354	0-3-7-9-4-6-8-5-2-4-9-7-2-5-2-1	0.0-3.0-7.0-9.0-4.0-6.0-8.0-5.0-2.0-4.1-9.1-7.1-2.1-5.1-2.0-1.0	99	115445	138278
HG02004.verkko_filt_mat.fa:haplotype1-0000022_97828542_98235483_0	HG02004.verkko_filt_mat.fa:haplotype1-0000022_97828542_98235483_0	139136	141176	7	12	0	0	11	2040	140227	138187	0-3-7-9-4-6-8-5-2-4-9-7-2-5-2-1	0.0-3.0-7.0-9.0-4.0-6.0-8.0-5.0-2.0-4.1-9.1-7.1-2.1-5.1-2.0-1.0	99	139037	141077
HG02004.verkko_filt_mat.fa:haplotype1-0000022_97828542_98235483_0	HG02004.verkko_filt_mat.fa:haplotype1-0000022_97828542_98235483_0	141120	142432	9	5	0	0	4	1312	141539	140227	0-3-7-9-4-6-8-5-2-4-9-7-2-5-2-1	0.0-3.0-7.0-9.0-4.0-6.0-8.0-5.0-2.0-4.1-9.1-7.1-2.1-5.1-2.0-1.0	99	141021	142333
HG02004.verkko_filt_mat.fa:haplotype1-0000022_97828542_98235483_0	HG02004.verkko_filt_mat.fa:haplotype1-0000022_97828542_98235483_0	142880	158682	4	84	0	0	83	15802	157341	141539	0-3-7-9-4-6-8-5-2-4-9-7-2-5-2-1	0.0-3.0-7.0-9.0-4.0-6.0-8.0-5.0-2.0-4.1-9.1-7.1-2.1-5.1-2.0-1.0	99	142781	158583
HG02004.verkko_filt_mat.fa:haplotype1-0000022_97828542_98235483_0	HG02004.verkko_filt_mat.fa:haplotype1-0000022_97828542_98235483_0	158626	161442	6	12	0	0	11	2816	160157	157341	0-3-7-9-4-6-8-5-2-4-9-7-2-5-2-1	0.0-3.0-7.0-9.0-4.0-6.0-8.0-5.0-2.0-4.1-9.1-7.1-2.1-5.1-2.0-1.0	99	158527	161343
HG02004.verkko_filt_mat.fa:haplotype1-0000022_97828542_98235483_0	HG02004.verkko_filt_mat.fa:haplotype1-0000022_97828542_98235483_0	161386	163156	8	8	0	0	7	1770	161927	160157	0-3-7-9-4-6-8-5-2-4-9-7-2-5-2-1	0.0-3.0-7.0-9.0-4.0-6.0-8.0-5.0-2.0-4.1-9.1-7.1-2.1-5.1-2.0-1.0	99	161287	163057
HG02004.verkko_filt_mat.fa:haplotype1-0000022_97828542_98235483_0	HG02004.verkko_filt_mat.fa:haplotype1-0000022_97828542_98235483_0	163100	176204	5	79	0	0	78	13104	175031	161927	0-3-7-9-4-6-8-5-2-4-9-7-2-5-2-1	0.0-3.0-7.0-9.0-4.0-6.0-8.0-5.0-2.0-4.1-9.1-7.1-2.1-5.1-2.0-1.0	99	163001	176105
HG02004.verkko_filt_mat.fa:haplotype1-0000022_97828542_98235483_0	HG02004.verkko_filt_mat.fa:haplotype1-0000022_97828542_98235483_0	176148	210088	2	196	0	0	194	33940	208971	175031	0-3-7-9-4-6-8-5-2-4-9-7-2-5-2-1	0.0-3.0-7.0-9.0-4.0-6.0-8.0-5.0-2.0-4.1-9.1-7.1-2.1-5.1-2.0-1.0	99	176049	209989
HG02004.verkko_filt_mat.fa:haplotype1-0000022_97828542_98235483_0	HG02004.verkko_filt_mat.fa:haplotype1-0000022_97828542_98235483_0	212339	223889	4	84	1	58	4	11550	220521	208971	0-3-7-9-4-6-8-5-2-4-9-7-2-5-2-1	0.0-3.0-7.0-9.0-4.0-6.0-8.0-5.0-2.0-4.1-9.1-7.1-2.1-5.1-2.0-1.0	99	212240	223790
HG02004.verkko_filt_mat.fa:haplotype1-0000022_97828542_98235483_0	HG02004.verkko_filt_mat.fa:haplotype1-0000022_97828542_98235483_0	224956	226267	9	5	1	4	0	1311	221832	220521	0-3-7-9-4-6-8-5-2-4-9-7-2-5-2-1	0.0-3.0-7.0-9.0-4.0-6.0-8.0-5.0-2.0-4.1-9.1-7.1-2.1-5.1-2.0-1.0	99	224857	226168
HG02004.verkko_filt_mat.fa:haplotype1-0000022_97828542_98235483_0	HG02004.verkko_filt_mat.fa:haplotype1-0000022_97828542_98235483_0	226211	228251	7	12	1	11	0	2040	223872	221832	0-3-7-9-4-6-8-5-2-4-9-7-2-5-2-1	0.0-3.0-7.0-9.0-4.0-6.0-8.0-5.0-2.0-4.1-9.1-7.1-2.1-5.1-2.0-1.0	99	226112	228152
HG02004.verkko_filt_mat.fa:haplotype1-0000022_97828542_98235483_0	HG02004.verkko_filt_mat.fa:haplotype1-0000022_97828542_98235483_0	229713	263667	2	196	1	194	0	33954	257826	223872	0-3-7-9-4-6-8-5-2-4-9-7-2-5-2-1	0.0-3.0-7.0-9.0-4.0-6.0-8.0-5.0-2.0-4.1-9.1-7.1-2.1-5.1-2.0-1.0	99	229614	263568
HG02004.verkko_filt_mat.fa:haplotype1-0000022_97828542_98235483_0	HG02004.verkko_filt_mat.fa:haplotype1-0000022_97828542_98235483_0	263611	275739	5	79	1	78	5	12128	269954	257826	0-3-7-9-4-6-8-5-2-4-9-7-2-5-2-1	0.0-3.0-7.0-9.0-4.0-6.0-8.0-5.0-2.0-4.1-9.1-7.1-2.1-5.1-2.0-1.0	99	263512	275640
HG02004.verkko_filt_mat.fa:haplotype1-0000022_97828542_98235483_0	HG02004.verkko_filt_mat.fa:haplotype1-0000022_97828542_98235483_0	276705	304620	2	196	0	39	195	27915	297869	269954	0-3-7-9-4-6-8-5-2-4-9-7-2-5-2-1	0.0-3.0-7.0-9.0-4.0-6.0-8.0-5.0-2.0-4.1-9.1-7.1-2.1-5.1-2.0-1.0	99	276606	304521
HG02004.verkko_filt_mat.fa:haplotype1-0000022_97828542_98235483_0	HG02004.verkko_filt_mat.fa:haplotype1-0000022_97828542_98235483_0	304564	406997	1	612	0	0	606	102433	400302	297869	0-3-7-9-4-6-8-5-2-4-9-7-2-5-2-1	0.0-3.0-7.0-9.0-4.0-6.0-8.0-5.0-2.0-4.1-9.1-7.1-2.1-5.1-2.0-1.0	99	304465	406898
HG02004.verkko_filt_pat.fa:haplotype2-0000813_139386576_140076845_1	HG02004.verkko_filt_pat.fa:haplotype2-0000813_139386576_140076845_1	154	115548	0	672	0	0	671	115394	115394	0	0-3-7-9-4-6-8-5-2-4-9-7-2-5-2-4-9-7-2-5-2-4-9-7-2-5-2-4-9-7-2-5-2-1	0.0-3.0-7.0-9.0-4.0-6.0-8.0-5.0-2.0-4.1-9.1-7.1-2.1-5.1-2.0-4.1-9.1-7.1-2.1-5.1-2.0-4.1-9.1-7.1-2.1-5.1-2.0-4.1-9.1-7.1-2.1-5.0-2.0-1.0	154	0	115394
HG02004.verkko_filt_pat.fa:haplotype2-0000813_139386576_140076845_1	HG02004.verkko_filt_pat.fa:haplotype2-0000813_139386576_140076845_1	115639	138474	3	132	0	0	131	22835	138229	115394	0-3-7-9-4-6-8-5-2-4-9-7-2-5-2-4-9-7-2-5-2-4-9-7-2-5-2-4-9-7-2-5-2-1	0.0-3.0-7.0-9.0-4.0-6.0-8.0-5.0-2.0-4.1-9.1-7.1-2.1-5.1-2.0-4.1-9.1-7.1-2.1-5.1-2.0-4.1-9.1-7.1-2.1-5.1-2.0-4.1-9.1-7.1-2.1-5.0-2.0-1.0	154	115485	138320
HG02004.verkko_filt_pat.fa:haplotype2-0000813_139386576_140076845_1	HG02004.verkko_filt_pat.fa:haplotype2-0000813_139386576_140076845_1	139233	141273	7	12	0	0	11	2040	140269	138229	0-3-7-9-4-6-8-5-2-4-9-7-2-5-2-4-9-7-2-5-2-4-9-7-2-5-2-4-9-7-2-5-2-1	0.0-3.0-7.0-9.0-4.0-6.0-8.0-5.0-2.0-4.1-9.1-7.1-2.1-5.1-2.0-4.1-9.1-7.1-2.1-5.1-2.0-4.1-9.1-7.1-2.1-5.1-2.0-4.1-9.1-7.1-2.1-5.0-2.0-1.0	154	139079	141119
HG02004.verkko_filt_pat.fa:haplotype2-0000813_139386576_140076845_1	HG02004.verkko_filt_pat.fa:haplotype2-0000813_139386576_140076845_1	141217	142529	9	5	0	0	4	1312	141581	140269	0-3-7-9-4-6-8-5-2-4-9-7-2-5-2-4-9-7-2-5-2-4-9-7-2-5-2-4-9-7-2-5-2-1	0.0-3.0-7.0-9.0-4.0-6.0-8.0-5.0-2.0-4.1-9.1-7.1-2.1-5.1-2.0-4.1-9.1-7.1-2.1-5.1-2.0-4.1-9.1-7.1-2.1-5.1-2.0-4.1-9.1-7.1-2.1-5.0-2.0-1.0	154	141063	142375
HG02004.verkko_filt_pat.fa:haplotype2-0000813_139386576_140076845_1	HG02004.verkko_filt_pat.fa:haplotype2-0000813_139386576_140076845_1	142977	158773	4	84	0	0	83	15796	157377	141581	0-3-7-9-4-6-8-5-2-4-9-7-2-5-2-4-9-7-2-5-2-4-9-7-2-5-2-4-9-7-2-5-2-1	0.0-3.0-7.0-9.0-4.0-6.0-8.0-5.0-2.0-4.1-9.1-7.1-2.1-5.1-2.0-4.1-9.1-7.1-2.1-5.1-2.0-4.1-9.1-7.1-2.1-5.1-2.0-4.1-9.1-7.1-2.1-5.0-2.0-1.0	154	142823	158619
HG02004.verkko_filt_pat.fa:haplotype2-0000813_139386576_140076845_1	HG02004.verkko_filt_pat.fa:haplotype2-0000813_139386576_140076845_1	158717	161533	6	12	0	0	11	2816	160193	157377	0-3-7-9-4-6-8-5-2-4-9-7-2-5-2-4-9-7-2-5-2-4-9-7-2-5-2-4-9-7-2-5-2-1	0.0-3.0-7.0-9.0-4.0-6.0-8.0-5.0-2.0-4.1-9.1-7.1-2.1-5.1-2.0-4.1-9.1-7.1-2.1-5.1-2.0-4.1-9.1-7.1-2.1-5.1-2.0-4.1-9.1-7.1-2.1-5.0-2.0-1.0	154	158563	161379
HG02004.verkko_filt_pat.fa:haplotype2-0000813_139386576_140076845_1	HG02004.verkko_filt_pat.fa:haplotype2-0000813_139386576_140076845_1	161477	163247	8	8	0	0	7	1770	161963	160193	0-3-7-9-4-6-8-5-2-4-9-7-2-5-2-4-9-7-2-5-2-4-9-7-2-5-2-4-9-7-2-5-2-1	0.0-3.0-7.0-9.0-4.0-6.0-8.0-5.0-2.0-4.1-9.1-7.1-2.1-5.1-2.0-4.1-9.1-7.1-2.1-5.1-2.0-4.1-9.1-7.1-2.1-5.1-2.0-4.1-9.1-7.1-2.1-5.0-2.0-1.0	154	161323	163093
HG02004.verkko_filt_pat.fa:haplotype2-0000813_139386576_140076845_1	HG02004.verkko_filt_pat.fa:haplotype2-0000813_139386576_140076845_1	163191	175855	5	79	0	0	77	12664	174627	161963	0-3-7-9-4-6-8-5-2-4-9-7-2-5-2-4-9-7-2-5-2-4-9-7-2-5-2-4-9-7-2-5-2-1	0.0-3.0-7.0-9.0-4.0-6.0-8.0-5.0-2.0-4.1-9.1-7.1-2.1-5.1-2.0-4.1-9.1-7.1-2.1-5.1-2.0-4.1-9.1-7.1-2.1-5.1-2.0-4.1-9.1-7.1-2.1-5.0-2.0-1.0	154	163037	175701
HG02004.verkko_filt_pat.fa:haplotype2-0000813_139386576_140076845_1	HG02004.verkko_filt_pat.fa:haplotype2-0000813_139386576_140076845_1	176239	210182	2	196	0	0	194	33943	208570	174627	0-3-7-9-4-6-8-5-2-4-9-7-2-5-2-4-9-7-2-5-2-4-9-7-2-5-2-4-9-7-2-5-2-1	0.0-3.0-7.0-9.0-4.0-6.0-8.0-5.0-2.0-4.1-9.1-7.1-2.1-5.1-2.0-4.1-9.1-7.1-2.1-5.1-2.0-4.1-9.1-7.1-2.1-5.1-2.0-4.1-9.1-7.1-2.1-5.0-2.0-1.0	154	176085	210028
HG02004.verkko_filt_pat.fa:haplotype2-0000813_139386576_140076845_1	HG02004.verkko_filt_pat.fa:haplotype2-0000813_139386576_140076845_1	212433	223977	4	84	1	58	4	11544	220114	208570	0-3-7-9-4-6-8-5-2-4-9-7-2-5-2-4-9-7-2-5-2-4-9-7-2-5-2-4-9-7-2-5-2-1	0.0-3.0-7.0-9.0-4.0-6.0-8.0-5.0-2.0-4.1-9.1-7.1-2.1-5.1-2.0-4.1-9.1-7.1-2.1-5.1-2.0-4.1-9.1-7.1-2.1-5.1-2.0-4.1-9.1-7.1-2.1-5.0-2.0-1.0	154	212279	223823
HG02004.verkko_filt_pat.fa:haplotype2-0000813_139386576_140076845_1	HG02004.verkko_filt_pat.fa:haplotype2-0000813_139386576_140076845_1	225042	226353	9	5	1	4	0	1311	221425	220114	0-3-7-9-4-6-8-5-2-4-9-7-2-5-2-4-9-7-2-5-2-4-9-7-2-5-2-4-9-7-2-5-2-1	0.0-3.0-7.0-9.0-4.0-6.0-8.0-5.0-2.0-4.1-9.1-7.1-2.1-5.1-2.0-4.1-9.1-7.1-2.1-5.1-2.0-4.1-9.1-7.1-2.1-5.1-2.0-4.1-9.1-7.1-2.1-5.0-2.0-1.0	154	224888	226199
HG02004.verkko_filt_pat.fa:haplotype2-0000813_139386576_140076845_1	HG02004.verkko_filt_pat.fa:haplotype2-0000813_139386576_140076845_1	226297	228337	7	12	1	11	0	2040	223465	221425	0-3-7-9-4-6-8-5-2-4-9-7-2-5-2-4-9-7-2-5-2-4-9-7-2-5-2-4-9-7-2-5-2-1	0.0-3.0-7.0-9.0-4.0-6.0-8.0-5.0-2.0-4.1-9.1-7.1-2.1-5.1-2.0-4.1-9.1-7.1-2.1-5.1-2.0-4.1-9.1-7.1-2.1-5.1-2.0-4.1-9.1-7.1-2.1-5.0-2.0-1.0	154	226143	228183
HG02004.verkko_filt_pat.fa:haplotype2-0000813_139386576_140076845_1	HG02004.verkko_filt_pat.fa:haplotype2-0000813_139386576_140076845_1	229799	263741	2	196	1	194	0	33942	257407	223465	0-3-7-9-4-6-8-5-2-4-9-7-2-5-2-4-9-7-2-5-2-4-9-7-2-5-2-4-9-7-2-5-2-1	0.0-3.0-7.0-9.0-4.0-6.0-8.0-5.0-2.0-4.1-9.1-7.1-2.1-5.1-2.0-4.1-9.1-7.1-2.1-5.1-2.0-4.1-9.1-7.1-2.1-5.1-2.0-4.1-9.1-7.1-2.1-5.0-2.0-1.0	154	229645	263587
HG02004.verkko_filt_pat.fa:haplotype2-0000813_139386576_140076845_1	HG02004.verkko_filt_pat.fa:haplotype2-0000813_139386576_140076845_1	264125	275813	5	79	1	77	5	11688	269095	257407	0-3-7-9-4-6-8-5-2-4-9-7-2-5-2-4-9-7-2-5-2-4-9-7-2-5-2-4-9-7-2-5-2-1	0.0-3.0-7.0-9.0-4.0-6.0-8.0-5.0-2.0-4.1-9.1-7.1-2.1-5.1-2.0-4.1-9.1-7.1-2.1-5.1-2.0-4.1-9.1-7.1-2.1-5.1-2.0-4.1-9.1-7.1-2.1-5.0-2.0-1.0	154	263971	275659
HG02004.verkko_filt_pat.fa:haplotype2-0000813_139386576_140076845_1	HG02004.verkko_filt_pat.fa:haplotype2-0000813_139386576_140076845_1	276779	304314	2	196	0	39	194	27535	296630	269095	0-3-7-9-4-6-8-5-2-4-9-7-2-5-2-4-9-7-2-5-2-4-9-7-2-5-2-4-9-7-2-5-2-1	0.0-3.0-7.0-9.0-4.0-6.0-8.0-5.0-2.0-4.1-9.1-7.1-2.1-5.1-2.0-4.1-9.1-7.1-2.1-5.1-2.0-4.1-9.1-7.1-2.1-5.1-2.0-4.1-9.1-7.1-2.1-5.0-2.0-1.0	154	276625	304160
HG02004.verkko_filt_pat.fa:haplotype2-0000813_139386576_140076845_1	HG02004.verkko_filt_pat.fa:haplotype2-0000813_139386576_140076845_1	306565	318114	4	84	1	58	4	11549	308179	296630	0-3-7-9-4-6-8-5-2-4-9-7-2-5-2-4-9-7-2-5-2-4-9-7-2-5-2-4-9-7-2-5-2-1	0.0-3.0-7.0-9.0-4.0-6.0-8.0-5.0-2.0-4.1-9.1-7.1-2.1-5.1-2.0-4.1-9.1-7.1-2.1-5.1-2.0-4.1-9.1-7.1-2.1-5.1-2.0-4.1-9.1-7.1-2.1-5.0-2.0-1.0	154	306411	317960
HG02004.verkko_filt_pat.fa:haplotype2-0000813_139386576_140076845_1	HG02004.verkko_filt_pat.fa:haplotype2-0000813_139386576_140076845_1	319179	320490	9	5	1	4	0	1311	309490	308179	0-3-7-9-4-6-8-5-2-4-9-7-2-5-2-4-9-7-2-5-2-4-9-7-2-5-2-4-9-7-2-5-2-1	0.0-3.0-7.0-9.0-4.0-6.0-8.0-5.0-2.0-4.1-9.1-7.1-2.1-5.1-2.0-4.1-9.1-7.1-2.1-5.1-2.0-4.1-9.1-7.1-2.1-5.1-2.0-4.1-9.1-7.1-2.1-5.0-2.0-1.0	154	319025	320336
HG02004.verkko_filt_pat.fa:haplotype2-0000813_139386576_140076845_1	HG02004.verkko_filt_pat.fa:haplotype2-0000813_139386576_140076845_1	320434	322474	7	12	1	11	0	2040	311530	309490	0-3-7-9-4-6-8-5-2-4-9-7-2-5-2-4-9-7-2-5-2-4-9-7-2-5-2-4-9-7-2-5-2-1	0.0-3.0-7.0-9.0-4.0-6.0-8.0-5.0-2.0-4.1-9.1-7.1-2.1-5.1-2.0-4.1-9.1-7.1-2.1-5.1-2.0-4.1-9.1-7.1-2.1-5.1-2.0-4.1-9.1-7.1-2.1-5.0-2.0-1.0	154	320280	322320
HG02004.verkko_filt_pat.fa:haplotype2-0000813_139386576_140076845_1	HG02004.verkko_filt_pat.fa:haplotype2-0000813_139386576_140076845_1	323936	357878	2	196	1	194	0	33942	345472	311530	0-3-7-9-4-6-8-5-2-4-9-7-2-5-2-4-9-7-2-5-2-4-9-7-2-5-2-4-9-7-2-5-2-1	0.0-3.0-7.0-9.0-4.0-6.0-8.0-5.0-2.0-4.1-9.1-7.1-2.1-5.1-2.0-4.1-9.1-7.1-2.1-5.1-2.0-4.1-9.1-7.1-2.1-5.1-2.0-4.1-9.1-7.1-2.1-5.0-2.0-1.0	154	323782	357724
HG02004.verkko_filt_pat.fa:haplotype2-0000813_139386576_140076845_1	HG02004.verkko_filt_pat.fa:haplotype2-0000813_139386576_140076845_1	358262	369950	5	79	1	77	5	11688	357160	345472	0-3-7-9-4-6-8-5-2-4-9-7-2-5-2-4-9-7-2-5-2-4-9-7-2-5-2-4-9-7-2-5-2-1	0.0-3.0-7.0-9.0-4.0-6.0-8.0-5.0-2.0-4.1-9.1-7.1-2.1-5.1-2.0-4.1-9.1-7.1-2.1-5.1-2.0-4.1-9.1-7.1-2.1-5.1-2.0-4.1-9.1-7.1-2.1-5.0-2.0-1.0	154	358108	369796
HG02004.verkko_filt_pat.fa:haplotype2-0000813_139386576_140076845_1	HG02004.verkko_filt_pat.fa:haplotype2-0000813_139386576_140076845_1	370916	398450	2	196	0	39	194	27534	384694	357160	0-3-7-9-4-6-8-5-2-4-9-7-2-5-2-4-9-7-2-5-2-4-9-7-2-5-2-4-9-7-2-5-2-1	0.0-3.0-7.0-9.0-4.0-6.0-8.0-5.0-2.0-4.1-9.1-7.1-2.1-5.1-2.0-4.1-9.1-7.1-2.1-5.1-2.0-4.1-9.1-7.1-2.1-5.1-2.0-4.1-9.1-7.1-2.1-5.0-2.0-1.0	154	370762	398296
HG02004.verkko_filt_pat.fa:haplotype2-0000813_139386576_140076845_1	HG02004.verkko_filt_pat.fa:haplotype2-0000813_139386576_140076845_1	400701	412246	4	84	1	58	4	11545	396239	384694	0-3-7-9-4-6-8-5-2-4-9-7-2-5-2-4-9-7-2-5-2-4-9-7-2-5-2-4-9-7-2-5-2-1	0.0-3.0-7.0-9.0-4.0-6.0-8.0-5.0-2.0-4.1-9.1-7.1-2.1-5.1-2.0-4.1-9.1-7.1-2.1-5.1-2.0-4.1-9.1-7.1-2.1-5.1-2.0-4.1-9.1-7.1-2.1-5.0-2.0-1.0	154	400547	412092
HG02004.verkko_filt_pat.fa:haplotype2-0000813_139386576_140076845_1	HG02004.verkko_filt_pat.fa:haplotype2-0000813_139386576_140076845_1	413311	414622	9	5	1	4	0	1311	397550	396239	0-3-7-9-4-6-8-5-2-4-9-7-2-5-2-4-9-7-2-5-2-4-9-7-2-5-2-4-9-7-2-5-2-1	0.0-3.0-7.0-9.0-4.0-6.0-8.0-5.0-2.0-4.1-9.1-7.1-2.1-5.1-2.0-4.1-9.1-7.1-2.1-5.1-2.0-4.1-9.1-7.1-2.1-5.1-2.0-4.1-9.1-7.1-2.1-5.0-2.0-1.0	154	413157	414468
HG02004.verkko_filt_pat.fa:haplotype2-0000813_139386576_140076845_1	HG02004.verkko_filt_pat.fa:haplotype2-0000813_139386576_140076845_1	414566	416606	7	12	1	11	0	2040	399590	397550	0-3-7-9-4-6-8-5-2-4-9-7-2-5-2-4-9-7-2-5-2-4-9-7-2-5-2-4-9-7-2-5-2-1	0.0-3.0-7.0-9.0-4.0-6.0-8.0-5.0-2.0-4.1-9.1-7.1-2.1-5.1-2.0-4.1-9.1-7.1-2.1-5.1-2.0-4.1-9.1-7.1-2.1-5.1-2.0-4.1-9.1-7.1-2.1-5.0-2.0-1.0	154	414412	416452
HG02004.verkko_filt_pat.fa:haplotype2-0000813_139386576_140076845_1	HG02004.verkko_filt_pat.fa:haplotype2-0000813_139386576_140076845_1	418068	452012	2	196	1	194	0	33944	433534	399590	0-3-7-9-4-6-8-5-2-4-9-7-2-5-2-4-9-7-2-5-2-4-9-7-2-5-2-4-9-7-2-5-2-1	0.0-3.0-7.0-9.0-4.0-6.0-8.0-5.0-2.0-4.1-9.1-7.1-2.1-5.1-2.0-4.1-9.1-7.1-2.1-5.1-2.0-4.1-9.1-7.1-2.1-5.1-2.0-4.1-9.1-7.1-2.1-5.0-2.0-1.0	154	417914	451858
HG02004.verkko_filt_pat.fa:haplotype2-0000813_139386576_140076845_1	HG02004.verkko_filt_pat.fa:haplotype2-0000813_139386576_140076845_1	451956	464084	5	79	1	78	5	12128	445662	433534	0-3-7-9-4-6-8-5-2-4-9-7-2-5-2-4-9-7-2-5-2-4-9-7-2-5-2-4-9-7-2-5-2-1	0.0-3.0-7.0-9.0-4.0-6.0-8.0-5.0-2.0-4.1-9.1-7.1-2.1-5.1-2.0-4.1-9.1-7.1-2.1-5.1-2.0-4.1-9.1-7.1-2.1-5.1-2.0-4.1-9.1-7.1-2.1-5.0-2.0-1.0	154	451802	463930
HG02004.verkko_filt_pat.fa:haplotype2-0000813_139386576_140076845_1	HG02004.verkko_filt_pat.fa:haplotype2-0000813_139386576_140076845_1	465050	492236	2	196	0	39	191	27186	472848	445662	0-3-7-9-4-6-8-5-2-4-9-7-2-5-2-4-9-7-2-5-2-4-9-7-2-5-2-4-9-7-2-5-2-1	0.0-3.0-7.0-9.0-4.0-6.0-8.0-5.0-2.0-4.1-9.1-7.1-2.1-5.1-2.0-4.1-9.1-7.1-2.1-5.1-2.0-4.1-9.1-7.1-2.1-5.1-2.0-4.1-9.1-7.1-2.1-5.0-2.0-1.0	154	464896	492082
HG02004.verkko_filt_pat.fa:haplotype2-0000813_139386576_140076845_1	HG02004.verkko_filt_pat.fa:haplotype2-0000813_139386576_140076845_1	494828	506374	4	84	1	58	4	11546	484394	472848	0-3-7-9-4-6-8-5-2-4-9-7-2-5-2-4-9-7-2-5-2-4-9-7-2-5-2-4-9-7-2-5-2-1	0.0-3.0-7.0-9.0-4.0-6.0-8.0-5.0-2.0-4.1-9.1-7.1-2.1-5.1-2.0-4.1-9.1-7.1-2.1-5.1-2.0-4.1-9.1-7.1-2.1-5.1-2.0-4.1-9.1-7.1-2.1-5.0-2.0-1.0	154	494674	506220
HG02004.verkko_filt_pat.fa:haplotype2-0000813_139386576_140076845_1	HG02004.verkko_filt_pat.fa:haplotype2-0000813_139386576_140076845_1	507441	508752	9	5	1	4	0	1311	485705	484394	0-3-7-9-4-6-8-5-2-4-9-7-2-5-2-4-9-7-2-5-2-4-9-7-2-5-2-4-9-7-2-5-2-1	0.0-3.0-7.0-9.0-4.0-6.0-8.0-5.0-2.0-4.1-9.1-7.1-2.1-5.1-2.0-4.1-9.1-7.1-2.1-5.1-2.0-4.1-9.1-7.1-2.1-5.1-2.0-4.1-9.1-7.1-2.1-5.0-2.0-1.0	154	507287	508598
HG02004.verkko_filt_pat.fa:haplotype2-0000813_139386576_140076845_1	HG02004.verkko_filt_pat.fa:haplotype2-0000813_139386576_140076845_1	508696	510736	7	12	1	11	0	2040	487745	485705	0-3-7-9-4-6-8-5-2-4-9-7-2-5-2-4-9-7-2-5-2-4-9-7-2-5-2-4-9-7-2-5-2-1	0.0-3.0-7.0-9.0-4.0-6.0-8.0-5.0-2.0-4.1-9.1-7.1-2.1-5.1-2.0-4.1-9.1-7.1-2.1-5.1-2.0-4.1-9.1-7.1-2.1-5.1-2.0-4.1-9.1-7.1-2.1-5.0-2.0-1.0	154	508542	510582
HG02004.verkko_filt_pat.fa:haplotype2-0000813_139386576_140076845_1	HG02004.verkko_filt_pat.fa:haplotype2-0000813_139386576_140076845_1	512198	539732	2	196	1	194	39	27534	515279	487745	0-3-7-9-4-6-8-5-2-4-9-7-2-5-2-4-9-7-2-5-2-4-9-7-2-5-2-4-9-7-2-5-2-1	0.0-3.0-7.0-9.0-4.0-6.0-8.0-5.0-2.0-4.1-9.1-7.1-2.1-5.1-2.0-4.1-9.1-7.1-2.1-5.1-2.0-4.1-9.1-7.1-2.1-5.1-2.0-4.1-9.1-7.1-2.1-5.0-2.0-1.0	154	512044	539578
HG02004.verkko_filt_pat.fa:haplotype2-0000813_139386576_140076845_1	HG02004.verkko_filt_pat.fa:haplotype2-0000813_139386576_140076845_1	540698	552826	5	79	0	5	78	12128	527407	515279	0-3-7-9-4-6-8-5-2-4-9-7-2-5-2-4-9-7-2-5-2-4-9-7-2-5-2-4-9-7-2-5-2-1	0.0-3.0-7.0-9.0-4.0-6.0-8.0-5.0-2.0-4.1-9.1-7.1-2.1-5.1-2.0-4.1-9.1-7.1-2.1-5.1-2.0-4.1-9.1-7.1-2.1-5.1-2.0-4.1-9.1-7.1-2.1-5.0-2.0-1.0	154	540544	552672
HG02004.verkko_filt_pat.fa:haplotype2-0000813_139386576_140076845_1	HG02004.verkko_filt_pat.fa:haplotype2-0000813_139386576_140076845_1	552770	587086	2	196	0	0	195	34316	561723	527407	0-3-7-9-4-6-8-5-2-4-9-7-2-5-2-4-9-7-2-5-2-4-9-7-2-5-2-4-9-7-2-5-2-1	0.0-3.0-7.0-9.0-4.0-6.0-8.0-5.0-2.0-4.1-9.1-7.1-2.1-5.1-2.0-4.1-9.1-7.1-2.1-5.1-2.0-4.1-9.1-7.1-2.1-5.1-2.0-4.1-9.1-7.1-2.1-5.0-2.0-1.0	154	552616	586932
HG02004.verkko_filt_pat.fa:haplotype2-0000813_139386576_140076845_1	HG02004.verkko_filt_pat.fa:haplotype2-0000813_139386576_140076845_1	587030	690253	1	612	0	0	611	103223	664946	561723	0-3-7-9-4-6-8-5-2-4-9-7-2-5-2-4-9-7-2-5-2-4-9-7-2-5-2-4-9-7-2-5-2-1	0.0-3.0-7.0-9.0-4.0-6.0-8.0-5.0-2.0-4.1-9.1-7.1-2.1-5.1-2.0-4.1-9.1-7.1-2.1-5.1-2.0-4.1-9.1-7.1-2.1-5.1-2.0-4.1-9.1-7.1-2.1-5.0-2.0-1.0	154	586876	690099
HG02055#2#JAHEPJ010000017.1_24870122_25298560_1	HG02055	154	115477	0	672	0	0	671	115323	115323	0	0-3-7-9-4-6-8-5-2-4-0-3-7-9-4-6-8-5-2-1	0.0-3.0-7.0-9.0-4.0-6.0-8.0-5.0-2.0-4.1-0.0-3.0-7.0-9.0-4.0-6.0-8.0-5.0-2.0-1.0	154	0	115323
HG02055#2#JAHEPJ010000017.1_24870122_25298560_1	HG02055	115568	138400	3	132	0	0	131	22832	138155	115323	0-3-7-9-4-6-8-5-2-4-0-3-7-9-4-6-8-5-2-1	0.0-3.0-7.0-9.0-4.0-6.0-8.0-5.0-2.0-4.1-0.0-3.0-7.0-9.0-4.0-6.0-8.0-5.0-2.0-1.0	154	115414	138246
HG02055#2#JAHEPJ010000017.1_24870122_25298560_1	HG02055	139159	141200	7	12	0	0	11	2041	140196	138155	0-3-7-9-4-6-8-5-2-4-0-3-7-9-4-6-8-5-2-1	0.0-3.0-7.0-9.0-4.0-6.0-8.0-5.0-2.0-4.1-0.0-3.0-7.0-9.0-4.0-6.0-8.0-5.0-2.0-1.0	154	139005	141046
HG02055#2#JAHEPJ010000017.1_24870122_25298560_1	HG02055	141144	142455	9	5	0	0	4	1311	141507	140196	0-3-7-9-4-6-8-5-2-4-0-3-7-9-4-6-8-5-2-1	0.0-3.0-7.0-9.0-4.0-6.0-8.0-5.0-2.0-4.1-0.0-3.0-7.0-9.0-4.0-6.0-8.0-5.0-2.0-1.0	154	140990	142301
HG02055#2#JAHEPJ010000017.1_24870122_25298560_1	HG02055	142903	158715	4	84	0	0	83	15812	157319	141507	0-3-7-9-4-6-8-5-2-4-0-3-7-9-4-6-8-5-2-1	0.0-3.0-7.0-9.0-4.0-6.0-8.0-5.0-2.0-4.1-0.0-3.0-7.0-9.0-4.0-6.0-8.0-5.0-2.0-1.0	154	142749	158561
HG02055#2#JAHEPJ010000017.1_24870122_25298560_1	HG02055	158659	161474	6	12	0	0	11	2815	160134	157319	0-3-7-9-4-6-8-5-2-4-0-3-7-9-4-6-8-5-2-1	0.0-3.0-7.0-9.0-4.0-6.0-8.0-5.0-2.0-4.1-0.0-3.0-7.0-9.0-4.0-6.0-8.0-5.0-2.0-1.0	154	158505	161320
HG02055#2#JAHEPJ010000017.1_24870122_25298560_1	HG02055	161418	163188	8	8	0	0	7	1770	161904	160134	0-3-7-9-4-6-8-5-2-4-0-3-7-9-4-6-8-5-2-1	0.0-3.0-7.0-9.0-4.0-6.0-8.0-5.0-2.0-4.1-0.0-3.0-7.0-9.0-4.0-6.0-8.0-5.0-2.0-1.0	154	161264	163034
HG02055#2#JAHEPJ010000017.1_24870122_25298560_1	HG02055	163132	176236	5	79	0	0	78	13104	175008	161904	0-3-7-9-4-6-8-5-2-4-0-3-7-9-4-6-8-5-2-1	0.0-3.0-7.0-9.0-4.0-6.0-8.0-5.0-2.0-4.1-0.0-3.0-7.0-9.0-4.0-6.0-8.0-5.0-2.0-1.0	154	162978	176082
HG02055#2#JAHEPJ010000017.1_24870122_25298560_1	HG02055	176180	210496	2	196	0	0	195	34316	209324	175008	0-3-7-9-4-6-8-5-2-4-0-3-7-9-4-6-8-5-2-1	0.0-3.0-7.0-9.0-4.0-6.0-8.0-5.0-2.0-4.1-0.0-3.0-7.0-9.0-4.0-6.0-8.0-5.0-2.0-1.0	154	176026	210342
HG02055#2#JAHEPJ010000017.1_24870122_25298560_1	HG02055	212362	220842	4	84	1	58	22	8480	217804	209324	0-3-7-9-4-6-8-5-2-4-0-3-7-9-4-6-8-5-2-1	0.0-3.0-7.0-9.0-4.0-6.0-8.0-5.0-2.0-4.1-0.0-3.0-7.0-9.0-4.0-6.0-8.0-5.0-2.0-1.0	154	212208	220688
HG02055#2#JAHEPJ010000017.1_24870122_25298560_1	HG02055	221019	231226	0	672	0	604	671	10207	228011	217804	0-3-7-9-4-6-8-5-2-4-0-3-7-9-4-6-8-5-2-1	0.0-3.0-7.0-9.0-4.0-6.0-8.0-5.0-2.0-4.1-0.0-3.0-7.0-9.0-4.0-6.0-8.0-5.0-2.0-1.0	154	220865	231072
HG02055#2#JAHEPJ010000017.1_24870122_25298560_1	HG02055	231317	254149	3	132	0	0	131	22832	250843	228011	0-3-7-9-4-6-8-5-2-4-0-3-7-9-4-6-8-5-2-1	0.0-3.0-7.0-9.0-4.0-6.0-8.0-5.0-2.0-4.1-0.0-3.0-7.0-9.0-4.0-6.0-8.0-5.0-2.0-1.0	154	231163	253995
HG02055#2#JAHEPJ010000017.1_24870122_25298560_1	HG02055	254908	256949	7	12	0	0	11	2041	252884	250843	0-3-7-9-4-6-8-5-2-4-0-3-7-9-4-6-8-5-2-1	0.0-3.0-7.0-9.0-4.0-6.0-8.0-5.0-2.0-4.1-0.0-3.0-7.0-9.0-4.0-6.0-8.0-5.0-2.0-1.0	154	254754	256795
HG02055#2#JAHEPJ010000017.1_24870122_25298560_1	HG02055	256893	258204	9	5	0	0	4	1311	254195	252884	0-3-7-9-4-6-8-5-2-4-0-3-7-9-4-6-8-5-2-1	0.0-3.0-7.0-9.0-4.0-6.0-8.0-5.0-2.0-4.1-0.0-3.0-7.0-9.0-4.0-6.0-8.0-5.0-2.0-1.0	154	256739	258050
HG02055#2#JAHEPJ010000017.1_24870122_25298560_1	HG02055	258652	274464	4	84	0	0	83	15812	270007	254195	0-3-7-9-4-6-8-5-2-4-0-3-7-9-4-6-8-5-2-1	0.0-3.0-7.0-9.0-4.0-6.0-8.0-5.0-2.0-4.1-0.0-3.0-7.0-9.0-4.0-6.0-8.0-5.0-2.0-1.0	154	258498	274310
HG02055#2#JAHEPJ010000017.1_24870122_25298560_1	HG02055	274408	277223	6	12	0	0	11	2815	272822	270007	0-3-7-9-4-6-8-5-2-4-0-3-7-9-4-6-8-5-2-1	0.0-3.0-7.0-9.0-4.0-6.0-8.0-5.0-2.0-4.1-0.0-3.0-7.0-9.0-4.0-6.0-8.0-5.0-2.0-1.0	154	274254	277069
HG02055#2#JAHEPJ010000017.1_24870122_25298560_1	HG02055	277167	278937	8	8	0	0	7	1770	274592	272822	0-3-7-9-4-6-8-5-2-4-0-3-7-9-4-6-8-5-2-1	0.0-3.0-7.0-9.0-4.0-6.0-8.0-5.0-2.0-4.1-0.0-3.0-7.0-9.0-4.0-6.0-8.0-5.0-2.0-1.0	154	277013	278783
HG02055#2#JAHEPJ010000017.1_24870122_25298560_1	HG02055	278881	291985	5	79	0	0	78	13104	287696	274592	0-3-7-9-4-6-8-5-2-4-0-3-7-9-4-6-8-5-2-1	0.0-3.0-7.0-9.0-4.0-6.0-8.0-5.0-2.0-4.1-0.0-3.0-7.0-9.0-4.0-6.0-8.0-5.0-2.0-1.0	154	278727	291831
HG02055#2#JAHEPJ010000017.1_24870122_25298560_1	HG02055	291929	326257	2	196	0	0	195	34328	322024	287696	0-3-7-9-4-6-8-5-2-4-0-3-7-9-4-6-8-5-2-1	0.0-3.0-7.0-9.0-4.0-6.0-8.0-5.0-2.0-4.1-0.0-3.0-7.0-9.0-4.0-6.0-8.0-5.0-2.0-1.0	154	291775	326103
HG02055#2#JAHEPJ010000017.1_24870122_25298560_1	HG02055	326201	428376	1	612	0	0	605	102175	424199	322024	0-3-7-9-4-6-8-5-2-4-0-3-7-9-4-6-8-5-2-1	0.0-3.0-7.0-9.0-4.0-6.0-8.0-5.0-2.0-4.1-0.0-3.0-7.0-9.0-4.0-6.0-8.0-5.0-2.0-1.0	154	326047	428222
HG02071.verkko_filt_mat.fa:haplotype1-0000041_103610513_104018399_0	HG02071.verkko_filt_mat.fa:haplotype1-0000041_103610513_104018399_0	99	115486	0	672	0	0	671	115387	115387	0	0-3-7-9-4-6-8-5-2-4-9-7-2-5-2-1	0.0-3.0-7.0-9.0-4.0-6.0-8.0-5.0-2.0-4.1-9.1-7.1-2.1-5.0-2.0-1.0	99	0	115387
HG02071.verkko_filt_mat.fa:haplotype1-0000041_103610513_104018399_0	HG02071.verkko_filt_mat.fa:haplotype1-0000041_103610513_104018399_0	115577	138414	3	132	0	0	131	22837	138224	115387	0-3-7-9-4-6-8-5-2-4-9-7-2-5-2-1	0.0-3.0-7.0-9.0-4.0-6.0-8.0-5.0-2.0-4.1-9.1-7.1-2.1-5.0-2.0-1.0	99	115478	138315
HG02071.verkko_filt_mat.fa:haplotype1-0000041_103610513_104018399_0	HG02071.verkko_filt_mat.fa:haplotype1-0000041_103610513_104018399_0	139173	141213	7	12	0	0	11	2040	140264	138224	0-3-7-9-4-6-8-5-2-4-9-7-2-5-2-1	0.0-3.0-7.0-9.0-4.0-6.0-8.0-5.0-2.0-4.1-9.1-7.1-2.1-5.0-2.0-1.0	99	139074	141114
HG02071.verkko_filt_mat.fa:haplotype1-0000041_103610513_104018399_0	HG02071.verkko_filt_mat.fa:haplotype1-0000041_103610513_104018399_0	141157	142469	9	5	0	0	4	1312	141576	140264	0-3-7-9-4-6-8-5-2-4-9-7-2-5-2-1	0.0-3.0-7.0-9.0-4.0-6.0-8.0-5.0-2.0-4.1-9.1-7.1-2.1-5.0-2.0-1.0	99	141058	142370
HG02071.verkko_filt_mat.fa:haplotype1-0000041_103610513_104018399_0	HG02071.verkko_filt_mat.fa:haplotype1-0000041_103610513_104018399_0	142917	158712	4	84	0	0	83	15795	157371	141576	0-3-7-9-4-6-8-5-2-4-9-7-2-5-2-1	0.0-3.0-7.0-9.0-4.0-6.0-8.0-5.0-2.0-4.1-9.1-7.1-2.1-5.0-2.0-1.0	99	142818	158613
HG02071.verkko_filt_mat.fa:haplotype1-0000041_103610513_104018399_0	HG02071.verkko_filt_mat.fa:haplotype1-0000041_103610513_104018399_0	158656	161472	6	12	0	0	11	2816	160187	157371	0-3-7-9-4-6-8-5-2-4-9-7-2-5-2-1	0.0-3.0-7.0-9.0-4.0-6.0-8.0-5.0-2.0-4.1-9.1-7.1-2.1-5.0-2.0-1.0	99	158557	161373
HG02071.verkko_filt_mat.fa:haplotype1-0000041_103610513_104018399_0	HG02071.verkko_filt_mat.fa:haplotype1-0000041_103610513_104018399_0	161416	162942	8	8	0	0	6	1526	161713	160187	0-3-7-9-4-6-8-5-2-4-9-7-2-5-2-1	0.0-3.0-7.0-9.0-4.0-6.0-8.0-5.0-2.0-4.1-9.1-7.1-2.1-5.0-2.0-1.0	99	161317	162843
HG02071.verkko_filt_mat.fa:haplotype1-0000041_103610513_104018399_0	HG02071.verkko_filt_mat.fa:haplotype1-0000041_103610513_104018399_0	163130	176234	5	79	0	0	78	13104	174817	161713	0-3-7-9-4-6-8-5-2-4-9-7-2-5-2-1	0.0-3.0-7.0-9.0-4.0-6.0-8.0-5.0-2.0-4.1-9.1-7.1-2.1-5.0-2.0-1.0	99	163031	176135
HG02071.verkko_filt_mat.fa:haplotype1-0000041_103610513_104018399_0	HG02071.verkko_filt_mat.fa:haplotype1-0000041_103610513_104018399_0	176178	210115	2	196	0	0	194	33937	208754	174817	0-3-7-9-4-6-8-5-2-4-9-7-2-5-2-1	0.0-3.0-7.0-9.0-4.0-6.0-8.0-5.0-2.0-4.1-9.1-7.1-2.1-5.0-2.0-1.0	99	176079	210016
HG02071.verkko_filt_mat.fa:haplotype1-0000041_103610513_104018399_0	HG02071.verkko_filt_mat.fa:haplotype1-0000041_103610513_104018399_0	212366	223913	4	84	1	58	4	11547	220301	208754	0-3-7-9-4-6-8-5-2-4-9-7-2-5-2-1	0.0-3.0-7.0-9.0-4.0-6.0-8.0-5.0-2.0-4.1-9.1-7.1-2.1-5.0-2.0-1.0	99	212267	223814
HG02071.verkko_filt_mat.fa:haplotype1-0000041_103610513_104018399_0	HG02071.verkko_filt_mat.fa:haplotype1-0000041_103610513_104018399_0	224978	226289	9	5	1	4	0	1311	221612	220301	0-3-7-9-4-6-8-5-2-4-9-7-2-5-2-1	0.0-3.0-7.0-9.0-4.0-6.0-8.0-5.0-2.0-4.1-9.1-7.1-2.1-5.0-2.0-1.0	99	224879	226190
HG02071.verkko_filt_mat.fa:haplotype1-0000041_103610513_104018399_0	HG02071.verkko_filt_mat.fa:haplotype1-0000041_103610513_104018399_0	226233	228273	7	12	1	11	0	2040	223652	221612	0-3-7-9-4-6-8-5-2-4-9-7-2-5-2-1	0.0-3.0-7.0-9.0-4.0-6.0-8.0-5.0-2.0-4.1-9.1-7.1-2.1-5.0-2.0-1.0	99	226134	228174
HG02071.verkko_filt_mat.fa:haplotype1-0000041_103610513_104018399_0	HG02071.verkko_filt_mat.fa:haplotype1-0000041_103610513_104018399_0	229735	257265	2	196	1	194	39	27530	251182	223652	0-3-7-9-4-6-8-5-2-4-9-7-2-5-2-1	0.0-3.0-7.0-9.0-4.0-6.0-8.0-5.0-2.0-4.1-9.1-7.1-2.1-5.0-2.0-1.0	99	229636	257166
HG02071.verkko_filt_mat.fa:haplotype1-0000041_103610513_104018399_0	HG02071.verkko_filt_mat.fa:haplotype1-0000041_103610513_104018399_0	258231	269919	5	79	0	5	77	11688	262870	251182	0-3-7-9-4-6-8-5-2-4-9-7-2-5-2-1	0.0-3.0-7.0-9.0-4.0-6.0-8.0-5.0-2.0-4.1-9.1-7.1-2.1-5.0-2.0-1.0	99	258132	269820
HG02071.verkko_filt_mat.fa:haplotype1-0000041_103610513_104018399_0	HG02071.verkko_filt_mat.fa:haplotype1-0000041_103610513_104018399_0	270526	304629	2	196	0	1	195	34103	296973	262870	0-3-7-9-4-6-8-5-2-4-9-7-2-5-2-1	0.0-3.0-7.0-9.0-4.0-6.0-8.0-5.0-2.0-4.1-9.1-7.1-2.1-5.0-2.0-1.0	99	270427	304530
HG02071.verkko_filt_mat.fa:haplotype1-0000041_103610513_104018399_0	HG02071.verkko_filt_mat.fa:haplotype1-0000041_103610513_104018399_0	304573	407814	1	612	0	0	611	103241	400214	296973	0-3-7-9-4-6-8-5-2-4-9-7-2-5-2-1	0.0-3.0-7.0-9.0-4.0-6.0-8.0-5.0-2.0-4.1-9.1-7.1-2.1-5.0-2.0-1.0	99	304474	407715
HG02071.verkko_filt_pat.fa:haplotype2-0000736_102745972_103248026_0	HG02071.verkko_filt_pat.fa:haplotype2-0000736_102745972_103248026_0	99	115493	0	672	0	0	671	115394	115394	0	0-3-7-9-4-6-8-5-2-4-9-7-2-5-2-4-9-7-2-5-2-1	0.0-3.0-7.0-9.0-4.0-6.0-8.0-5.0-2.0-4.1-9.1-7.1-2.1-5.1-2.0-4.1-9.1-7.1-2.1-5.1-2.0-1.0	99	0	115394
HG02071.verkko_filt_pat.fa:haplotype2-0000736_102745972_103248026_0	HG02071.verkko_filt_pat.fa:haplotype2-0000736_102745972_103248026_0	115584	138421	3	132	0	0	131	22837	138231	115394	0-3-7-9-4-6-8-5-2-4-9-7-2-5-2-4-9-7-2-5-2-1	0.0-3.0-7.0-9.0-4.0-6.0-8.0-5.0-2.0-4.1-9.1-7.1-2.1-5.1-2.0-4.1-9.1-7.1-2.1-5.1-2.0-1.0	99	115485	138322
HG02071.verkko_filt_pat.fa:haplotype2-0000736_102745972_103248026_0	HG02071.verkko_filt_pat.fa:haplotype2-0000736_102745972_103248026_0	139180	141220	7	12	0	0	11	2040	140271	138231	0-3-7-9-4-6-8-5-2-4-9-7-2-5-2-4-9-7-2-5-2-1	0.0-3.0-7.0-9.0-4.0-6.0-8.0-5.0-2.0-4.1-9.1-7.1-2.1-5.1-2.0-4.1-9.1-7.1-2.1-5.1-2.0-1.0	99	139081	141121
HG02071.verkko_filt_pat.fa:haplotype2-0000736_102745972_103248026_0	HG02071.verkko_filt_pat.fa:haplotype2-0000736_102745972_103248026_0	141164	142476	9	5	0	0	4	1312	141583	140271	0-3-7-9-4-6-8-5-2-4-9-7-2-5-2-4-9-7-2-5-2-1	0.0-3.0-7.0-9.0-4.0-6.0-8.0-5.0-2.0-4.1-9.1-7.1-2.1-5.1-2.0-4.1-9.1-7.1-2.1-5.1-2.0-1.0	99	141065	142377
HG02071.verkko_filt_pat.fa:haplotype2-0000736_102745972_103248026_0	HG02071.verkko_filt_pat.fa:haplotype2-0000736_102745972_103248026_0	142924	158719	4	84	0	0	83	15795	157378	141583	0-3-7-9-4-6-8-5-2-4-9-7-2-5-2-4-9-7-2-5-2-1	0.0-3.0-7.0-9.0-4.0-6.0-8.0-5.0-2.0-4.1-9.1-7.1-2.1-5.1-2.0-4.1-9.1-7.1-2.1-5.1-2.0-1.0	99	142825	158620
HG02071.verkko_filt_pat.fa:haplotype2-0000736_102745972_103248026_0	HG02071.verkko_filt_pat.fa:haplotype2-0000736_102745972_103248026_0	158663	161479	6	12	0	0	11	2816	160194	157378	0-3-7-9-4-6-8-5-2-4-9-7-2-5-2-4-9-7-2-5-2-1	0.0-3.0-7.0-9.0-4.0-6.0-8.0-5.0-2.0-4.1-9.1-7.1-2.1-5.1-2.0-4.1-9.1-7.1-2.1-5.1-2.0-1.0	99	158564	161380
HG02071.verkko_filt_pat.fa:haplotype2-0000736_102745972_103248026_0	HG02071.verkko_filt_pat.fa:haplotype2-0000736_102745972_103248026_0	161423	163193	8	8	0	0	7	1770	161964	160194	0-3-7-9-4-6-8-5-2-4-9-7-2-5-2-4-9-7-2-5-2-1	0.0-3.0-7.0-9.0-4.0-6.0-8.0-5.0-2.0-4.1-9.1-7.1-2.1-5.1-2.0-4.1-9.1-7.1-2.1-5.1-2.0-1.0	99	161324	163094
HG02071.verkko_filt_pat.fa:haplotype2-0000736_102745972_103248026_0	HG02071.verkko_filt_pat.fa:haplotype2-0000736_102745972_103248026_0	163137	175801	5	79	0	0	77	12664	174628	161964	0-3-7-9-4-6-8-5-2-4-9-7-2-5-2-4-9-7-2-5-2-1	0.0-3.0-7.0-9.0-4.0-6.0-8.0-5.0-2.0-4.1-9.1-7.1-2.1-5.1-2.0-4.1-9.1-7.1-2.1-5.1-2.0-1.0	99	163038	175702
HG02071.verkko_filt_pat.fa:haplotype2-0000736_102745972_103248026_0	HG02071.verkko_filt_pat.fa:haplotype2-0000736_102745972_103248026_0	176185	209785	2	196	0	0	191	33600	208228	174628	0-3-7-9-4-6-8-5-2-4-9-7-2-5-2-4-9-7-2-5-2-1	0.0-3.0-7.0-9.0-4.0-6.0-8.0-5.0-2.0-4.1-9.1-7.1-2.1-5.1-2.0-4.1-9.1-7.1-2.1-5.1-2.0-1.0	99	176086	209686
HG02071.verkko_filt_pat.fa:haplotype2-0000736_102745972_103248026_0	HG02071.verkko_filt_pat.fa:haplotype2-0000736_102745972_103248026_0	212377	223921	4	84	1	58	4	11544	219772	208228	0-3-7-9-4-6-8-5-2-4-9-7-2-5-2-4-9-7-2-5-2-1	0.0-3.0-7.0-9.0-4.0-6.0-8.0-5.0-2.0-4.1-9.1-7.1-2.1-5.1-2.0-4.1-9.1-7.1-2.1-5.1-2.0-1.0	99	212278	223822
HG02071.verkko_filt_pat.fa:haplotype2-0000736_102745972_103248026_0	HG02071.verkko_filt_pat.fa:haplotype2-0000736_102745972_103248026_0	224986	226297	9	5	1	4	0	1311	221083	219772	0-3-7-9-4-6-8-5-2-4-9-7-2-5-2-4-9-7-2-5-2-1	0.0-3.0-7.0-9.0-4.0-6.0-8.0-5.0-2.0-4.1-9.1-7.1-2.1-5.1-2.0-4.1-9.1-7.1-2.1-5.1-2.0-1.0	99	224887	226198
HG02071.verkko_filt_pat.fa:haplotype2-0000736_102745972_103248026_0	HG02071.verkko_filt_pat.fa:haplotype2-0000736_102745972_103248026_0	226241	228281	7	12	1	11	0	2040	223123	221083	0-3-7-9-4-6-8-5-2-4-9-7-2-5-2-4-9-7-2-5-2-1	0.0-3.0-7.0-9.0-4.0-6.0-8.0-5.0-2.0-4.1-9.1-7.1-2.1-5.1-2.0-4.1-9.1-7.1-2.1-5.1-2.0-1.0	99	226142	228182
HG02071.verkko_filt_pat.fa:haplotype2-0000736_102745972_103248026_0	HG02071.verkko_filt_pat.fa:haplotype2-0000736_102745972_103248026_0	229743	263703	2	196	1	194	0	33960	257083	223123	0-3-7-9-4-6-8-5-2-4-9-7-2-5-2-4-9-7-2-5-2-1	0.0-3.0-7.0-9.0-4.0-6.0-8.0-5.0-2.0-4.1-9.1-7.1-2.1-5.1-2.0-4.1-9.1-7.1-2.1-5.1-2.0-1.0	99	229644	263604
HG02071.verkko_filt_pat.fa:haplotype2-0000736_102745972_103248026_0	HG02071.verkko_filt_pat.fa:haplotype2-0000736_102745972_103248026_0	263647	275775	5	79	1	78	5	12128	269211	257083	0-3-7-9-4-6-8-5-2-4-9-7-2-5-2-4-9-7-2-5-2-1	0.0-3.0-7.0-9.0-4.0-6.0-8.0-5.0-2.0-4.1-9.1-7.1-2.1-5.1-2.0-4.1-9.1-7.1-2.1-5.1-2.0-1.0	99	263548	275676
HG02071.verkko_filt_pat.fa:haplotype2-0000736_102745972_103248026_0	HG02071.verkko_filt_pat.fa:haplotype2-0000736_102745972_103248026_0	276741	303931	2	196	0	39	191	27190	296401	269211	0-3-7-9-4-6-8-5-2-4-9-7-2-5-2-4-9-7-2-5-2-1	0.0-3.0-7.0-9.0-4.0-6.0-8.0-5.0-2.0-4.1-9.1-7.1-2.1-5.1-2.0-4.1-9.1-7.1-2.1-5.1-2.0-1.0	99	276642	303832
HG02071.verkko_filt_pat.fa:haplotype2-0000736_102745972_103248026_0	HG02071.verkko_filt_pat.fa:haplotype2-0000736_102745972_103248026_0	306523	318079	4	84	1	58	4	11556	307957	296401	0-3-7-9-4-6-8-5-2-4-9-7-2-5-2-4-9-7-2-5-2-1	0.0-3.0-7.0-9.0-4.0-6.0-8.0-5.0-2.0-4.1-9.1-7.1-2.1-5.1-2.0-4.1-9.1-7.1-2.1-5.1-2.0-1.0	99	306424	317980
HG02071.verkko_filt_pat.fa:haplotype2-0000736_102745972_103248026_0	HG02071.verkko_filt_pat.fa:haplotype2-0000736_102745972_103248026_0	319148	320459	9	5	1	4	0	1311	309268	307957	0-3-7-9-4-6-8-5-2-4-9-7-2-5-2-4-9-7-2-5-2-1	0.0-3.0-7.0-9.0-4.0-6.0-8.0-5.0-2.0-4.1-9.1-7.1-2.1-5.1-2.0-4.1-9.1-7.1-2.1-5.1-2.0-1.0	99	319049	320360
HG02071.verkko_filt_pat.fa:haplotype2-0000736_102745972_103248026_0	HG02071.verkko_filt_pat.fa:haplotype2-0000736_102745972_103248026_0	320403	322443	7	12	1	11	0	2040	311308	309268	0-3-7-9-4-6-8-5-2-4-9-7-2-5-2-4-9-7-2-5-2-1	0.0-3.0-7.0-9.0-4.0-6.0-8.0-5.0-2.0-4.1-9.1-7.1-2.1-5.1-2.0-4.1-9.1-7.1-2.1-5.1-2.0-1.0	99	320304	322344
HG02071.verkko_filt_pat.fa:haplotype2-0000736_102745972_103248026_0	HG02071.verkko_filt_pat.fa:haplotype2-0000736_102745972_103248026_0	323905	357866	2	196	1	194	0	33961	345269	311308	0-3-7-9-4-6-8-5-2-4-9-7-2-5-2-4-9-7-2-5-2-1	0.0-3.0-7.0-9.0-4.0-6.0-8.0-5.0-2.0-4.1-9.1-7.1-2.1-5.1-2.0-4.1-9.1-7.1-2.1-5.1-2.0-1.0	99	323806	357767
HG02071.verkko_filt_pat.fa:haplotype2-0000736_102745972_103248026_0	HG02071.verkko_filt_pat.fa:haplotype2-0000736_102745972_103248026_0	357810	369938	5	79	1	78	5	12128	357397	345269	0-3-7-9-4-6-8-5-2-4-9-7-2-5-2-4-9-7-2-5-2-1	0.0-3.0-7.0-9.0-4.0-6.0-8.0-5.0-2.0-4.1-9.1-7.1-2.1-5.1-2.0-4.1-9.1-7.1-2.1-5.1-2.0-1.0	99	357711	369839
HG02071.verkko_filt_pat.fa:haplotype2-0000736_102745972_103248026_0	HG02071.verkko_filt_pat.fa:haplotype2-0000736_102745972_103248026_0	370904	398824	2	196	0	39	195	27920	385317	357397	0-3-7-9-4-6-8-5-2-4-9-7-2-5-2-4-9-7-2-5-2-1	0.0-3.0-7.0-9.0-4.0-6.0-8.0-5.0-2.0-4.1-9.1-7.1-2.1-5.1-2.0-4.1-9.1-7.1-2.1-5.1-2.0-1.0	99	370805	398725
HG02071.verkko_filt_pat.fa:haplotype2-0000736_102745972_103248026_0	HG02071.verkko_filt_pat.fa:haplotype2-0000736_102745972_103248026_0	398768	501982	1	612	0	0	611	103214	488531	385317	0-3-7-9-4-6-8-5-2-4-9-7-2-5-2-4-9-7-2-5-2-1	0.0-3.0-7.0-9.0-4.0-6.0-8.0-5.0-2.0-4.1-9.1-7.1-2.1-5.1-2.0-4.1-9.1-7.1-2.1-5.1-2.0-1.0	99	398669	501883
HG02080#1#JAHEOW010000048.1_16689583_17097287_0	HG02080	98	115419	0	672	0	0	671	115321	115321	0	0-3-7-9-4-6-8-5-2-4-9-7-2-5-2-1	0.0-3.0-7.0-9.0-4.0-6.0-8.0-5.0-2.0-4.1-9.1-7.1-2.1-5.1-2.0-1.0	98	0	115321
HG02080#1#JAHEOW010000048.1_16689583_17097287_0	HG02080	115510	138341	3	132	0	0	131	22831	138152	115321	0-3-7-9-4-6-8-5-2-4-9-7-2-5-2-1	0.0-3.0-7.0-9.0-4.0-6.0-8.0-5.0-2.0-4.1-9.1-7.1-2.1-5.1-2.0-1.0	98	115412	138243
HG02080#1#JAHEOW010000048.1_16689583_17097287_0	HG02080	139100	141140	7	12	0	0	11	2040	140192	138152	0-3-7-9-4-6-8-5-2-4-9-7-2-5-2-1	0.0-3.0-7.0-9.0-4.0-6.0-8.0-5.0-2.0-4.1-9.1-7.1-2.1-5.1-2.0-1.0	98	139002	141042
HG02080#1#JAHEOW010000048.1_16689583_17097287_0	HG02080	141084	142395	9	5	0	0	4	1311	141503	140192	0-3-7-9-4-6-8-5-2-4-9-7-2-5-2-1	0.0-3.0-7.0-9.0-4.0-6.0-8.0-5.0-2.0-4.1-9.1-7.1-2.1-5.1-2.0-1.0	98	140986	142297
HG02080#1#JAHEOW010000048.1_16689583_17097287_0	HG02080	143186	158636	4	84	0	1	83	15450	156953	141503	0-3-7-9-4-6-8-5-2-4-9-7-2-5-2-1	0.0-3.0-7.0-9.0-4.0-6.0-8.0-5.0-2.0-4.1-9.1-7.1-2.1-5.1-2.0-1.0	98	143088	158538
HG02080#1#JAHEOW010000048.1_16689583_17097287_0	HG02080	158580	161395	6	12	0	0	11	2815	159768	156953	0-3-7-9-4-6-8-5-2-4-9-7-2-5-2-1	0.0-3.0-7.0-9.0-4.0-6.0-8.0-5.0-2.0-4.1-9.1-7.1-2.1-5.1-2.0-1.0	98	158482	161297
HG02080#1#JAHEOW010000048.1_16689583_17097287_0	HG02080	161339	163109	8	8	0	0	7	1770	161538	159768	0-3-7-9-4-6-8-5-2-4-9-7-2-5-2-1	0.0-3.0-7.0-9.0-4.0-6.0-8.0-5.0-2.0-4.1-9.1-7.1-2.1-5.1-2.0-1.0	98	161241	163011
HG02080#1#JAHEOW010000048.1_16689583_17097287_0	HG02080	163053	176157	5	79	0	0	78	13104	174642	161538	0-3-7-9-4-6-8-5-2-4-9-7-2-5-2-1	0.0-3.0-7.0-9.0-4.0-6.0-8.0-5.0-2.0-4.1-9.1-7.1-2.1-5.1-2.0-1.0	98	162955	176059
HG02080#1#JAHEOW010000048.1_16689583_17097287_0	HG02080	176101	210420	2	196	0	0	195	34319	208961	174642	0-3-7-9-4-6-8-5-2-4-9-7-2-5-2-1	0.0-3.0-7.0-9.0-4.0-6.0-8.0-5.0-2.0-4.1-9.1-7.1-2.1-5.1-2.0-1.0	98	176003	210322
HG02080#1#JAHEOW010000048.1_16689583_17097287_0	HG02080	212512	224087	4	84	1	57	1	11575	220536	208961	0-3-7-9-4-6-8-5-2-4-9-7-2-5-2-1	0.0-3.0-7.0-9.0-4.0-6.0-8.0-5.0-2.0-4.1-9.1-7.1-2.1-5.1-2.0-1.0	98	212414	223989
HG02080#1#JAHEOW010000048.1_16689583_17097287_0	HG02080	224878	226189	9	5	1	4	0	1311	221847	220536	0-3-7-9-4-6-8-5-2-4-9-7-2-5-2-1	0.0-3.0-7.0-9.0-4.0-6.0-8.0-5.0-2.0-4.1-9.1-7.1-2.1-5.1-2.0-1.0	98	224780	226091
HG02080#1#JAHEOW010000048.1_16689583_17097287_0	HG02080	226133	228173	7	12	1	11	0	2040	223887	221847	0-3-7-9-4-6-8-5-2-4-9-7-2-5-2-1	0.0-3.0-7.0-9.0-4.0-6.0-8.0-5.0-2.0-4.1-9.1-7.1-2.1-5.1-2.0-1.0	98	226035	228075
HG02080#1#JAHEOW010000048.1_16689583_17097287_0	HG02080	229250	263350	2	196	1	195	1	34100	257987	223887	0-3-7-9-4-6-8-5-2-4-9-7-2-5-2-1	0.0-3.0-7.0-9.0-4.0-6.0-8.0-5.0-2.0-4.1-9.1-7.1-2.1-5.1-2.0-1.0	98	229152	263252
HG02080#1#JAHEOW010000048.1_16689583_17097287_0	HG02080	263957	276172	5	79	1	77	3	12215	270202	257987	0-3-7-9-4-6-8-5-2-4-9-7-2-5-2-1	0.0-3.0-7.0-9.0-4.0-6.0-8.0-5.0-2.0-4.1-9.1-7.1-2.1-5.1-2.0-1.0	98	263859	276074
HG02080#1#JAHEOW010000048.1_16689583_17097287_0	HG02080	276611	304516	2	196	0	39	195	27905	298107	270202	0-3-7-9-4-6-8-5-2-4-9-7-2-5-2-1	0.0-3.0-7.0-9.0-4.0-6.0-8.0-5.0-2.0-4.1-9.1-7.1-2.1-5.1-2.0-1.0	98	276513	304418
HG02080#1#JAHEOW010000048.1_16689583_17097287_0	HG02080	304460	407632	1	612	0	0	611	103172	401279	298107	0-3-7-9-4-6-8-5-2-4-9-7-2-5-2-1	0.0-3.0-7.0-9.0-4.0-6.0-8.0-5.0-2.0-4.1-9.1-7.1-2.1-5.1-2.0-1.0	98	304362	407534
HG02080#2#JAHEOV010000017.1_16662177_17164189_0	HG02080	99	115482	0	672	0	0	671	115383	115383	0	0-3-7-9-4-6-8-5-2-4-9-7-2-5-2-4-9-7-2-5-2-1	0.0-3.0-7.0-9.0-4.0-6.0-8.0-5.0-2.0-4.1-9.1-7.1-2.1-5.0-2.0-4.1-9.1-7.1-2.1-5.0-2.0-1.0	99	0	115383
HG02080#2#JAHEOV010000017.1_16662177_17164189_0	HG02080	115573	138410	3	132	0	0	131	22837	138220	115383	0-3-7-9-4-6-8-5-2-4-9-7-2-5-2-4-9-7-2-5-2-1	0.0-3.0-7.0-9.0-4.0-6.0-8.0-5.0-2.0-4.1-9.1-7.1-2.1-5.0-2.0-4.1-9.1-7.1-2.1-5.0-2.0-1.0	99	115474	138311
HG02080#2#JAHEOV010000017.1_16662177_17164189_0	HG02080	139169	141209	7	12	0	0	11	2040	140260	138220	0-3-7-9-4-6-8-5-2-4-9-7-2-5-2-4-9-7-2-5-2-1	0.0-3.0-7.0-9.0-4.0-6.0-8.0-5.0-2.0-4.1-9.1-7.1-2.1-5.0-2.0-4.1-9.1-7.1-2.1-5.0-2.0-1.0	99	139070	141110
HG02080#2#JAHEOV010000017.1_16662177_17164189_0	HG02080	141153	142465	9	5	0	0	4	1312	141572	140260	0-3-7-9-4-6-8-5-2-4-9-7-2-5-2-4-9-7-2-5-2-1	0.0-3.0-7.0-9.0-4.0-6.0-8.0-5.0-2.0-4.1-9.1-7.1-2.1-5.0-2.0-4.1-9.1-7.1-2.1-5.0-2.0-1.0	99	141054	142366
HG02080#2#JAHEOV010000017.1_16662177_17164189_0	HG02080	142913	158705	4	84	0	0	83	15792	157364	141572	0-3-7-9-4-6-8-5-2-4-9-7-2-5-2-4-9-7-2-5-2-1	0.0-3.0-7.0-9.0-4.0-6.0-8.0-5.0-2.0-4.1-9.1-7.1-2.1-5.0-2.0-4.1-9.1-7.1-2.1-5.0-2.0-1.0	99	142814	158606
HG02080#2#JAHEOV010000017.1_16662177_17164189_0	HG02080	158649	161465	6	12	0	0	11	2816	160180	157364	0-3-7-9-4-6-8-5-2-4-9-7-2-5-2-4-9-7-2-5-2-1	0.0-3.0-7.0-9.0-4.0-6.0-8.0-5.0-2.0-4.1-9.1-7.1-2.1-5.0-2.0-4.1-9.1-7.1-2.1-5.0-2.0-1.0	99	158550	161366
HG02080#2#JAHEOV010000017.1_16662177_17164189_0	HG02080	161409	163179	8	8	0	0	7	1770	161950	160180	0-3-7-9-4-6-8-5-2-4-9-7-2-5-2-4-9-7-2-5-2-1	0.0-3.0-7.0-9.0-4.0-6.0-8.0-5.0-2.0-4.1-9.1-7.1-2.1-5.0-2.0-4.1-9.1-7.1-2.1-5.0-2.0-1.0	99	161310	163080
HG02080#2#JAHEOV010000017.1_16662177_17164189_0	HG02080	163123	176227	5	79	0	0	78	13104	175054	161950	0-3-7-9-4-6-8-5-2-4-9-7-2-5-2-4-9-7-2-5-2-1	0.0-3.0-7.0-9.0-4.0-6.0-8.0-5.0-2.0-4.1-9.1-7.1-2.1-5.0-2.0-4.1-9.1-7.1-2.1-5.0-2.0-1.0	99	163024	176128
HG02080#2#JAHEOV010000017.1_16662177_17164189_0	HG02080	176171	210110	2	196	0	0	194	33939	208993	175054	0-3-7-9-4-6-8-5-2-4-9-7-2-5-2-4-9-7-2-5-2-1	0.0-3.0-7.0-9.0-4.0-6.0-8.0-5.0-2.0-4.1-9.1-7.1-2.1-5.0-2.0-4.1-9.1-7.1-2.1-5.0-2.0-1.0	99	176072	210011
HG02080#2#JAHEOV010000017.1_16662177_17164189_0	HG02080	212361	223909	4	84	1	58	4	11548	220541	208993	0-3-7-9-4-6-8-5-2-4-9-7-2-5-2-4-9-7-2-5-2-1	0.0-3.0-7.0-9.0-4.0-6.0-8.0-5.0-2.0-4.1-9.1-7.1-2.1-5.0-2.0-4.1-9.1-7.1-2.1-5.0-2.0-1.0	99	212262	223810
HG02080#2#JAHEOV010000017.1_16662177_17164189_0	HG02080	224976	226287	9	5	1	4	0	1311	221852	220541	0-3-7-9-4-6-8-5-2-4-9-7-2-5-2-4-9-7-2-5-2-1	0.0-3.0-7.0-9.0-4.0-6.0-8.0-5.0-2.0-4.1-9.1-7.1-2.1-5.0-2.0-4.1-9.1-7.1-2.1-5.0-2.0-1.0	99	224877	226188
HG02080#2#JAHEOV010000017.1_16662177_17164189_0	HG02080	226231	228271	7	12	1	11	0	2040	223892	221852	0-3-7-9-4-6-8-5-2-4-9-7-2-5-2-4-9-7-2-5-2-1	0.0-3.0-7.0-9.0-4.0-6.0-8.0-5.0-2.0-4.1-9.1-7.1-2.1-5.0-2.0-4.1-9.1-7.1-2.1-5.0-2.0-1.0	99	226132	228172
HG02080#2#JAHEOV010000017.1_16662177_17164189_0	HG02080	229733	257263	2	196	1	194	39	27530	251422	223892	0-3-7-9-4-6-8-5-2-4-9-7-2-5-2-4-9-7-2-5-2-1	0.0-3.0-7.0-9.0-4.0-6.0-8.0-5.0-2.0-4.1-9.1-7.1-2.1-5.0-2.0-4.1-9.1-7.1-2.1-5.0-2.0-1.0	99	229634	257164
HG02080#2#JAHEOV010000017.1_16662177_17164189_0	HG02080	258229	270357	5	79	0	5	78	12128	263550	251422	0-3-7-9-4-6-8-5-2-4-9-7-2-5-2-4-9-7-2-5-2-1	0.0-3.0-7.0-9.0-4.0-6.0-8.0-5.0-2.0-4.1-9.1-7.1-2.1-5.0-2.0-4.1-9.1-7.1-2.1-5.0-2.0-1.0	99	258130	270258
HG02080#2#JAHEOV010000017.1_16662177_17164189_0	HG02080	270301	303902	2	196	0	0	191	33601	297151	263550	0-3-7-9-4-6-8-5-2-4-9-7-2-5-2-4-9-7-2-5-2-1	0.0-3.0-7.0-9.0-4.0-6.0-8.0-5.0-2.0-4.1-9.1-7.1-2.1-5.0-2.0-4.1-9.1-7.1-2.1-5.0-2.0-1.0	99	270202	303803
HG02080#2#JAHEOV010000017.1_16662177_17164189_0	HG02080	306494	318039	4	84	1	58	4	11545	308696	297151	0-3-7-9-4-6-8-5-2-4-9-7-2-5-2-4-9-7-2-5-2-1	0.0-3.0-7.0-9.0-4.0-6.0-8.0-5.0-2.0-4.1-9.1-7.1-2.1-5.0-2.0-4.1-9.1-7.1-2.1-5.0-2.0-1.0	99	306395	317940
HG02080#2#JAHEOV010000017.1_16662177_17164189_0	HG02080	319106	320417	9	5	1	4	0	1311	310007	308696	0-3-7-9-4-6-8-5-2-4-9-7-2-5-2-4-9-7-2-5-2-1	0.0-3.0-7.0-9.0-4.0-6.0-8.0-5.0-2.0-4.1-9.1-7.1-2.1-5.0-2.0-4.1-9.1-7.1-2.1-5.0-2.0-1.0	99	319007	320318
HG02080#2#JAHEOV010000017.1_16662177_17164189_0	HG02080	320361	322401	7	12	1	11	0	2040	312047	310007	0-3-7-9-4-6-8-5-2-4-9-7-2-5-2-4-9-7-2-5-2-1	0.0-3.0-7.0-9.0-4.0-6.0-8.0-5.0-2.0-4.1-9.1-7.1-2.1-5.0-2.0-4.1-9.1-7.1-2.1-5.0-2.0-1.0	99	320262	322302
HG02080#2#JAHEOV010000017.1_16662177_17164189_0	HG02080	324047	351391	2	196	1	192	39	27344	339391	312047	0-3-7-9-4-6-8-5-2-4-9-7-2-5-2-4-9-7-2-5-2-1	0.0-3.0-7.0-9.0-4.0-6.0-8.0-5.0-2.0-4.1-9.1-7.1-2.1-5.0-2.0-4.1-9.1-7.1-2.1-5.0-2.0-1.0	99	323948	351292
HG02080#2#JAHEOV010000017.1_16662177_17164189_0	HG02080	352357	364485	5	79	0	5	78	12128	351519	339391	0-3-7-9-4-6-8-5-2-4-9-7-2-5-2-4-9-7-2-5-2-1	0.0-3.0-7.0-9.0-4.0-6.0-8.0-5.0-2.0-4.1-9.1-7.1-2.1-5.0-2.0-4.1-9.1-7.1-2.1-5.0-2.0-1.0	99	352258	364386
HG02080#2#JAHEOV010000017.1_16662177_17164189_0	HG02080	364429	398766	2	196	0	0	195	34337	385856	351519	0-3-7-9-4-6-8-5-2-4-9-7-2-5-2-4-9-7-2-5-2-1	0.0-3.0-7.0-9.0-4.0-6.0-8.0-5.0-2.0-4.1-9.1-7.1-2.1-5.0-2.0-4.1-9.1-7.1-2.1-5.0-2.0-1.0	99	364330	398667
HG02080#2#JAHEOV010000017.1_16662177_17164189_0	HG02080	398710	501940	1	612	0	0	611	103230	489086	385856	0-3-7-9-4-6-8-5-2-4-9-7-2-5-2-4-9-7-2-5-2-1	0.0-3.0-7.0-9.0-4.0-6.0-8.0-5.0-2.0-4.1-9.1-7.1-2.1-5.0-2.0-4.1-9.1-7.1-2.1-5.0-2.0-1.0	99	398611	501841
HG02109#1#JAHEPG010000026.1_16673035_17080816_0	HG02109	98	115458	0	672	0	0	671	115360	115360	0	0-3-7-9-4-6-8-5-2-4-9-7-2-5-2-1	0.0-3.0-7.0-9.0-4.0-6.0-8.0-5.0-2.0-4.1-9.1-7.1-2.1-5.1-2.0-1.0	98	0	115360
HG02109#1#JAHEPG010000026.1_16673035_17080816_0	HG02109	115549	138378	3	132	0	0	131	22829	138189	115360	0-3-7-9-4-6-8-5-2-4-9-7-2-5-2-1	0.0-3.0-7.0-9.0-4.0-6.0-8.0-5.0-2.0-4.1-9.1-7.1-2.1-5.1-2.0-1.0	98	115451	138280
HG02109#1#JAHEPG010000026.1_16673035_17080816_0	HG02109	139137	141177	7	12	0	0	11	2040	140229	138189	0-3-7-9-4-6-8-5-2-4-9-7-2-5-2-1	0.0-3.0-7.0-9.0-4.0-6.0-8.0-5.0-2.0-4.1-9.1-7.1-2.1-5.1-2.0-1.0	98	139039	141079
HG02109#1#JAHEPG010000026.1_16673035_17080816_0	HG02109	141121	142432	9	5	0	0	4	1311	141540	140229	0-3-7-9-4-6-8-5-2-4-9-7-2-5-2-1	0.0-3.0-7.0-9.0-4.0-6.0-8.0-5.0-2.0-4.1-9.1-7.1-2.1-5.1-2.0-1.0	98	141023	142334
HG02109#1#JAHEPG010000026.1_16673035_17080816_0	HG02109	142880	158689	4	84	0	0	83	15809	157349	141540	0-3-7-9-4-6-8-5-2-4-9-7-2-5-2-1	0.0-3.0-7.0-9.0-4.0-6.0-8.0-5.0-2.0-4.1-9.1-7.1-2.1-5.1-2.0-1.0	98	142782	158591
HG02109#1#JAHEPG010000026.1_16673035_17080816_0	HG02109	158633	161448	6	12	0	0	11	2815	160164	157349	0-3-7-9-4-6-8-5-2-4-9-7-2-5-2-1	0.0-3.0-7.0-9.0-4.0-6.0-8.0-5.0-2.0-4.1-9.1-7.1-2.1-5.1-2.0-1.0	98	158535	161350
HG02109#1#JAHEPG010000026.1_16673035_17080816_0	HG02109	161392	163162	8	8	0	0	7	1770	161934	160164	0-3-7-9-4-6-8-5-2-4-9-7-2-5-2-1	0.0-3.0-7.0-9.0-4.0-6.0-8.0-5.0-2.0-4.1-9.1-7.1-2.1-5.1-2.0-1.0	98	161294	163064
HG02109#1#JAHEPG010000026.1_16673035_17080816_0	HG02109	163106	176210	5	79	0	0	78	13104	175038	161934	0-3-7-9-4-6-8-5-2-4-9-7-2-5-2-1	0.0-3.0-7.0-9.0-4.0-6.0-8.0-5.0-2.0-4.1-9.1-7.1-2.1-5.1-2.0-1.0	98	163008	176112
HG02109#1#JAHEPG010000026.1_16673035_17080816_0	HG02109	176154	210476	2	196	0	0	195	34322	209360	175038	0-3-7-9-4-6-8-5-2-4-9-7-2-5-2-1	0.0-3.0-7.0-9.0-4.0-6.0-8.0-5.0-2.0-4.1-9.1-7.1-2.1-5.1-2.0-1.0	98	176056	210378
HG02109#1#JAHEPG010000026.1_16673035_17080816_0	HG02109	212342	223887	4	84	1	58	4	11545	220905	209360	0-3-7-9-4-6-8-5-2-4-9-7-2-5-2-1	0.0-3.0-7.0-9.0-4.0-6.0-8.0-5.0-2.0-4.1-9.1-7.1-2.1-5.1-2.0-1.0	98	212244	223789
HG02109#1#JAHEPG010000026.1_16673035_17080816_0	HG02109	224950	226261	9	5	1	4	0	1311	222216	220905	0-3-7-9-4-6-8-5-2-4-9-7-2-5-2-1	0.0-3.0-7.0-9.0-4.0-6.0-8.0-5.0-2.0-4.1-9.1-7.1-2.1-5.1-2.0-1.0	98	224852	226163
HG02109#1#JAHEPG010000026.1_16673035_17080816_0	HG02109	226205	228245	7	12	1	11	0	2040	224256	222216	0-3-7-9-4-6-8-5-2-4-9-7-2-5-2-1	0.0-3.0-7.0-9.0-4.0-6.0-8.0-5.0-2.0-4.1-9.1-7.1-2.1-5.1-2.0-1.0	98	226107	228147
HG02109#1#JAHEPG010000026.1_16673035_17080816_0	HG02109	229322	263420	2	196	1	195	1	34098	258354	224256	0-3-7-9-4-6-8-5-2-4-9-7-2-5-2-1	0.0-3.0-7.0-9.0-4.0-6.0-8.0-5.0-2.0-4.1-9.1-7.1-2.1-5.1-2.0-1.0	98	229224	263322
HG02109#1#JAHEPG010000026.1_16673035_17080816_0	HG02109	264027	276242	5	79	1	77	3	12215	270569	258354	0-3-7-9-4-6-8-5-2-4-9-7-2-5-2-1	0.0-3.0-7.0-9.0-4.0-6.0-8.0-5.0-2.0-4.1-9.1-7.1-2.1-5.1-2.0-1.0	98	263929	276144
HG02109#1#JAHEPG010000026.1_16673035_17080816_0	HG02109	276681	304588	2	196	0	39	195	27907	298476	270569	0-3-7-9-4-6-8-5-2-4-9-7-2-5-2-1	0.0-3.0-7.0-9.0-4.0-6.0-8.0-5.0-2.0-4.1-9.1-7.1-2.1-5.1-2.0-1.0	98	276583	304490
HG02109#1#JAHEPG010000026.1_16673035_17080816_0	HG02109	304532	407709	1	612	0	0	611	103177	401653	298476	0-3-7-9-4-6-8-5-2-4-9-7-2-5-2-1	0.0-3.0-7.0-9.0-4.0-6.0-8.0-5.0-2.0-4.1-9.1-7.1-2.1-5.1-2.0-1.0	98	304434	407611
HG02109#2#JAHEPF010000078.1_16678387_16991144_0	HG02109	98	115474	0	672	0	0	671	115376	115376	0	0-3-7-9-4-6-8-5-2-1	0.0-3.0-7.0-9.0-4.0-6.0-8.0-5.0-2.0-1.0	98	0	115376
HG02109#2#JAHEPF010000078.1_16678387_16991144_0	HG02109	115565	138400	3	132	0	0	131	22835	138211	115376	0-3-7-9-4-6-8-5-2-1	0.0-3.0-7.0-9.0-4.0-6.0-8.0-5.0-2.0-1.0	98	115467	138302
HG02109#2#JAHEPF010000078.1_16678387_16991144_0	HG02109	139159	141199	7	12	0	0	11	2040	140251	138211	0-3-7-9-4-6-8-5-2-1	0.0-3.0-7.0-9.0-4.0-6.0-8.0-5.0-2.0-1.0	98	139061	141101
HG02109#2#JAHEPF010000078.1_16678387_16991144_0	HG02109	141143	142454	9	5	0	0	4	1311	141562	140251	0-3-7-9-4-6-8-5-2-1	0.0-3.0-7.0-9.0-4.0-6.0-8.0-5.0-2.0-1.0	98	141045	142356
HG02109#2#JAHEPF010000078.1_16678387_16991144_0	HG02109	142902	158707	4	84	0	0	83	15805	157367	141562	0-3-7-9-4-6-8-5-2-1	0.0-3.0-7.0-9.0-4.0-6.0-8.0-5.0-2.0-1.0	98	142804	158609
HG02109#2#JAHEPF010000078.1_16678387_16991144_0	HG02109	158651	161466	6	12	0	0	11	2815	160182	157367	0-3-7-9-4-6-8-5-2-1	0.0-3.0-7.0-9.0-4.0-6.0-8.0-5.0-2.0-1.0	98	158553	161368
HG02109#2#JAHEPF010000078.1_16678387_16991144_0	HG02109	161410	163180	8	8	0	0	7	1770	161952	160182	0-3-7-9-4-6-8-5-2-1	0.0-3.0-7.0-9.0-4.0-6.0-8.0-5.0-2.0-1.0	98	161312	163082
HG02109#2#JAHEPF010000078.1_16678387_16991144_0	HG02109	163124	175788	5	79	0	0	77	12664	174616	161952	0-3-7-9-4-6-8-5-2-1	0.0-3.0-7.0-9.0-4.0-6.0-8.0-5.0-2.0-1.0	98	163026	175690
HG02109#2#JAHEPF010000078.1_16678387_16991144_0	HG02109	176172	210492	2	196	0	0	195	34320	208936	174616	0-3-7-9-4-6-8-5-2-1	0.0-3.0-7.0-9.0-4.0-6.0-8.0-5.0-2.0-1.0	98	176074	210394
HG02109#2#JAHEPF010000078.1_16678387_16991144_0	HG02109	210436	312813	1	612	0	0	606	102377	311313	208936	0-3-7-9-4-6-8-5-2-1	0.0-3.0-7.0-9.0-4.0-6.0-8.0-5.0-2.0-1.0	98	210338	312715
HG02145#1#JAHKSG010000134.1_2102465_2647653_1	HG02145	154	115532	0	672	0	0	671	115378	115378	0	0-3-7-9-4-6-8-5-2-4-0-3-7-9-4-6-8-5-2-4-0-3-7-9-4-6-8-5-2-1	0.0-3.0-7.0-9.0-4.0-6.0-8.0-5.0-2.0-4.1-0.0-3.0-7.0-9.0-4.0-6.0-8.0-5.0-2.0-4.1-0.0-3.0-7.0-9.0-4.0-6.0-8.0-5.0-2.0-1.0	154	0	115378
HG02145#1#JAHKSG010000134.1_2102465_2647653_1	HG02145	115623	138455	3	132	0	0	131	22832	138210	115378	0-3-7-9-4-6-8-5-2-4-0-3-7-9-4-6-8-5-2-4-0-3-7-9-4-6-8-5-2-1	0.0-3.0-7.0-9.0-4.0-6.0-8.0-5.0-2.0-4.1-0.0-3.0-7.0-9.0-4.0-6.0-8.0-5.0-2.0-4.1-0.0-3.0-7.0-9.0-4.0-6.0-8.0-5.0-2.0-1.0	154	115469	138301
HG02145#1#JAHKSG010000134.1_2102465_2647653_1	HG02145	139214	141255	7	12	0	0	11	2041	140251	138210	0-3-7-9-4-6-8-5-2-4-0-3-7-9-4-6-8-5-2-4-0-3-7-9-4-6-8-5-2-1	0.0-3.0-7.0-9.0-4.0-6.0-8.0-5.0-2.0-4.1-0.0-3.0-7.0-9.0-4.0-6.0-8.0-5.0-2.0-4.1-0.0-3.0-7.0-9.0-4.0-6.0-8.0-5.0-2.0-1.0	154	139060	141101
HG02145#1#JAHKSG010000134.1_2102465_2647653_1	HG02145	141199	142510	9	5	0	0	4	1311	141562	140251	0-3-7-9-4-6-8-5-2-4-0-3-7-9-4-6-8-5-2-4-0-3-7-9-4-6-8-5-2-1	0.0-3.0-7.0-9.0-4.0-6.0-8.0-5.0-2.0-4.1-0.0-3.0-7.0-9.0-4.0-6.0-8.0-5.0-2.0-4.1-0.0-3.0-7.0-9.0-4.0-6.0-8.0-5.0-2.0-1.0	154	141045	142356
HG02145#1#JAHKSG010000134.1_2102465_2647653_1	HG02145	142958	158769	4	84	0	0	83	15811	157373	141562	0-3-7-9-4-6-8-5-2-4-0-3-7-9-4-6-8-5-2-4-0-3-7-9-4-6-8-5-2-1	0.0-3.0-7.0-9.0-4.0-6.0-8.0-5.0-2.0-4.1-0.0-3.0-7.0-9.0-4.0-6.0-8.0-5.0-2.0-4.1-0.0-3.0-7.0-9.0-4.0-6.0-8.0-5.0-2.0-1.0	154	142804	158615
HG02145#1#JAHKSG010000134.1_2102465_2647653_1	HG02145	158713	161528	6	12	0	0	11	2815	160188	157373	0-3-7-9-4-6-8-5-2-4-0-3-7-9-4-6-8-5-2-4-0-3-7-9-4-6-8-5-2-1	0.0-3.0-7.0-9.0-4.0-6.0-8.0-5.0-2.0-4.1-0.0-3.0-7.0-9.0-4.0-6.0-8.0-5.0-2.0-4.1-0.0-3.0-7.0-9.0-4.0-6.0-8.0-5.0-2.0-1.0	154	158559	161374
HG02145#1#JAHKSG010000134.1_2102465_2647653_1	HG02145	161472	163242	8	8	0	0	7	1770	161958	160188	0-3-7-9-4-6-8-5-2-4-0-3-7-9-4-6-8-5-2-4-0-3-7-9-4-6-8-5-2-1	0.0-3.0-7.0-9.0-4.0-6.0-8.0-5.0-2.0-4.1-0.0-3.0-7.0-9.0-4.0-6.0-8.0-5.0-2.0-4.1-0.0-3.0-7.0-9.0-4.0-6.0-8.0-5.0-2.0-1.0	154	161318	163088
HG02145#1#JAHKSG010000134.1_2102465_2647653_1	HG02145	163186	176290	5	79	0	0	78	13104	175062	161958	0-3-7-9-4-6-8-5-2-4-0-3-7-9-4-6-8-5-2-4-0-3-7-9-4-6-8-5-2-1	0.0-3.0-7.0-9.0-4.0-6.0-8.0-5.0-2.0-4.1-0.0-3.0-7.0-9.0-4.0-6.0-8.0-5.0-2.0-4.1-0.0-3.0-7.0-9.0-4.0-6.0-8.0-5.0-2.0-1.0	154	163032	176136
HG02145#1#JAHKSG010000134.1_2102465_2647653_1	HG02145	176234	210548	2	196	0	0	195	34314	209376	175062	0-3-7-9-4-6-8-5-2-4-0-3-7-9-4-6-8-5-2-4-0-3-7-9-4-6-8-5-2-1	0.0-3.0-7.0-9.0-4.0-6.0-8.0-5.0-2.0-4.1-0.0-3.0-7.0-9.0-4.0-6.0-8.0-5.0-2.0-4.1-0.0-3.0-7.0-9.0-4.0-6.0-8.0-5.0-2.0-1.0	154	176080	210394
HG02145#1#JAHKSG010000134.1_2102465_2647653_1	HG02145	212414	220894	4	84	1	58	22	8480	217856	209376	0-3-7-9-4-6-8-5-2-4-0-3-7-9-4-6-8-5-2-4-0-3-7-9-4-6-8-5-2-1	0.0-3.0-7.0-9.0-4.0-6.0-8.0-5.0-2.0-4.1-0.0-3.0-7.0-9.0-4.0-6.0-8.0-5.0-2.0-4.1-0.0-3.0-7.0-9.0-4.0-6.0-8.0-5.0-2.0-1.0	154	212260	220740
HG02145#1#JAHKSG010000134.1_2102465_2647653_1	HG02145	221071	231279	0	672	0	604	671	10208	228064	217856	0-3-7-9-4-6-8-5-2-4-0-3-7-9-4-6-8-5-2-4-0-3-7-9-4-6-8-5-2-1	0.0-3.0-7.0-9.0-4.0-6.0-8.0-5.0-2.0-4.1-0.0-3.0-7.0-9.0-4.0-6.0-8.0-5.0-2.0-4.1-0.0-3.0-7.0-9.0-4.0-6.0-8.0-5.0-2.0-1.0	154	220917	231125
HG02145#1#JAHKSG010000134.1_2102465_2647653_1	HG02145	231370	254202	3	132	0	0	131	22832	250896	228064	0-3-7-9-4-6-8-5-2-4-0-3-7-9-4-6-8-5-2-4-0-3-7-9-4-6-8-5-2-1	0.0-3.0-7.0-9.0-4.0-6.0-8.0-5.0-2.0-4.1-0.0-3.0-7.0-9.0-4.0-6.0-8.0-5.0-2.0-4.1-0.0-3.0-7.0-9.0-4.0-6.0-8.0-5.0-2.0-1.0	154	231216	254048
HG02145#1#JAHKSG010000134.1_2102465_2647653_1	HG02145	254961	257002	7	12	0	0	11	2041	252937	250896	0-3-7-9-4-6-8-5-2-4-0-3-7-9-4-6-8-5-2-4-0-3-7-9-4-6-8-5-2-1	0.0-3.0-7.0-9.0-4.0-6.0-8.0-5.0-2.0-4.1-0.0-3.0-7.0-9.0-4.0-6.0-8.0-5.0-2.0-4.1-0.0-3.0-7.0-9.0-4.0-6.0-8.0-5.0-2.0-1.0	154	254807	256848
HG02145#1#JAHKSG010000134.1_2102465_2647653_1	HG02145	256946	258257	9	5	0	0	4	1311	254248	252937	0-3-7-9-4-6-8-5-2-4-0-3-7-9-4-6-8-5-2-4-0-3-7-9-4-6-8-5-2-1	0.0-3.0-7.0-9.0-4.0-6.0-8.0-5.0-2.0-4.1-0.0-3.0-7.0-9.0-4.0-6.0-8.0-5.0-2.0-4.1-0.0-3.0-7.0-9.0-4.0-6.0-8.0-5.0-2.0-1.0	154	256792	258103
HG02145#1#JAHKSG010000134.1_2102465_2647653_1	HG02145	258705	274516	4	84	0	0	83	15811	270059	254248	0-3-7-9-4-6-8-5-2-4-0-3-7-9-4-6-8-5-2-4-0-3-7-9-4-6-8-5-2-1	0.0-3.0-7.0-9.0-4.0-6.0-8.0-5.0-2.0-4.1-0.0-3.0-7.0-9.0-4.0-6.0-8.0-5.0-2.0-4.1-0.0-3.0-7.0-9.0-4.0-6.0-8.0-5.0-2.0-1.0	154	258551	274362
HG02145#1#JAHKSG010000134.1_2102465_2647653_1	HG02145	274460	277275	6	12	0	0	11	2815	272874	270059	0-3-7-9-4-6-8-5-2-4-0-3-7-9-4-6-8-5-2-4-0-3-7-9-4-6-8-5-2-1	0.0-3.0-7.0-9.0-4.0-6.0-8.0-5.0-2.0-4.1-0.0-3.0-7.0-9.0-4.0-6.0-8.0-5.0-2.0-4.1-0.0-3.0-7.0-9.0-4.0-6.0-8.0-5.0-2.0-1.0	154	274306	277121
HG02145#1#JAHKSG010000134.1_2102465_2647653_1	HG02145	277219	278989	8	8	0	0	7	1770	274644	272874	0-3-7-9-4-6-8-5-2-4-0-3-7-9-4-6-8-5-2-4-0-3-7-9-4-6-8-5-2-1	0.0-3.0-7.0-9.0-4.0-6.0-8.0-5.0-2.0-4.1-0.0-3.0-7.0-9.0-4.0-6.0-8.0-5.0-2.0-4.1-0.0-3.0-7.0-9.0-4.0-6.0-8.0-5.0-2.0-1.0	154	277065	278835
HG02145#1#JAHKSG010000134.1_2102465_2647653_1	HG02145	278933	292037	5	79	0	0	78	13104	287748	274644	0-3-7-9-4-6-8-5-2-4-0-3-7-9-4-6-8-5-2-4-0-3-7-9-4-6-8-5-2-1	0.0-3.0-7.0-9.0-4.0-6.0-8.0-5.0-2.0-4.1-0.0-3.0-7.0-9.0-4.0-6.0-8.0-5.0-2.0-4.1-0.0-3.0-7.0-9.0-4.0-6.0-8.0-5.0-2.0-1.0	154	278779	291883
HG02145#1#JAHKSG010000134.1_2102465_2647653_1	HG02145	291981	326291	2	196	0	0	195	34310	322058	287748	0-3-7-9-4-6-8-5-2-4-0-3-7-9-4-6-8-5-2-4-0-3-7-9-4-6-8-5-2-1	0.0-3.0-7.0-9.0-4.0-6.0-8.0-5.0-2.0-4.1-0.0-3.0-7.0-9.0-4.0-6.0-8.0-5.0-2.0-4.1-0.0-3.0-7.0-9.0-4.0-6.0-8.0-5.0-2.0-1.0	154	291827	326137
HG02145#1#JAHKSG010000134.1_2102465_2647653_1	HG02145	328157	336637	4	84	1	58	22	8480	330538	322058	0-3-7-9-4-6-8-5-2-4-0-3-7-9-4-6-8-5-2-4-0-3-7-9-4-6-8-5-2-1	0.0-3.0-7.0-9.0-4.0-6.0-8.0-5.0-2.0-4.1-0.0-3.0-7.0-9.0-4.0-6.0-8.0-5.0-2.0-4.1-0.0-3.0-7.0-9.0-4.0-6.0-8.0-5.0-2.0-1.0	154	328003	336483
HG02145#1#JAHKSG010000134.1_2102465_2647653_1	HG02145	336814	347024	0	672	0	604	671	10210	340748	330538	0-3-7-9-4-6-8-5-2-4-0-3-7-9-4-6-8-5-2-4-0-3-7-9-4-6-8-5-2-1	0.0-3.0-7.0-9.0-4.0-6.0-8.0-5.0-2.0-4.1-0.0-3.0-7.0-9.0-4.0-6.0-8.0-5.0-2.0-4.1-0.0-3.0-7.0-9.0-4.0-6.0-8.0-5.0-2.0-1.0	154	336660	346870
HG02145#1#JAHKSG010000134.1_2102465_2647653_1	HG02145	347115	369947	3	132	0	0	131	22832	363580	340748	0-3-7-9-4-6-8-5-2-4-0-3-7-9-4-6-8-5-2-4-0-3-7-9-4-6-8-5-2-1	0.0-3.0-7.0-9.0-4.0-6.0-8.0-5.0-2.0-4.1-0.0-3.0-7.0-9.0-4.0-6.0-8.0-5.0-2.0-4.1-0.0-3.0-7.0-9.0-4.0-6.0-8.0-5.0-2.0-1.0	154	346961	369793
HG02145#1#JAHKSG010000134.1_2102465_2647653_1	HG02145	370706	372747	7	12	0	0	11	2041	365621	363580	0-3-7-9-4-6-8-5-2-4-0-3-7-9-4-6-8-5-2-4-0-3-7-9-4-6-8-5-2-1	0.0-3.0-7.0-9.0-4.0-6.0-8.0-5.0-2.0-4.1-0.0-3.0-7.0-9.0-4.0-6.0-8.0-5.0-2.0-4.1-0.0-3.0-7.0-9.0-4.0-6.0-8.0-5.0-2.0-1.0	154	370552	372593
HG02145#1#JAHKSG010000134.1_2102465_2647653_1	HG02145	372691	374002	9	5	0	0	4	1311	366932	365621	0-3-7-9-4-6-8-5-2-4-0-3-7-9-4-6-8-5-2-4-0-3-7-9-4-6-8-5-2-1	0.0-3.0-7.0-9.0-4.0-6.0-8.0-5.0-2.0-4.1-0.0-3.0-7.0-9.0-4.0-6.0-8.0-5.0-2.0-4.1-0.0-3.0-7.0-9.0-4.0-6.0-8.0-5.0-2.0-1.0	154	372537	373848
HG02145#1#JAHKSG010000134.1_2102465_2647653_1	HG02145	374450	390261	4	84	0	0	83	15811	382743	366932	0-3-7-9-4-6-8-5-2-4-0-3-7-9-4-6-8-5-2-4-0-3-7-9-4-6-8-5-2-1	0.0-3.0-7.0-9.0-4.0-6.0-8.0-5.0-2.0-4.1-0.0-3.0-7.0-9.0-4.0-6.0-8.0-5.0-2.0-4.1-0.0-3.0-7.0-9.0-4.0-6.0-8.0-5.0-2.0-1.0	154	374296	390107
HG02145#1#JAHKSG010000134.1_2102465_2647653_1	HG02145	390205	393020	6	12	0	0	11	2815	385558	382743	0-3-7-9-4-6-8-5-2-4-0-3-7-9-4-6-8-5-2-4-0-3-7-9-4-6-8-5-2-1	0.0-3.0-7.0-9.0-4.0-6.0-8.0-5.0-2.0-4.1-0.0-3.0-7.0-9.0-4.0-6.0-8.0-5.0-2.0-4.1-0.0-3.0-7.0-9.0-4.0-6.0-8.0-5.0-2.0-1.0	154	390051	392866
HG02145#1#JAHKSG010000134.1_2102465_2647653_1	HG02145	392964	394734	8	8	0	0	7	1770	387328	385558	0-3-7-9-4-6-8-5-2-4-0-3-7-9-4-6-8-5-2-4-0-3-7-9-4-6-8-5-2-1	0.0-3.0-7.0-9.0-4.0-6.0-8.0-5.0-2.0-4.1-0.0-3.0-7.0-9.0-4.0-6.0-8.0-5.0-2.0-4.1-0.0-3.0-7.0-9.0-4.0-6.0-8.0-5.0-2.0-1.0	154	392810	394580
HG02145#1#JAHKSG010000134.1_2102465_2647653_1	HG02145	394678	407782	5	79	0	0	78	13104	400432	387328	0-3-7-9-4-6-8-5-2-4-0-3-7-9-4-6-8-5-2-4-0-3-7-9-4-6-8-5-2-1	0.0-3.0-7.0-9.0-4.0-6.0-8.0-5.0-2.0-4.1-0.0-3.0-7.0-9.0-4.0-6.0-8.0-5.0-2.0-4.1-0.0-3.0-7.0-9.0-4.0-6.0-8.0-5.0-2.0-1.0	154	394524	407628
HG02145#1#JAHKSG010000134.1_2102465_2647653_1	HG02145	407726	442051	2	196	0	0	195	34325	434757	400432	0-3-7-9-4-6-8-5-2-4-0-3-7-9-4-6-8-5-2-4-0-3-7-9-4-6-8-5-2-1	0.0-3.0-7.0-9.0-4.0-6.0-8.0-5.0-2.0-4.1-0.0-3.0-7.0-9.0-4.0-6.0-8.0-5.0-2.0-4.1-0.0-3.0-7.0-9.0-4.0-6.0-8.0-5.0-2.0-1.0	154	407572	441897
HG02145#1#JAHKSG010000134.1_2102465_2647653_1	HG02145	441995	545172	1	612	0	0	611	103177	537934	434757	0-3-7-9-4-6-8-5-2-4-0-3-7-9-4-6-8-5-2-4-0-3-7-9-4-6-8-5-2-1	0.0-3.0-7.0-9.0-4.0-6.0-8.0-5.0-2.0-4.1-0.0-3.0-7.0-9.0-4.0-6.0-8.0-5.0-2.0-4.1-0.0-3.0-7.0-9.0-4.0-6.0-8.0-5.0-2.0-1.0	154	441841	545018
HG02145#2#JAHKSF010000206.1_1005292_1413195_1	HG02145	154	115553	0	672	0	0	671	115399	115399	0	0-3-7-9-4-6-8-5-2-4-9-7-2-5-2-1	0.0-3.0-7.0-9.0-4.0-6.0-8.0-5.0-2.0-4.1-9.1-7.1-2.1-5.0-2.0-1.0	154	0	115399
HG02145#2#JAHKSF010000206.1_1005292_1413195_1	HG02145	115644	138478	3	132	0	0	131	22834	138233	115399	0-3-7-9-4-6-8-5-2-4-9-7-2-5-2-1	0.0-3.0-7.0-9.0-4.0-6.0-8.0-5.0-2.0-4.1-9.1-7.1-2.1-5.0-2.0-1.0	154	115490	138324
HG02145#2#JAHKSF010000206.1_1005292_1413195_1	HG02145	139237	141277	7	12	0	0	11	2040	140273	138233	0-3-7-9-4-6-8-5-2-4-9-7-2-5-2-1	0.0-3.0-7.0-9.0-4.0-6.0-8.0-5.0-2.0-4.1-9.1-7.1-2.1-5.0-2.0-1.0	154	139083	141123
HG02145#2#JAHKSF010000206.1_1005292_1413195_1	HG02145	141221	142532	9	5	0	0	4	1311	141584	140273	0-3-7-9-4-6-8-5-2-4-9-7-2-5-2-1	0.0-3.0-7.0-9.0-4.0-6.0-8.0-5.0-2.0-4.1-9.1-7.1-2.1-5.0-2.0-1.0	154	141067	142378
HG02145#2#JAHKSF010000206.1_1005292_1413195_1	HG02145	143597	158794	4	84	0	4	83	15197	156781	141584	0-3-7-9-4-6-8-5-2-4-9-7-2-5-2-1	0.0-3.0-7.0-9.0-4.0-6.0-8.0-5.0-2.0-4.1-9.1-7.1-2.1-5.0-2.0-1.0	154	143443	158640
HG02145#2#JAHKSF010000206.1_1005292_1413195_1	HG02145	158738	161553	6	12	0	0	11	2815	159596	156781	0-3-7-9-4-6-8-5-2-4-9-7-2-5-2-1	0.0-3.0-7.0-9.0-4.0-6.0-8.0-5.0-2.0-4.1-9.1-7.1-2.1-5.0-2.0-1.0	154	158584	161399
HG02145#2#JAHKSF010000206.1_1005292_1413195_1	HG02145	161497	163267	8	8	0	0	7	1770	161366	159596	0-3-7-9-4-6-8-5-2-4-9-7-2-5-2-1	0.0-3.0-7.0-9.0-4.0-6.0-8.0-5.0-2.0-4.1-9.1-7.1-2.1-5.0-2.0-1.0	154	161343	163113
HG02145#2#JAHKSF010000206.1_1005292_1413195_1	HG02145	163211	175909	5	79	0	0	77	12698	174064	161366	0-3-7-9-4-6-8-5-2-4-9-7-2-5-2-1	0.0-3.0-7.0-9.0-4.0-6.0-8.0-5.0-2.0-4.1-9.1-7.1-2.1-5.0-2.0-1.0	154	163057	175755
HG02145#2#JAHKSF010000206.1_1005292_1413195_1	HG02145	176516	210644	2	196	0	1	195	34128	208192	174064	0-3-7-9-4-6-8-5-2-4-9-7-2-5-2-1	0.0-3.0-7.0-9.0-4.0-6.0-8.0-5.0-2.0-4.1-9.1-7.1-2.1-5.0-2.0-1.0	154	176362	210490
HG02145#2#JAHKSF010000206.1_1005292_1413195_1	HG02145	212960	224054	4	84	1	56	4	11094	219286	208192	0-3-7-9-4-6-8-5-2-4-9-7-2-5-2-1	0.0-3.0-7.0-9.0-4.0-6.0-8.0-5.0-2.0-4.1-9.1-7.1-2.1-5.0-2.0-1.0	154	212806	223900
HG02145#2#JAHKSF010000206.1_1005292_1413195_1	HG02145	225117	226428	9	5	1	4	0	1311	220597	219286	0-3-7-9-4-6-8-5-2-4-9-7-2-5-2-1	0.0-3.0-7.0-9.0-4.0-6.0-8.0-5.0-2.0-4.1-9.1-7.1-2.1-5.0-2.0-1.0	154	224963	226274
HG02145#2#JAHKSF010000206.1_1005292_1413195_1	HG02145	226372	228412	7	12	1	11	0	2040	222637	220597	0-3-7-9-4-6-8-5-2-4-9-7-2-5-2-1	0.0-3.0-7.0-9.0-4.0-6.0-8.0-5.0-2.0-4.1-9.1-7.1-2.1-5.0-2.0-1.0	154	226218	228258
HG02145#2#JAHKSF010000206.1_1005292_1413195_1	HG02145	229489	257401	2	196	1	195	39	27912	250549	222637	0-3-7-9-4-6-8-5-2-4-9-7-2-5-2-1	0.0-3.0-7.0-9.0-4.0-6.0-8.0-5.0-2.0-4.1-9.1-7.1-2.1-5.0-2.0-1.0	154	229335	257247
HG02145#2#JAHKSF010000206.1_1005292_1413195_1	HG02145	258367	269581	5	79	0	5	75	11214	261763	250549	0-3-7-9-4-6-8-5-2-4-9-7-2-5-2-1	0.0-3.0-7.0-9.0-4.0-6.0-8.0-5.0-2.0-4.1-9.1-7.1-2.1-5.0-2.0-1.0	154	258213	269427
HG02145#2#JAHKSF010000206.1_1005292_1413195_1	HG02145	270662	304757	2	196	0	1	195	34095	295858	261763	0-3-7-9-4-6-8-5-2-4-9-7-2-5-2-1	0.0-3.0-7.0-9.0-4.0-6.0-8.0-5.0-2.0-4.1-9.1-7.1-2.1-5.0-2.0-1.0	154	270508	304603
HG02145#2#JAHKSF010000206.1_1005292_1413195_1	HG02145	304701	407887	1	612	0	0	611	103186	399044	295858	0-3-7-9-4-6-8-5-2-4-9-7-2-5-2-1	0.0-3.0-7.0-9.0-4.0-6.0-8.0-5.0-2.0-4.1-9.1-7.1-2.1-5.0-2.0-1.0	154	304547	407733
HG02293.verkko_filt_mat.fa:haplotype1-0000039_30204405_30517145_1	HG02293.verkko_filt_mat.fa:haplotype1-0000039_30204405_30517145_1	155	115493	0	672	0	0	671	115338	115338	0	0-3-7-9-4-6-8-5-2-1	0.0-3.0-7.0-9.0-4.0-6.0-8.0-5.0-2.0-1.0	155	0	115338
HG02293.verkko_filt_mat.fa:haplotype1-0000039_30204405_30517145_1	HG02293.verkko_filt_mat.fa:haplotype1-0000039_30204405_30517145_1	115584	138417	3	132	0	0	131	22833	138171	115338	0-3-7-9-4-6-8-5-2-1	0.0-3.0-7.0-9.0-4.0-6.0-8.0-5.0-2.0-1.0	155	115429	138262
HG02293.verkko_filt_mat.fa:haplotype1-0000039_30204405_30517145_1	HG02293.verkko_filt_mat.fa:haplotype1-0000039_30204405_30517145_1	139176	141216	7	12	0	0	11	2040	140211	138171	0-3-7-9-4-6-8-5-2-1	0.0-3.0-7.0-9.0-4.0-6.0-8.0-5.0-2.0-1.0	155	139021	141061
HG02293.verkko_filt_mat.fa:haplotype1-0000039_30204405_30517145_1	HG02293.verkko_filt_mat.fa:haplotype1-0000039_30204405_30517145_1	141160	142472	9	5	0	0	4	1312	141523	140211	0-3-7-9-4-6-8-5-2-1	0.0-3.0-7.0-9.0-4.0-6.0-8.0-5.0-2.0-1.0	155	141005	142317
HG02293.verkko_filt_mat.fa:haplotype1-0000039_30204405_30517145_1	HG02293.verkko_filt_mat.fa:haplotype1-0000039_30204405_30517145_1	142920	158721	4	84	0	0	83	15801	157324	141523	0-3-7-9-4-6-8-5-2-1	0.0-3.0-7.0-9.0-4.0-6.0-8.0-5.0-2.0-1.0	155	142765	158566
HG02293.verkko_filt_mat.fa:haplotype1-0000039_30204405_30517145_1	HG02293.verkko_filt_mat.fa:haplotype1-0000039_30204405_30517145_1	158665	161481	6	12	0	0	11	2816	160140	157324	0-3-7-9-4-6-8-5-2-1	0.0-3.0-7.0-9.0-4.0-6.0-8.0-5.0-2.0-1.0	155	158510	161326
HG02293.verkko_filt_mat.fa:haplotype1-0000039_30204405_30517145_1	HG02293.verkko_filt_mat.fa:haplotype1-0000039_30204405_30517145_1	161425	163195	8	8	0	0	7	1770	161910	160140	0-3-7-9-4-6-8-5-2-1	0.0-3.0-7.0-9.0-4.0-6.0-8.0-5.0-2.0-1.0	155	161270	163040
HG02293.verkko_filt_mat.fa:haplotype1-0000039_30204405_30517145_1	HG02293.verkko_filt_mat.fa:haplotype1-0000039_30204405_30517145_1	163139	176243	5	79	0	0	78	13104	175014	161910	0-3-7-9-4-6-8-5-2-1	0.0-3.0-7.0-9.0-4.0-6.0-8.0-5.0-2.0-1.0	155	162984	176088
HG02293.verkko_filt_mat.fa:haplotype1-0000039_30204405_30517145_1	HG02293.verkko_filt_mat.fa:haplotype1-0000039_30204405_30517145_1	176187	210504	2	196	0	0	195	34317	209331	175014	0-3-7-9-4-6-8-5-2-1	0.0-3.0-7.0-9.0-4.0-6.0-8.0-5.0-2.0-1.0	155	176032	210349
HG02293.verkko_filt_mat.fa:haplotype1-0000039_30204405_30517145_1	HG02293.verkko_filt_mat.fa:haplotype1-0000039_30204405_30517145_1	210448	312536	1	612	0	0	604	102088	311419	209331	0-3-7-9-4-6-8-5-2-1	0.0-3.0-7.0-9.0-4.0-6.0-8.0-5.0-2.0-1.0	155	210293	312381
HG02293.verkko_filt_pat.fa:haplotype2-0000836_148310532_148812524_1	HG02293.verkko_filt_pat.fa:haplotype2-0000836_148310532_148812524_1	155	115536	0	672	0	0	671	115381	115381	0	0-3-7-9-4-6-8-5-2-4-9-7-2-5-2-4-9-7-2-5-2-1	0.0-3.0-7.0-9.0-4.0-6.0-8.0-5.0-2.0-4.1-9.1-7.1-2.1-5.1-2.0-4.1-9.1-7.1-2.1-5.1-2.0-1.0	155	0	115381
HG02293.verkko_filt_pat.fa:haplotype2-0000836_148310532_148812524_1	HG02293.verkko_filt_pat.fa:haplotype2-0000836_148310532_148812524_1	115627	138462	3	132	0	0	131	22835	138216	115381	0-3-7-9-4-6-8-5-2-4-9-7-2-5-2-4-9-7-2-5-2-1	0.0-3.0-7.0-9.0-4.0-6.0-8.0-5.0-2.0-4.1-9.1-7.1-2.1-5.1-2.0-4.1-9.1-7.1-2.1-5.1-2.0-1.0	155	115472	138307
HG02293.verkko_filt_pat.fa:haplotype2-0000836_148310532_148812524_1	HG02293.verkko_filt_pat.fa:haplotype2-0000836_148310532_148812524_1	139221	141261	7	12	0	0	11	2040	140256	138216	0-3-7-9-4-6-8-5-2-4-9-7-2-5-2-4-9-7-2-5-2-1	0.0-3.0-7.0-9.0-4.0-6.0-8.0-5.0-2.0-4.1-9.1-7.1-2.1-5.1-2.0-4.1-9.1-7.1-2.1-5.1-2.0-1.0	155	139066	141106
HG02293.verkko_filt_pat.fa:haplotype2-0000836_148310532_148812524_1	HG02293.verkko_filt_pat.fa:haplotype2-0000836_148310532_148812524_1	141205	142517	9	5	0	0	4	1312	141568	140256	0-3-7-9-4-6-8-5-2-4-9-7-2-5-2-4-9-7-2-5-2-1	0.0-3.0-7.0-9.0-4.0-6.0-8.0-5.0-2.0-4.1-9.1-7.1-2.1-5.1-2.0-4.1-9.1-7.1-2.1-5.1-2.0-1.0	155	141050	142362
HG02293.verkko_filt_pat.fa:haplotype2-0000836_148310532_148812524_1	HG02293.verkko_filt_pat.fa:haplotype2-0000836_148310532_148812524_1	142965	158764	4	84	0	0	83	15799	157367	141568	0-3-7-9-4-6-8-5-2-4-9-7-2-5-2-4-9-7-2-5-2-1	0.0-3.0-7.0-9.0-4.0-6.0-8.0-5.0-2.0-4.1-9.1-7.1-2.1-5.1-2.0-4.1-9.1-7.1-2.1-5.1-2.0-1.0	155	142810	158609
HG02293.verkko_filt_pat.fa:haplotype2-0000836_148310532_148812524_1	HG02293.verkko_filt_pat.fa:haplotype2-0000836_148310532_148812524_1	158708	161524	6	12	0	0	11	2816	160183	157367	0-3-7-9-4-6-8-5-2-4-9-7-2-5-2-4-9-7-2-5-2-1	0.0-3.0-7.0-9.0-4.0-6.0-8.0-5.0-2.0-4.1-9.1-7.1-2.1-5.1-2.0-4.1-9.1-7.1-2.1-5.1-2.0-1.0	155	158553	161369
HG02293.verkko_filt_pat.fa:haplotype2-0000836_148310532_148812524_1	HG02293.verkko_filt_pat.fa:haplotype2-0000836_148310532_148812524_1	161468	163238	8	8	0	0	7	1770	161953	160183	0-3-7-9-4-6-8-5-2-4-9-7-2-5-2-4-9-7-2-5-2-1	0.0-3.0-7.0-9.0-4.0-6.0-8.0-5.0-2.0-4.1-9.1-7.1-2.1-5.1-2.0-4.1-9.1-7.1-2.1-5.1-2.0-1.0	155	161313	163083
HG02293.verkko_filt_pat.fa:haplotype2-0000836_148310532_148812524_1	HG02293.verkko_filt_pat.fa:haplotype2-0000836_148310532_148812524_1	163182	176286	5	79	0	0	78	13104	175057	161953	0-3-7-9-4-6-8-5-2-4-9-7-2-5-2-4-9-7-2-5-2-1	0.0-3.0-7.0-9.0-4.0-6.0-8.0-5.0-2.0-4.1-9.1-7.1-2.1-5.1-2.0-4.1-9.1-7.1-2.1-5.1-2.0-1.0	155	163027	176131
HG02293.verkko_filt_pat.fa:haplotype2-0000836_148310532_148812524_1	HG02293.verkko_filt_pat.fa:haplotype2-0000836_148310532_148812524_1	176230	210168	2	196	0	0	194	33938	208995	175057	0-3-7-9-4-6-8-5-2-4-9-7-2-5-2-4-9-7-2-5-2-1	0.0-3.0-7.0-9.0-4.0-6.0-8.0-5.0-2.0-4.1-9.1-7.1-2.1-5.1-2.0-4.1-9.1-7.1-2.1-5.1-2.0-1.0	155	176075	210013
HG02293.verkko_filt_pat.fa:haplotype2-0000836_148310532_148812524_1	HG02293.verkko_filt_pat.fa:haplotype2-0000836_148310532_148812524_1	212419	223963	4	84	1	58	4	11544	220539	208995	0-3-7-9-4-6-8-5-2-4-9-7-2-5-2-4-9-7-2-5-2-1	0.0-3.0-7.0-9.0-4.0-6.0-8.0-5.0-2.0-4.1-9.1-7.1-2.1-5.1-2.0-4.1-9.1-7.1-2.1-5.1-2.0-1.0	155	212264	223808
HG02293.verkko_filt_pat.fa:haplotype2-0000836_148310532_148812524_1	HG02293.verkko_filt_pat.fa:haplotype2-0000836_148310532_148812524_1	225028	226339	9	5	1	4	0	1311	221850	220539	0-3-7-9-4-6-8-5-2-4-9-7-2-5-2-4-9-7-2-5-2-1	0.0-3.0-7.0-9.0-4.0-6.0-8.0-5.0-2.0-4.1-9.1-7.1-2.1-5.1-2.0-4.1-9.1-7.1-2.1-5.1-2.0-1.0	155	224873	226184
HG02293.verkko_filt_pat.fa:haplotype2-0000836_148310532_148812524_1	HG02293.verkko_filt_pat.fa:haplotype2-0000836_148310532_148812524_1	226283	228323	7	12	1	11	0	2040	223890	221850	0-3-7-9-4-6-8-5-2-4-9-7-2-5-2-4-9-7-2-5-2-1	0.0-3.0-7.0-9.0-4.0-6.0-8.0-5.0-2.0-4.1-9.1-7.1-2.1-5.1-2.0-4.1-9.1-7.1-2.1-5.1-2.0-1.0	155	226128	228168
HG02293.verkko_filt_pat.fa:haplotype2-0000836_148310532_148812524_1	HG02293.verkko_filt_pat.fa:haplotype2-0000836_148310532_148812524_1	229785	263724	2	196	1	194	0	33939	257829	223890	0-3-7-9-4-6-8-5-2-4-9-7-2-5-2-4-9-7-2-5-2-1	0.0-3.0-7.0-9.0-4.0-6.0-8.0-5.0-2.0-4.1-9.1-7.1-2.1-5.1-2.0-4.1-9.1-7.1-2.1-5.1-2.0-1.0	155	229630	263569
HG02293.verkko_filt_pat.fa:haplotype2-0000836_148310532_148812524_1	HG02293.verkko_filt_pat.fa:haplotype2-0000836_148310532_148812524_1	263668	275796	5	79	1	78	5	12128	269957	257829	0-3-7-9-4-6-8-5-2-4-9-7-2-5-2-4-9-7-2-5-2-1	0.0-3.0-7.0-9.0-4.0-6.0-8.0-5.0-2.0-4.1-9.1-7.1-2.1-5.1-2.0-4.1-9.1-7.1-2.1-5.1-2.0-1.0	155	263513	275641
HG02293.verkko_filt_pat.fa:haplotype2-0000836_148310532_148812524_1	HG02293.verkko_filt_pat.fa:haplotype2-0000836_148310532_148812524_1	276762	303956	2	196	0	39	191	27194	297151	269957	0-3-7-9-4-6-8-5-2-4-9-7-2-5-2-4-9-7-2-5-2-1	0.0-3.0-7.0-9.0-4.0-6.0-8.0-5.0-2.0-4.1-9.1-7.1-2.1-5.1-2.0-4.1-9.1-7.1-2.1-5.1-2.0-1.0	155	276607	303801
HG02293.verkko_filt_pat.fa:haplotype2-0000836_148310532_148812524_1	HG02293.verkko_filt_pat.fa:haplotype2-0000836_148310532_148812524_1	306548	318092	4	84	1	58	4	11544	308695	297151	0-3-7-9-4-6-8-5-2-4-9-7-2-5-2-4-9-7-2-5-2-1	0.0-3.0-7.0-9.0-4.0-6.0-8.0-5.0-2.0-4.1-9.1-7.1-2.1-5.1-2.0-4.1-9.1-7.1-2.1-5.1-2.0-1.0	155	306393	317937
HG02293.verkko_filt_pat.fa:haplotype2-0000836_148310532_148812524_1	HG02293.verkko_filt_pat.fa:haplotype2-0000836_148310532_148812524_1	319159	320470	9	5	1	4	0	1311	310006	308695	0-3-7-9-4-6-8-5-2-4-9-7-2-5-2-4-9-7-2-5-2-1	0.0-3.0-7.0-9.0-4.0-6.0-8.0-5.0-2.0-4.1-9.1-7.1-2.1-5.1-2.0-4.1-9.1-7.1-2.1-5.1-2.0-1.0	155	319004	320315
HG02293.verkko_filt_pat.fa:haplotype2-0000836_148310532_148812524_1	HG02293.verkko_filt_pat.fa:haplotype2-0000836_148310532_148812524_1	320414	322454	7	12	1	11	0	2040	312046	310006	0-3-7-9-4-6-8-5-2-4-9-7-2-5-2-4-9-7-2-5-2-1	0.0-3.0-7.0-9.0-4.0-6.0-8.0-5.0-2.0-4.1-9.1-7.1-2.1-5.1-2.0-4.1-9.1-7.1-2.1-5.1-2.0-1.0	155	320259	322299
HG02293.verkko_filt_pat.fa:haplotype2-0000836_148310532_148812524_1	HG02293.verkko_filt_pat.fa:haplotype2-0000836_148310532_148812524_1	323916	357856	2	196	1	194	0	33940	345986	312046	0-3-7-9-4-6-8-5-2-4-9-7-2-5-2-4-9-7-2-5-2-1	0.0-3.0-7.0-9.0-4.0-6.0-8.0-5.0-2.0-4.1-9.1-7.1-2.1-5.1-2.0-4.1-9.1-7.1-2.1-5.1-2.0-1.0	155	323761	357701
HG02293.verkko_filt_pat.fa:haplotype2-0000836_148310532_148812524_1	HG02293.verkko_filt_pat.fa:haplotype2-0000836_148310532_148812524_1	357800	369928	5	79	1	78	5	12128	358114	345986	0-3-7-9-4-6-8-5-2-4-9-7-2-5-2-4-9-7-2-5-2-1	0.0-3.0-7.0-9.0-4.0-6.0-8.0-5.0-2.0-4.1-9.1-7.1-2.1-5.1-2.0-4.1-9.1-7.1-2.1-5.1-2.0-1.0	155	357645	369773
HG02293.verkko_filt_pat.fa:haplotype2-0000836_148310532_148812524_1	HG02293.verkko_filt_pat.fa:haplotype2-0000836_148310532_148812524_1	370894	398812	2	196	0	39	195	27918	386032	358114	0-3-7-9-4-6-8-5-2-4-9-7-2-5-2-4-9-7-2-5-2-1	0.0-3.0-7.0-9.0-4.0-6.0-8.0-5.0-2.0-4.1-9.1-7.1-2.1-5.1-2.0-4.1-9.1-7.1-2.1-5.1-2.0-1.0	155	370739	398657
HG02293.verkko_filt_pat.fa:haplotype2-0000836_148310532_148812524_1	HG02293.verkko_filt_pat.fa:haplotype2-0000836_148310532_148812524_1	398756	501976	1	612	0	0	611	103220	489252	386032	0-3-7-9-4-6-8-5-2-4-9-7-2-5-2-4-9-7-2-5-2-1	0.0-3.0-7.0-9.0-4.0-6.0-8.0-5.0-2.0-4.1-9.1-7.1-2.1-5.1-2.0-4.1-9.1-7.1-2.1-5.1-2.0-1.0	155	398601	501821
HG02300.verkko_filt_mat.fa:haplotype1-0000028_144052837_144460586_1	HG02300.verkko_filt_mat.fa:haplotype1-0000028_144052837_144460586_1	154	115490	0	672	0	0	671	115336	115336	0	0-3-7-9-4-6-8-5-2-4-9-7-2-5-2-1	0.0-3.0-7.0-9.0-4.0-6.0-8.0-5.0-2.0-4.1-9.1-7.1-2.1-5.1-2.0-1.0	154	0	115336
HG02300.verkko_filt_mat.fa:haplotype1-0000028_144052837_144460586_1	HG02300.verkko_filt_mat.fa:haplotype1-0000028_144052837_144460586_1	115581	138412	3	132	0	0	131	22831	138167	115336	0-3-7-9-4-6-8-5-2-4-9-7-2-5-2-1	0.0-3.0-7.0-9.0-4.0-6.0-8.0-5.0-2.0-4.1-9.1-7.1-2.1-5.1-2.0-1.0	154	115427	138258
HG02300.verkko_filt_mat.fa:haplotype1-0000028_144052837_144460586_1	HG02300.verkko_filt_mat.fa:haplotype1-0000028_144052837_144460586_1	139171	141211	7	12	0	0	11	2040	140207	138167	0-3-7-9-4-6-8-5-2-4-9-7-2-5-2-1	0.0-3.0-7.0-9.0-4.0-6.0-8.0-5.0-2.0-4.1-9.1-7.1-2.1-5.1-2.0-1.0	154	139017	141057
HG02300.verkko_filt_mat.fa:haplotype1-0000028_144052837_144460586_1	HG02300.verkko_filt_mat.fa:haplotype1-0000028_144052837_144460586_1	141155	142466	9	5	0	0	4	1311	141518	140207	0-3-7-9-4-6-8-5-2-4-9-7-2-5-2-1	0.0-3.0-7.0-9.0-4.0-6.0-8.0-5.0-2.0-4.1-9.1-7.1-2.1-5.1-2.0-1.0	154	141001	142312
HG02300.verkko_filt_mat.fa:haplotype1-0000028_144052837_144460586_1	HG02300.verkko_filt_mat.fa:haplotype1-0000028_144052837_144460586_1	143257	158707	4	84	0	1	83	15450	156968	141518	0-3-7-9-4-6-8-5-2-4-9-7-2-5-2-1	0.0-3.0-7.0-9.0-4.0-6.0-8.0-5.0-2.0-4.1-9.1-7.1-2.1-5.1-2.0-1.0	154	143103	158553
HG02300.verkko_filt_mat.fa:haplotype1-0000028_144052837_144460586_1	HG02300.verkko_filt_mat.fa:haplotype1-0000028_144052837_144460586_1	158651	161466	6	12	0	0	11	2815	159783	156968	0-3-7-9-4-6-8-5-2-4-9-7-2-5-2-1	0.0-3.0-7.0-9.0-4.0-6.0-8.0-5.0-2.0-4.1-9.1-7.1-2.1-5.1-2.0-1.0	154	158497	161312
HG02300.verkko_filt_mat.fa:haplotype1-0000028_144052837_144460586_1	HG02300.verkko_filt_mat.fa:haplotype1-0000028_144052837_144460586_1	161410	163180	8	8	0	0	7	1770	161553	159783	0-3-7-9-4-6-8-5-2-4-9-7-2-5-2-1	0.0-3.0-7.0-9.0-4.0-6.0-8.0-5.0-2.0-4.1-9.1-7.1-2.1-5.1-2.0-1.0	154	161256	163026
HG02300.verkko_filt_mat.fa:haplotype1-0000028_144052837_144460586_1	HG02300.verkko_filt_mat.fa:haplotype1-0000028_144052837_144460586_1	163124	176228	5	79	0	0	78	13104	174657	161553	0-3-7-9-4-6-8-5-2-4-9-7-2-5-2-1	0.0-3.0-7.0-9.0-4.0-6.0-8.0-5.0-2.0-4.1-9.1-7.1-2.1-5.1-2.0-1.0	154	162970	176074
HG02300.verkko_filt_mat.fa:haplotype1-0000028_144052837_144460586_1	HG02300.verkko_filt_mat.fa:haplotype1-0000028_144052837_144460586_1	176172	210494	2	196	0	0	195	34322	208979	174657	0-3-7-9-4-6-8-5-2-4-9-7-2-5-2-1	0.0-3.0-7.0-9.0-4.0-6.0-8.0-5.0-2.0-4.1-9.1-7.1-2.1-5.1-2.0-1.0	154	176018	210340
HG02300.verkko_filt_mat.fa:haplotype1-0000028_144052837_144460586_1	HG02300.verkko_filt_mat.fa:haplotype1-0000028_144052837_144460586_1	212360	223904	4	84	1	58	4	11544	220523	208979	0-3-7-9-4-6-8-5-2-4-9-7-2-5-2-1	0.0-3.0-7.0-9.0-4.0-6.0-8.0-5.0-2.0-4.1-9.1-7.1-2.1-5.1-2.0-1.0	154	212206	223750
HG02300.verkko_filt_mat.fa:haplotype1-0000028_144052837_144460586_1	HG02300.verkko_filt_mat.fa:haplotype1-0000028_144052837_144460586_1	224967	226278	9	5	1	4	0	1311	221834	220523	0-3-7-9-4-6-8-5-2-4-9-7-2-5-2-1	0.0-3.0-7.0-9.0-4.0-6.0-8.0-5.0-2.0-4.1-9.1-7.1-2.1-5.1-2.0-1.0	154	224813	226124
HG02300.verkko_filt_mat.fa:haplotype1-0000028_144052837_144460586_1	HG02300.verkko_filt_mat.fa:haplotype1-0000028_144052837_144460586_1	226222	228262	7	12	1	11	0	2040	223874	221834	0-3-7-9-4-6-8-5-2-4-9-7-2-5-2-1	0.0-3.0-7.0-9.0-4.0-6.0-8.0-5.0-2.0-4.1-9.1-7.1-2.1-5.1-2.0-1.0	154	226068	228108
HG02300.verkko_filt_mat.fa:haplotype1-0000028_144052837_144460586_1	HG02300.verkko_filt_mat.fa:haplotype1-0000028_144052837_144460586_1	229339	263444	2	196	1	195	1	34105	257979	223874	0-3-7-9-4-6-8-5-2-4-9-7-2-5-2-1	0.0-3.0-7.0-9.0-4.0-6.0-8.0-5.0-2.0-4.1-9.1-7.1-2.1-5.1-2.0-1.0	154	229185	263290
HG02300.verkko_filt_mat.fa:haplotype1-0000028_144052837_144460586_1	HG02300.verkko_filt_mat.fa:haplotype1-0000028_144052837_144460586_1	264051	276266	5	79	1	77	3	12215	270194	257979	0-3-7-9-4-6-8-5-2-4-9-7-2-5-2-1	0.0-3.0-7.0-9.0-4.0-6.0-8.0-5.0-2.0-4.1-9.1-7.1-2.1-5.1-2.0-1.0	154	263897	276112
HG02300.verkko_filt_mat.fa:haplotype1-0000028_144052837_144460586_1	HG02300.verkko_filt_mat.fa:haplotype1-0000028_144052837_144460586_1	276705	304606	2	196	0	39	195	27901	298095	270194	0-3-7-9-4-6-8-5-2-4-9-7-2-5-2-1	0.0-3.0-7.0-9.0-4.0-6.0-8.0-5.0-2.0-4.1-9.1-7.1-2.1-5.1-2.0-1.0	154	276551	304452
HG02300.verkko_filt_mat.fa:haplotype1-0000028_144052837_144460586_1	HG02300.verkko_filt_mat.fa:haplotype1-0000028_144052837_144460586_1	304550	407733	1	612	0	0	611	103183	401278	298095	0-3-7-9-4-6-8-5-2-4-9-7-2-5-2-1	0.0-3.0-7.0-9.0-4.0-6.0-8.0-5.0-2.0-4.1-9.1-7.1-2.1-5.1-2.0-1.0	154	304396	407579
HG02300.verkko_filt_pat.fa:haplotype2-0000620_143362344_143769323_1	HG02300.verkko_filt_pat.fa:haplotype2-0000620_143362344_143769323_1	155	115567	0	672	0	0	671	115412	115412	0	0-3-7-9-4-6-8-5-2-4-9-7-2-5-2-1	0.0-3.0-7.0-9.0-4.0-6.0-8.0-5.0-2.0-4.1-9.1-7.1-2.1-5.0-2.0-1.0	155	0	115412
HG02300.verkko_filt_pat.fa:haplotype2-0000620_143362344_143769323_1	HG02300.verkko_filt_pat.fa:haplotype2-0000620_143362344_143769323_1	115658	138491	3	132	0	0	131	22833	138245	115412	0-3-7-9-4-6-8-5-2-4-9-7-2-5-2-1	0.0-3.0-7.0-9.0-4.0-6.0-8.0-5.0-2.0-4.1-9.1-7.1-2.1-5.0-2.0-1.0	155	115503	138336
HG02300.verkko_filt_pat.fa:haplotype2-0000620_143362344_143769323_1	HG02300.verkko_filt_pat.fa:haplotype2-0000620_143362344_143769323_1	139250	141290	7	12	0	0	11	2040	140285	138245	0-3-7-9-4-6-8-5-2-4-9-7-2-5-2-1	0.0-3.0-7.0-9.0-4.0-6.0-8.0-5.0-2.0-4.1-9.1-7.1-2.1-5.0-2.0-1.0	155	139095	141135
HG02300.verkko_filt_pat.fa:haplotype2-0000620_143362344_143769323_1	HG02300.verkko_filt_pat.fa:haplotype2-0000620_143362344_143769323_1	141234	142546	9	5	0	0	4	1312	141597	140285	0-3-7-9-4-6-8-5-2-4-9-7-2-5-2-1	0.0-3.0-7.0-9.0-4.0-6.0-8.0-5.0-2.0-4.1-9.1-7.1-2.1-5.0-2.0-1.0	155	141079	142391
HG02300.verkko_filt_pat.fa:haplotype2-0000620_143362344_143769323_1	HG02300.verkko_filt_pat.fa:haplotype2-0000620_143362344_143769323_1	142994	158789	4	84	0	0	83	15795	157392	141597	0-3-7-9-4-6-8-5-2-4-9-7-2-5-2-1	0.0-3.0-7.0-9.0-4.0-6.0-8.0-5.0-2.0-4.1-9.1-7.1-2.1-5.0-2.0-1.0	155	142839	158634
HG02300.verkko_filt_pat.fa:haplotype2-0000620_143362344_143769323_1	HG02300.verkko_filt_pat.fa:haplotype2-0000620_143362344_143769323_1	158733	161549	6	12	0	0	11	2816	160208	157392	0-3-7-9-4-6-8-5-2-4-9-7-2-5-2-1	0.0-3.0-7.0-9.0-4.0-6.0-8.0-5.0-2.0-4.1-9.1-7.1-2.1-5.0-2.0-1.0	155	158578	161394
HG02300.verkko_filt_pat.fa:haplotype2-0000620_143362344_143769323_1	HG02300.verkko_filt_pat.fa:haplotype2-0000620_143362344_143769323_1	161493	163263	8	8	0	0	7	1770	161978	160208	0-3-7-9-4-6-8-5-2-4-9-7-2-5-2-1	0.0-3.0-7.0-9.0-4.0-6.0-8.0-5.0-2.0-4.1-9.1-7.1-2.1-5.0-2.0-1.0	155	161338	163108
HG02300.verkko_filt_pat.fa:haplotype2-0000620_143362344_143769323_1	HG02300.verkko_filt_pat.fa:haplotype2-0000620_143362344_143769323_1	163207	176311	5	79	0	0	78	13104	175082	161978	0-3-7-9-4-6-8-5-2-4-9-7-2-5-2-1	0.0-3.0-7.0-9.0-4.0-6.0-8.0-5.0-2.0-4.1-9.1-7.1-2.1-5.0-2.0-1.0	155	163052	176156
HG02300.verkko_filt_pat.fa:haplotype2-0000620_143362344_143769323_1	HG02300.verkko_filt_pat.fa:haplotype2-0000620_143362344_143769323_1	176255	209850	2	196	0	0	191	33595	208677	175082	0-3-7-9-4-6-8-5-2-4-9-7-2-5-2-1	0.0-3.0-7.0-9.0-4.0-6.0-8.0-5.0-2.0-4.1-9.1-7.1-2.1-5.0-2.0-1.0	155	176100	209695
HG02300.verkko_filt_pat.fa:haplotype2-0000620_143362344_143769323_1	HG02300.verkko_filt_pat.fa:haplotype2-0000620_143362344_143769323_1	212442	223988	4	84	1	58	4	11546	220223	208677	0-3-7-9-4-6-8-5-2-4-9-7-2-5-2-1	0.0-3.0-7.0-9.0-4.0-6.0-8.0-5.0-2.0-4.1-9.1-7.1-2.1-5.0-2.0-1.0	155	212287	223833
HG02300.verkko_filt_pat.fa:haplotype2-0000620_143362344_143769323_1	HG02300.verkko_filt_pat.fa:haplotype2-0000620_143362344_143769323_1	225053	226364	9	5	1	4	0	1311	221534	220223	0-3-7-9-4-6-8-5-2-4-9-7-2-5-2-1	0.0-3.0-7.0-9.0-4.0-6.0-8.0-5.0-2.0-4.1-9.1-7.1-2.1-5.0-2.0-1.0	155	224898	226209
HG02300.verkko_filt_pat.fa:haplotype2-0000620_143362344_143769323_1	HG02300.verkko_filt_pat.fa:haplotype2-0000620_143362344_143769323_1	226308	228348	7	12	1	11	0	2040	223574	221534	0-3-7-9-4-6-8-5-2-4-9-7-2-5-2-1	0.0-3.0-7.0-9.0-4.0-6.0-8.0-5.0-2.0-4.1-9.1-7.1-2.1-5.0-2.0-1.0	155	226153	228193
HG02300.verkko_filt_pat.fa:haplotype2-0000620_143362344_143769323_1	HG02300.verkko_filt_pat.fa:haplotype2-0000620_143362344_143769323_1	229810	257333	2	196	1	194	39	27523	251097	223574	0-3-7-9-4-6-8-5-2-4-9-7-2-5-2-1	0.0-3.0-7.0-9.0-4.0-6.0-8.0-5.0-2.0-4.1-9.1-7.1-2.1-5.0-2.0-1.0	155	229655	257178
HG02300.verkko_filt_pat.fa:haplotype2-0000620_143362344_143769323_1	HG02300.verkko_filt_pat.fa:haplotype2-0000620_143362344_143769323_1	258299	269987	5	79	0	5	77	11688	262785	251097	0-3-7-9-4-6-8-5-2-4-9-7-2-5-2-1	0.0-3.0-7.0-9.0-4.0-6.0-8.0-5.0-2.0-4.1-9.1-7.1-2.1-5.0-2.0-1.0	155	258144	269832
HG02300.verkko_filt_pat.fa:haplotype2-0000620_143362344_143769323_1	HG02300.verkko_filt_pat.fa:haplotype2-0000620_143362344_143769323_1	270594	304693	2	196	0	1	195	34099	296884	262785	0-3-7-9-4-6-8-5-2-4-9-7-2-5-2-1	0.0-3.0-7.0-9.0-4.0-6.0-8.0-5.0-2.0-4.1-9.1-7.1-2.1-5.0-2.0-1.0	155	270439	304538
HG02300.verkko_filt_pat.fa:haplotype2-0000620_143362344_143769323_1	HG02300.verkko_filt_pat.fa:haplotype2-0000620_143362344_143769323_1	304637	406775	1	612	0	0	604	102138	399022	296884	0-3-7-9-4-6-8-5-2-4-9-7-2-5-2-1	0.0-3.0-7.0-9.0-4.0-6.0-8.0-5.0-2.0-4.1-9.1-7.1-2.1-5.0-2.0-1.0	155	304482	406620
HG02486#1#JAGYVM010000007.1_28868414_29370339_1	HG02486	154	115521	0	672	0	0	671	115367	115367	0	0-3-7-9-4-6-8-5-2-4-9-7-2-5-2-7-9-4-2-5-2-1	0.0-3.0-7.0-9.0-4.0-6.0-8.0-5.0-2.0-4.1-9.1-7.1-2.1-5.1-2.0-7.0-9.0-4.0-2.1-5.0-2.0-1.0	154	0	115367
HG02486#1#JAGYVM010000007.1_28868414_29370339_1	HG02486	115612	138447	3	132	0	0	131	22835	138202	115367	0-3-7-9-4-6-8-5-2-4-9-7-2-5-2-7-9-4-2-5-2-1	0.0-3.0-7.0-9.0-4.0-6.0-8.0-5.0-2.0-4.1-9.1-7.1-2.1-5.1-2.0-7.0-9.0-4.0-2.1-5.0-2.0-1.0	154	115458	138293
HG02486#1#JAGYVM010000007.1_28868414_29370339_1	HG02486	139206	141246	7	12	0	0	11	2040	140242	138202	0-3-7-9-4-6-8-5-2-4-9-7-2-5-2-7-9-4-2-5-2-1	0.0-3.0-7.0-9.0-4.0-6.0-8.0-5.0-2.0-4.1-9.1-7.1-2.1-5.1-2.0-7.0-9.0-4.0-2.1-5.0-2.0-1.0	154	139052	141092
HG02486#1#JAGYVM010000007.1_28868414_29370339_1	HG02486	141190	142501	9	5	0	0	4	1311	141553	140242	0-3-7-9-4-6-8-5-2-4-9-7-2-5-2-7-9-4-2-5-2-1	0.0-3.0-7.0-9.0-4.0-6.0-8.0-5.0-2.0-4.1-9.1-7.1-2.1-5.1-2.0-7.0-9.0-4.0-2.1-5.0-2.0-1.0	154	141036	142347
HG02486#1#JAGYVM010000007.1_28868414_29370339_1	HG02486	142949	158762	4	84	0	0	83	15813	157366	141553	0-3-7-9-4-6-8-5-2-4-9-7-2-5-2-7-9-4-2-5-2-1	0.0-3.0-7.0-9.0-4.0-6.0-8.0-5.0-2.0-4.1-9.1-7.1-2.1-5.1-2.0-7.0-9.0-4.0-2.1-5.0-2.0-1.0	154	142795	158608
HG02486#1#JAGYVM010000007.1_28868414_29370339_1	HG02486	158706	161521	6	12	0	0	11	2815	160181	157366	0-3-7-9-4-6-8-5-2-4-9-7-2-5-2-7-9-4-2-5-2-1	0.0-3.0-7.0-9.0-4.0-6.0-8.0-5.0-2.0-4.1-9.1-7.1-2.1-5.1-2.0-7.0-9.0-4.0-2.1-5.0-2.0-1.0	154	158552	161367
HG02486#1#JAGYVM010000007.1_28868414_29370339_1	HG02486	161465	163235	8	8	0	0	7	1770	161951	160181	0-3-7-9-4-6-8-5-2-4-9-7-2-5-2-7-9-4-2-5-2-1	0.0-3.0-7.0-9.0-4.0-6.0-8.0-5.0-2.0-4.1-9.1-7.1-2.1-5.1-2.0-7.0-9.0-4.0-2.1-5.0-2.0-1.0	154	161311	163081
HG02486#1#JAGYVM010000007.1_28868414_29370339_1	HG02486	163179	176283	5	79	0	0	78	13104	175055	161951	0-3-7-9-4-6-8-5-2-4-9-7-2-5-2-7-9-4-2-5-2-1	0.0-3.0-7.0-9.0-4.0-6.0-8.0-5.0-2.0-4.1-9.1-7.1-2.1-5.1-2.0-7.0-9.0-4.0-2.1-5.0-2.0-1.0	154	163025	176129
HG02486#1#JAGYVM010000007.1_28868414_29370339_1	HG02486	176227	210559	2	196	0	0	195	34332	209387	175055	0-3-7-9-4-6-8-5-2-4-9-7-2-5-2-7-9-4-2-5-2-1	0.0-3.0-7.0-9.0-4.0-6.0-8.0-5.0-2.0-4.1-9.1-7.1-2.1-5.1-2.0-7.0-9.0-4.0-2.1-5.0-2.0-1.0	154	176073	210405
HG02486#1#JAGYVM010000007.1_28868414_29370339_1	HG02486	212425	223975	4	84	1	58	4	11550	220937	209387	0-3-7-9-4-6-8-5-2-4-9-7-2-5-2-7-9-4-2-5-2-1	0.0-3.0-7.0-9.0-4.0-6.0-8.0-5.0-2.0-4.1-9.1-7.1-2.1-5.1-2.0-7.0-9.0-4.0-2.1-5.0-2.0-1.0	154	212271	223821
HG02486#1#JAGYVM010000007.1_28868414_29370339_1	HG02486	225040	226351	9	5	1	4	0	1311	222248	220937	0-3-7-9-4-6-8-5-2-4-9-7-2-5-2-7-9-4-2-5-2-1	0.0-3.0-7.0-9.0-4.0-6.0-8.0-5.0-2.0-4.1-9.1-7.1-2.1-5.1-2.0-7.0-9.0-4.0-2.1-5.0-2.0-1.0	154	224886	226197
HG02486#1#JAGYVM010000007.1_28868414_29370339_1	HG02486	226295	228335	7	12	1	11	0	2040	224288	222248	0-3-7-9-4-6-8-5-2-4-9-7-2-5-2-7-9-4-2-5-2-1	0.0-3.0-7.0-9.0-4.0-6.0-8.0-5.0-2.0-4.1-9.1-7.1-2.1-5.1-2.0-7.0-9.0-4.0-2.1-5.0-2.0-1.0	154	226141	228181
HG02486#1#JAGYVM010000007.1_28868414_29370339_1	HG02486	229412	263520	2	196	1	195	1	34108	258396	224288	0-3-7-9-4-6-8-5-2-4-9-7-2-5-2-7-9-4-2-5-2-1	0.0-3.0-7.0-9.0-4.0-6.0-8.0-5.0-2.0-4.1-9.1-7.1-2.1-5.1-2.0-7.0-9.0-4.0-2.1-5.0-2.0-1.0	154	229258	263366
HG02486#1#JAGYVM010000007.1_28868414_29370339_1	HG02486	264601	276341	5	79	1	75	3	11740	270136	258396	0-3-7-9-4-6-8-5-2-4-9-7-2-5-2-7-9-4-2-5-2-1	0.0-3.0-7.0-9.0-4.0-6.0-8.0-5.0-2.0-4.1-9.1-7.1-2.1-5.1-2.0-7.0-9.0-4.0-2.1-5.0-2.0-1.0	154	264447	276187
HG02486#1#JAGYVM010000007.1_28868414_29370339_1	HG02486	276780	304680	2	196	0	39	195	27900	298036	270136	0-3-7-9-4-6-8-5-2-4-9-7-2-5-2-7-9-4-2-5-2-1	0.0-3.0-7.0-9.0-4.0-6.0-8.0-5.0-2.0-4.1-9.1-7.1-2.1-5.1-2.0-7.0-9.0-4.0-2.1-5.0-2.0-1.0	154	276626	304526
HG02486#1#JAGYVM010000007.1_28868414_29370339_1	HG02486	305757	307797	7	12	0	0	11	2040	300076	298036	0-3-7-9-4-6-8-5-2-4-9-7-2-5-2-7-9-4-2-5-2-1	0.0-3.0-7.0-9.0-4.0-6.0-8.0-5.0-2.0-4.1-9.1-7.1-2.1-5.1-2.0-7.0-9.0-4.0-2.1-5.0-2.0-1.0	154	305603	307643
HG02486#1#JAGYVM010000007.1_28868414_29370339_1	HG02486	307741	309052	9	5	0	0	4	1311	301387	300076	0-3-7-9-4-6-8-5-2-4-9-7-2-5-2-7-9-4-2-5-2-1	0.0-3.0-7.0-9.0-4.0-6.0-8.0-5.0-2.0-4.1-9.1-7.1-2.1-5.1-2.0-7.0-9.0-4.0-2.1-5.0-2.0-1.0	154	307587	308898
HG02486#1#JAGYVM010000007.1_28868414_29370339_1	HG02486	309500	321662	4	84	0	0	58	12162	313549	301387	0-3-7-9-4-6-8-5-2-4-9-7-2-5-2-7-9-4-2-5-2-1	0.0-3.0-7.0-9.0-4.0-6.0-8.0-5.0-2.0-4.1-9.1-7.1-2.1-5.1-2.0-7.0-9.0-4.0-2.1-5.0-2.0-1.0	154	309346	321508
HG02486#1#JAGYVM010000007.1_28868414_29370339_1	HG02486	323528	351430	2	196	1	195	39	27902	341451	313549	0-3-7-9-4-6-8-5-2-4-9-7-2-5-2-7-9-4-2-5-2-1	0.0-3.0-7.0-9.0-4.0-6.0-8.0-5.0-2.0-4.1-9.1-7.1-2.1-5.1-2.0-7.0-9.0-4.0-2.1-5.0-2.0-1.0	154	323374	351276
HG02486#1#JAGYVM010000007.1_28868414_29370339_1	HG02486	351869	363609	5	79	0	3	75	11740	353191	341451	0-3-7-9-4-6-8-5-2-4-9-7-2-5-2-7-9-4-2-5-2-1	0.0-3.0-7.0-9.0-4.0-6.0-8.0-5.0-2.0-4.1-9.1-7.1-2.1-5.1-2.0-7.0-9.0-4.0-2.1-5.0-2.0-1.0	154	351715	363455
HG02486#1#JAGYVM010000007.1_28868414_29370339_1	HG02486	364690	398796	2	196	0	1	195	34106	387297	353191	0-3-7-9-4-6-8-5-2-4-9-7-2-5-2-7-9-4-2-5-2-1	0.0-3.0-7.0-9.0-4.0-6.0-8.0-5.0-2.0-4.1-9.1-7.1-2.1-5.1-2.0-7.0-9.0-4.0-2.1-5.0-2.0-1.0	154	364536	398642
HG02486#1#JAGYVM010000007.1_28868414_29370339_1	HG02486	398740	501909	1	612	0	0	611	103169	490466	387297	0-3-7-9-4-6-8-5-2-4-9-7-2-5-2-7-9-4-2-5-2-1	0.0-3.0-7.0-9.0-4.0-6.0-8.0-5.0-2.0-4.1-9.1-7.1-2.1-5.1-2.0-7.0-9.0-4.0-2.1-5.0-2.0-1.0	154	398586	501755
HG02486#2#JAGYVL010000029.1_94163344_94570162_0	HG02486	98	115414	0	672	0	0	671	115316	115316	0	0-3-7-9-4-6-8-5-2-7-9-4-2-5-2-1	0.0-3.0-7.0-9.0-4.0-6.0-8.0-5.0-2.0-7.0-9.0-4.0-2.1-5.1-2.0-1.0	98	0	115316
HG02486#2#JAGYVL010000029.1_94163344_94570162_0	HG02486	115505	138340	3	132	0	0	131	22835	138151	115316	0-3-7-9-4-6-8-5-2-7-9-4-2-5-2-1	0.0-3.0-7.0-9.0-4.0-6.0-8.0-5.0-2.0-7.0-9.0-4.0-2.1-5.1-2.0-1.0	98	115407	138242
HG02486#2#JAGYVL010000029.1_94163344_94570162_0	HG02486	139099	141139	7	12	0	0	11	2040	140191	138151	0-3-7-9-4-6-8-5-2-7-9-4-2-5-2-1	0.0-3.0-7.0-9.0-4.0-6.0-8.0-5.0-2.0-7.0-9.0-4.0-2.1-5.1-2.0-1.0	98	139001	141041
HG02486#2#JAGYVL010000029.1_94163344_94570162_0	HG02486	141083	142394	9	5	0	0	4	1311	141502	140191	0-3-7-9-4-6-8-5-2-7-9-4-2-5-2-1	0.0-3.0-7.0-9.0-4.0-6.0-8.0-5.0-2.0-7.0-9.0-4.0-2.1-5.1-2.0-1.0	98	140985	142296
HG02486#2#JAGYVL010000029.1_94163344_94570162_0	HG02486	142842	158655	4	84	0	0	83	15813	157315	141502	0-3-7-9-4-6-8-5-2-7-9-4-2-5-2-1	0.0-3.0-7.0-9.0-4.0-6.0-8.0-5.0-2.0-7.0-9.0-4.0-2.1-5.1-2.0-1.0	98	142744	158557
HG02486#2#JAGYVL010000029.1_94163344_94570162_0	HG02486	158599	161414	6	12	0	0	11	2815	160130	157315	0-3-7-9-4-6-8-5-2-7-9-4-2-5-2-1	0.0-3.0-7.0-9.0-4.0-6.0-8.0-5.0-2.0-7.0-9.0-4.0-2.1-5.1-2.0-1.0	98	158501	161316
HG02486#2#JAGYVL010000029.1_94163344_94570162_0	HG02486	161358	163128	8	8	0	0	7	1770	161900	160130	0-3-7-9-4-6-8-5-2-7-9-4-2-5-2-1	0.0-3.0-7.0-9.0-4.0-6.0-8.0-5.0-2.0-7.0-9.0-4.0-2.1-5.1-2.0-1.0	98	161260	163030
HG02486#2#JAGYVL010000029.1_94163344_94570162_0	HG02486	163072	175262	5	79	0	0	75	12190	174090	161900	0-3-7-9-4-6-8-5-2-7-9-4-2-5-2-1	0.0-3.0-7.0-9.0-4.0-6.0-8.0-5.0-2.0-7.0-9.0-4.0-2.1-5.1-2.0-1.0	98	162974	175164
HG02486#2#JAGYVL010000029.1_94163344_94570162_0	HG02486	176343	210442	2	196	0	1	195	34099	208189	174090	0-3-7-9-4-6-8-5-2-7-9-4-2-5-2-1	0.0-3.0-7.0-9.0-4.0-6.0-8.0-5.0-2.0-7.0-9.0-4.0-2.1-5.1-2.0-1.0	98	176245	210344
HG02486#2#JAGYVL010000029.1_94163344_94570162_0	HG02486	211519	213559	7	12	0	0	11	2040	210229	208189	0-3-7-9-4-6-8-5-2-7-9-4-2-5-2-1	0.0-3.0-7.0-9.0-4.0-6.0-8.0-5.0-2.0-7.0-9.0-4.0-2.1-5.1-2.0-1.0	98	211421	213461
HG02486#2#JAGYVL010000029.1_94163344_94570162_0	HG02486	213503	214814	9	5	0	0	4	1311	211540	210229	0-3-7-9-4-6-8-5-2-7-9-4-2-5-2-1	0.0-3.0-7.0-9.0-4.0-6.0-8.0-5.0-2.0-7.0-9.0-4.0-2.1-5.1-2.0-1.0	98	213405	214716
HG02486#2#JAGYVL010000029.1_94163344_94570162_0	HG02486	215879	227429	4	84	0	4	58	11550	223090	211540	0-3-7-9-4-6-8-5-2-7-9-4-2-5-2-1	0.0-3.0-7.0-9.0-4.0-6.0-8.0-5.0-2.0-7.0-9.0-4.0-2.1-5.1-2.0-1.0	98	215781	227331
HG02486#2#JAGYVL010000029.1_94163344_94570162_0	HG02486	229295	263398	2	196	1	195	1	34103	257193	223090	0-3-7-9-4-6-8-5-2-7-9-4-2-5-2-1	0.0-3.0-7.0-9.0-4.0-6.0-8.0-5.0-2.0-7.0-9.0-4.0-2.1-5.1-2.0-1.0	98	229197	263300
HG02486#2#JAGYVL010000029.1_94163344_94570162_0	HG02486	264005	276220	5	79	1	77	3	12215	269408	257193	0-3-7-9-4-6-8-5-2-7-9-4-2-5-2-1	0.0-3.0-7.0-9.0-4.0-6.0-8.0-5.0-2.0-7.0-9.0-4.0-2.1-5.1-2.0-1.0	98	263907	276122
HG02486#2#JAGYVL010000029.1_94163344_94570162_0	HG02486	276659	304566	2	196	0	39	195	27907	297315	269408	0-3-7-9-4-6-8-5-2-7-9-4-2-5-2-1	0.0-3.0-7.0-9.0-4.0-6.0-8.0-5.0-2.0-7.0-9.0-4.0-2.1-5.1-2.0-1.0	98	276561	304468
HG02486#2#JAGYVL010000029.1_94163344_94570162_0	HG02486	304510	406874	1	612	0	0	606	102364	399679	297315	0-3-7-9-4-6-8-5-2-7-9-4-2-5-2-1	0.0-3.0-7.0-9.0-4.0-6.0-8.0-5.0-2.0-7.0-9.0-4.0-2.1-5.1-2.0-1.0	98	304412	406776
HG02559#1#JAGYVK010000012.1_51505852_51913611_0	HG02559	98	115467	0	672	0	0	671	115369	115369	0	0-3-7-9-4-6-8-5-2-4-9-7-2-5-2-1	0.0-3.0-7.0-9.0-4.0-6.0-8.0-5.0-2.0-4.1-9.1-7.1-2.1-5.1-2.0-1.0	98	0	115369
HG02559#1#JAGYVK010000012.1_51505852_51913611_0	HG02559	115558	138394	3	132	0	0	131	22836	138205	115369	0-3-7-9-4-6-8-5-2-4-9-7-2-5-2-1	0.0-3.0-7.0-9.0-4.0-6.0-8.0-5.0-2.0-4.1-9.1-7.1-2.1-5.1-2.0-1.0	98	115460	138296
HG02559#1#JAGYVK010000012.1_51505852_51913611_0	HG02559	139153	141193	7	12	0	0	11	2040	140245	138205	0-3-7-9-4-6-8-5-2-4-9-7-2-5-2-1	0.0-3.0-7.0-9.0-4.0-6.0-8.0-5.0-2.0-4.1-9.1-7.1-2.1-5.1-2.0-1.0	98	139055	141095
HG02559#1#JAGYVK010000012.1_51505852_51913611_0	HG02559	141137	142448	9	5	0	0	4	1311	141556	140245	0-3-7-9-4-6-8-5-2-4-9-7-2-5-2-1	0.0-3.0-7.0-9.0-4.0-6.0-8.0-5.0-2.0-4.1-9.1-7.1-2.1-5.1-2.0-1.0	98	141039	142350
HG02559#1#JAGYVK010000012.1_51505852_51913611_0	HG02559	142896	158695	4	84	0	0	83	15799	157355	141556	0-3-7-9-4-6-8-5-2-4-9-7-2-5-2-1	0.0-3.0-7.0-9.0-4.0-6.0-8.0-5.0-2.0-4.1-9.1-7.1-2.1-5.1-2.0-1.0	98	142798	158597
HG02559#1#JAGYVK010000012.1_51505852_51913611_0	HG02559	158639	161454	6	12	0	0	11	2815	160170	157355	0-3-7-9-4-6-8-5-2-4-9-7-2-5-2-1	0.0-3.0-7.0-9.0-4.0-6.0-8.0-5.0-2.0-4.1-9.1-7.1-2.1-5.1-2.0-1.0	98	158541	161356
HG02559#1#JAGYVK010000012.1_51505852_51913611_0	HG02559	161398	163168	8	8	0	0	7	1770	161940	160170	0-3-7-9-4-6-8-5-2-4-9-7-2-5-2-1	0.0-3.0-7.0-9.0-4.0-6.0-8.0-5.0-2.0-4.1-9.1-7.1-2.1-5.1-2.0-1.0	98	161300	163070
HG02559#1#JAGYVK010000012.1_51505852_51913611_0	HG02559	163112	175302	5	79	0	0	75	12190	174130	161940	0-3-7-9-4-6-8-5-2-4-9-7-2-5-2-1	0.0-3.0-7.0-9.0-4.0-6.0-8.0-5.0-2.0-4.1-9.1-7.1-2.1-5.1-2.0-1.0	98	163014	175204
HG02559#1#JAGYVK010000012.1_51505852_51913611_0	HG02559	176383	210103	2	196	0	1	194	33720	207850	174130	0-3-7-9-4-6-8-5-2-4-9-7-2-5-2-1	0.0-3.0-7.0-9.0-4.0-6.0-8.0-5.0-2.0-4.1-9.1-7.1-2.1-5.1-2.0-1.0	98	176285	210005
HG02559#1#JAGYVK010000012.1_51505852_51913611_0	HG02559	212354	223476	4	84	1	58	6	11122	218972	207850	0-3-7-9-4-6-8-5-2-4-9-7-2-5-2-1	0.0-3.0-7.0-9.0-4.0-6.0-8.0-5.0-2.0-4.1-9.1-7.1-2.1-5.1-2.0-1.0	98	212256	223378
HG02559#1#JAGYVK010000012.1_51505852_51913611_0	HG02559	224963	226274	9	5	1	4	0	1311	220283	218972	0-3-7-9-4-6-8-5-2-4-9-7-2-5-2-1	0.0-3.0-7.0-9.0-4.0-6.0-8.0-5.0-2.0-4.1-9.1-7.1-2.1-5.1-2.0-1.0	98	224865	226176
HG02559#1#JAGYVK010000012.1_51505852_51913611_0	HG02559	226218	228258	7	12	1	11	0	2040	222323	220283	0-3-7-9-4-6-8-5-2-4-9-7-2-5-2-1	0.0-3.0-7.0-9.0-4.0-6.0-8.0-5.0-2.0-4.1-9.1-7.1-2.1-5.1-2.0-1.0	98	226120	228160
HG02559#1#JAGYVK010000012.1_51505852_51913611_0	HG02559	229720	263445	2	196	1	194	1	33725	256048	222323	0-3-7-9-4-6-8-5-2-4-9-7-2-5-2-1	0.0-3.0-7.0-9.0-4.0-6.0-8.0-5.0-2.0-4.1-9.1-7.1-2.1-5.1-2.0-1.0	98	229622	263347
HG02559#1#JAGYVK010000012.1_51505852_51913611_0	HG02559	264526	276266	5	79	1	75	3	11740	267788	256048	0-3-7-9-4-6-8-5-2-4-9-7-2-5-2-1	0.0-3.0-7.0-9.0-4.0-6.0-8.0-5.0-2.0-4.1-9.1-7.1-2.1-5.1-2.0-1.0	98	264428	276168
HG02559#1#JAGYVK010000012.1_51505852_51913611_0	HG02559	276705	304615	2	196	0	39	195	27910	295698	267788	0-3-7-9-4-6-8-5-2-4-9-7-2-5-2-1	0.0-3.0-7.0-9.0-4.0-6.0-8.0-5.0-2.0-4.1-9.1-7.1-2.1-5.1-2.0-1.0	98	276607	304517
HG02559#1#JAGYVK010000012.1_51505852_51913611_0	HG02559	304559	407687	1	612	0	0	611	103128	398826	295698	0-3-7-9-4-6-8-5-2-4-9-7-2-5-2-1	0.0-3.0-7.0-9.0-4.0-6.0-8.0-5.0-2.0-4.1-9.1-7.1-2.1-5.1-2.0-1.0	98	304461	407589
HG02559#2#JAGYVJ010000037.1_52167780_52574597_1	HG02559	154	115474	0	672	0	0	671	115320	115320	0	0-3-7-9-4-6-8-5-2-4-9-7-2-5-2-1	0.0-3.0-7.0-9.0-4.0-6.0-8.0-5.0-2.0-4.1-9.1-7.1-2.1-5.1-2.0-1.0	154	0	115320
HG02559#2#JAGYVJ010000037.1_52167780_52574597_1	HG02559	115987	138396	3	132	0	2	131	22409	137729	115320	0-3-7-9-4-6-8-5-2-4-9-7-2-5-2-1	0.0-3.0-7.0-9.0-4.0-6.0-8.0-5.0-2.0-4.1-9.1-7.1-2.1-5.1-2.0-1.0	154	115833	138242
HG02559#2#JAGYVJ010000037.1_52167780_52574597_1	HG02559	139155	141195	7	12	0	0	11	2040	139769	137729	0-3-7-9-4-6-8-5-2-4-9-7-2-5-2-1	0.0-3.0-7.0-9.0-4.0-6.0-8.0-5.0-2.0-4.1-9.1-7.1-2.1-5.1-2.0-1.0	154	139001	141041
HG02559#2#JAGYVJ010000037.1_52167780_52574597_1	HG02559	141139	142450	9	5	0	0	4	1311	141080	139769	0-3-7-9-4-6-8-5-2-4-9-7-2-5-2-1	0.0-3.0-7.0-9.0-4.0-6.0-8.0-5.0-2.0-4.1-9.1-7.1-2.1-5.1-2.0-1.0	154	140985	142296
HG02559#2#JAGYVJ010000037.1_52167780_52574597_1	HG02559	143241	158689	4	84	0	1	83	15448	156528	141080	0-3-7-9-4-6-8-5-2-4-9-7-2-5-2-1	0.0-3.0-7.0-9.0-4.0-6.0-8.0-5.0-2.0-4.1-9.1-7.1-2.1-5.1-2.0-1.0	154	143087	158535
HG02559#2#JAGYVJ010000037.1_52167780_52574597_1	HG02559	158633	161448	6	12	0	0	11	2815	159343	156528	0-3-7-9-4-6-8-5-2-4-9-7-2-5-2-1	0.0-3.0-7.0-9.0-4.0-6.0-8.0-5.0-2.0-4.1-9.1-7.1-2.1-5.1-2.0-1.0	154	158479	161294
HG02559#2#JAGYVJ010000037.1_52167780_52574597_1	HG02559	161392	163162	8	8	0	0	7	1770	161113	159343	0-3-7-9-4-6-8-5-2-4-9-7-2-5-2-1	0.0-3.0-7.0-9.0-4.0-6.0-8.0-5.0-2.0-4.1-9.1-7.1-2.1-5.1-2.0-1.0	154	161238	163008
HG02559#2#JAGYVJ010000037.1_52167780_52574597_1	HG02559	163106	176210	5	79	0	0	78	13104	174217	161113	0-3-7-9-4-6-8-5-2-4-9-7-2-5-2-1	0.0-3.0-7.0-9.0-4.0-6.0-8.0-5.0-2.0-4.1-9.1-7.1-2.1-5.1-2.0-1.0	154	162952	176056
HG02559#2#JAGYVJ010000037.1_52167780_52574597_1	HG02559	176154	210525	2	196	0	0	195	34371	208588	174217	0-3-7-9-4-6-8-5-2-4-9-7-2-5-2-1	0.0-3.0-7.0-9.0-4.0-6.0-8.0-5.0-2.0-4.1-9.1-7.1-2.1-5.1-2.0-1.0	154	176000	210371
HG02559#2#JAGYVJ010000037.1_52167780_52574597_1	HG02559	212391	223937	4	84	1	58	4	11546	220134	208588	0-3-7-9-4-6-8-5-2-4-9-7-2-5-2-1	0.0-3.0-7.0-9.0-4.0-6.0-8.0-5.0-2.0-4.1-9.1-7.1-2.1-5.1-2.0-1.0	154	212237	223783
HG02559#2#JAGYVJ010000037.1_52167780_52574597_1	HG02559	225000	226311	9	5	1	4	0	1311	221445	220134	0-3-7-9-4-6-8-5-2-4-9-7-2-5-2-1	0.0-3.0-7.0-9.0-4.0-6.0-8.0-5.0-2.0-4.1-9.1-7.1-2.1-5.1-2.0-1.0	154	224846	226157
HG02559#2#JAGYVJ010000037.1_52167780_52574597_1	HG02559	226255	228295	7	12	1	11	0	2040	223485	221445	0-3-7-9-4-6-8-5-2-4-9-7-2-5-2-1	0.0-3.0-7.0-9.0-4.0-6.0-8.0-5.0-2.0-4.1-9.1-7.1-2.1-5.1-2.0-1.0	154	226101	228141
HG02559#2#JAGYVJ010000037.1_52167780_52574597_1	HG02559	229372	263453	2	196	1	195	1	34081	257566	223485	0-3-7-9-4-6-8-5-2-4-9-7-2-5-2-1	0.0-3.0-7.0-9.0-4.0-6.0-8.0-5.0-2.0-4.1-9.1-7.1-2.1-5.1-2.0-1.0	154	229218	263299
HG02559#2#JAGYVJ010000037.1_52167780_52574597_1	HG02559	264063	276278	5	79	1	77	3	12215	269781	257566	0-3-7-9-4-6-8-5-2-4-9-7-2-5-2-1	0.0-3.0-7.0-9.0-4.0-6.0-8.0-5.0-2.0-4.1-9.1-7.1-2.1-5.1-2.0-1.0	154	263909	276124
HG02559#2#JAGYVJ010000037.1_52167780_52574597_1	HG02559	276717	304622	2	196	0	39	195	27905	297686	269781	0-3-7-9-4-6-8-5-2-4-9-7-2-5-2-1	0.0-3.0-7.0-9.0-4.0-6.0-8.0-5.0-2.0-4.1-9.1-7.1-2.1-5.1-2.0-1.0	154	276563	304468
HG02559#2#JAGYVJ010000037.1_52167780_52574597_1	HG02559	304566	406755	1	612	0	0	605	102189	399875	297686	0-3-7-9-4-6-8-5-2-4-9-7-2-5-2-1	0.0-3.0-7.0-9.0-4.0-6.0-8.0-5.0-2.0-4.1-9.1-7.1-2.1-5.1-2.0-1.0	154	304412	406601
HG02622#1#JAHAOO010000002.1_16673678_17080663_0	HG02622	98	115495	0	672	0	0	671	115397	115397	0	0-3-7-9-4-6-8-5-2-4-9-7-2-5-2-1	0.0-3.0-7.0-9.0-4.0-6.0-8.0-5.0-2.0-4.1-9.1-7.1-2.1-5.0-2.0-1.0	98	0	115397
HG02622#1#JAHAOO010000002.1_16673678_17080663_0	HG02622	115586	138419	3	132	0	0	131	22833	138230	115397	0-3-7-9-4-6-8-5-2-4-9-7-2-5-2-1	0.0-3.0-7.0-9.0-4.0-6.0-8.0-5.0-2.0-4.1-9.1-7.1-2.1-5.0-2.0-1.0	98	115488	138321
HG02622#1#JAHAOO010000002.1_16673678_17080663_0	HG02622	139178	141218	7	12	0	0	11	2040	140270	138230	0-3-7-9-4-6-8-5-2-4-9-7-2-5-2-1	0.0-3.0-7.0-9.0-4.0-6.0-8.0-5.0-2.0-4.1-9.1-7.1-2.1-5.0-2.0-1.0	98	139080	141120
HG02622#1#JAHAOO010000002.1_16673678_17080663_0	HG02622	141162	142473	9	5	0	0	4	1311	141581	140270	0-3-7-9-4-6-8-5-2-4-9-7-2-5-2-1	0.0-3.0-7.0-9.0-4.0-6.0-8.0-5.0-2.0-4.1-9.1-7.1-2.1-5.0-2.0-1.0	98	141064	142375
HG02622#1#JAHAOO010000002.1_16673678_17080663_0	HG02622	143538	158749	4	84	0	4	83	15211	156792	141581	0-3-7-9-4-6-8-5-2-4-9-7-2-5-2-1	0.0-3.0-7.0-9.0-4.0-6.0-8.0-5.0-2.0-4.1-9.1-7.1-2.1-5.0-2.0-1.0	98	143440	158651
HG02622#1#JAHAOO010000002.1_16673678_17080663_0	HG02622	158693	161508	6	12	0	0	11	2815	159607	156792	0-3-7-9-4-6-8-5-2-4-9-7-2-5-2-1	0.0-3.0-7.0-9.0-4.0-6.0-8.0-5.0-2.0-4.1-9.1-7.1-2.1-5.0-2.0-1.0	98	158595	161410
HG02622#1#JAHAOO010000002.1_16673678_17080663_0	HG02622	161452	163222	8	8	0	0	7	1770	161377	159607	0-3-7-9-4-6-8-5-2-4-9-7-2-5-2-1	0.0-3.0-7.0-9.0-4.0-6.0-8.0-5.0-2.0-4.1-9.1-7.1-2.1-5.0-2.0-1.0	98	161354	163124
HG02622#1#JAHAOO010000002.1_16673678_17080663_0	HG02622	163166	175864	5	79	0	0	77	12698	174075	161377	0-3-7-9-4-6-8-5-2-4-9-7-2-5-2-1	0.0-3.0-7.0-9.0-4.0-6.0-8.0-5.0-2.0-4.1-9.1-7.1-2.1-5.0-2.0-1.0	98	163068	175766
HG02622#1#JAHAOO010000002.1_16673678_17080663_0	HG02622	176471	210578	2	196	0	1	195	34107	208182	174075	0-3-7-9-4-6-8-5-2-4-9-7-2-5-2-1	0.0-3.0-7.0-9.0-4.0-6.0-8.0-5.0-2.0-4.1-9.1-7.1-2.1-5.0-2.0-1.0	98	176373	210480
HG02622#1#JAHAOO010000002.1_16673678_17080663_0	HG02622	212894	223988	4	84	1	56	4	11094	219276	208182	0-3-7-9-4-6-8-5-2-4-9-7-2-5-2-1	0.0-3.0-7.0-9.0-4.0-6.0-8.0-5.0-2.0-4.1-9.1-7.1-2.1-5.0-2.0-1.0	98	212796	223890
HG02622#1#JAHAOO010000002.1_16673678_17080663_0	HG02622	225053	226364	9	5	1	4	0	1311	220587	219276	0-3-7-9-4-6-8-5-2-4-9-7-2-5-2-1	0.0-3.0-7.0-9.0-4.0-6.0-8.0-5.0-2.0-4.1-9.1-7.1-2.1-5.0-2.0-1.0	98	224955	226266
HG02622#1#JAHAOO010000002.1_16673678_17080663_0	HG02622	226308	228348	7	12	1	11	0	2040	222627	220587	0-3-7-9-4-6-8-5-2-4-9-7-2-5-2-1	0.0-3.0-7.0-9.0-4.0-6.0-8.0-5.0-2.0-4.1-9.1-7.1-2.1-5.0-2.0-1.0	98	226210	228250
HG02622#1#JAHAOO010000002.1_16673678_17080663_0	HG02622	229425	256888	2	196	1	195	41	27463	250090	222627	0-3-7-9-4-6-8-5-2-4-9-7-2-5-2-1	0.0-3.0-7.0-9.0-4.0-6.0-8.0-5.0-2.0-4.1-9.1-7.1-2.1-5.0-2.0-1.0	98	229327	256790
HG02622#1#JAHAOO010000002.1_16673678_17080663_0	HG02622	258305	269519	5	79	0	5	75	11214	261304	250090	0-3-7-9-4-6-8-5-2-4-9-7-2-5-2-1	0.0-3.0-7.0-9.0-4.0-6.0-8.0-5.0-2.0-4.1-9.1-7.1-2.1-5.0-2.0-1.0	98	258207	269421
HG02622#1#JAHAOO010000002.1_16673678_17080663_0	HG02622	270600	304702	2	196	0	1	195	34102	295406	261304	0-3-7-9-4-6-8-5-2-4-9-7-2-5-2-1	0.0-3.0-7.0-9.0-4.0-6.0-8.0-5.0-2.0-4.1-9.1-7.1-2.1-5.0-2.0-1.0	98	270502	304604
HG02622#1#JAHAOO010000002.1_16673678_17080663_0	HG02622	304646	407041	1	612	0	0	606	102395	397801	295406	0-3-7-9-4-6-8-5-2-4-9-7-2-5-2-1	0.0-3.0-7.0-9.0-4.0-6.0-8.0-5.0-2.0-4.1-9.1-7.1-2.1-5.0-2.0-1.0	98	304548	406943
HG02622#2#JAHAON010000012.1_51551779_52031001_0	HG02622	98	115401	0	672	0	0	671	115303	115303	0	0-3-7-9-4-6-8-5-2-7-9-4-2-5-8-6-4-9-7-2-5-2-1	0.0-3.0-7.0-9.0-4.0-6.0-8.0-5.0-2.0-7.0-9.0-4.0-2.1-5.1-8.1-6.1-4.1-9.1-7.1-2.1-5.0-2.0-1.0	98	0	115303
HG02622#2#JAHAON010000012.1_51551779_52031001_0	HG02622	115492	138312	3	132	0	0	131	22820	138123	115303	0-3-7-9-4-6-8-5-2-7-9-4-2-5-8-6-4-9-7-2-5-2-1	0.0-3.0-7.0-9.0-4.0-6.0-8.0-5.0-2.0-7.0-9.0-4.0-2.1-5.1-8.1-6.1-4.1-9.1-7.1-2.1-5.0-2.0-1.0	98	115394	138214
HG02622#2#JAHAON010000012.1_51551779_52031001_0	HG02622	139071	141111	7	12	0	0	11	2040	140163	138123	0-3-7-9-4-6-8-5-2-7-9-4-2-5-8-6-4-9-7-2-5-2-1	0.0-3.0-7.0-9.0-4.0-6.0-8.0-5.0-2.0-7.0-9.0-4.0-2.1-5.1-8.1-6.1-4.1-9.1-7.1-2.1-5.0-2.0-1.0	98	138973	141013
HG02622#2#JAHAON010000012.1_51551779_52031001_0	HG02622	141055	142366	9	5	0	0	4	1311	141474	140163	0-3-7-9-4-6-8-5-2-7-9-4-2-5-8-6-4-9-7-2-5-2-1	0.0-3.0-7.0-9.0-4.0-6.0-8.0-5.0-2.0-7.0-9.0-4.0-2.1-5.1-8.1-6.1-4.1-9.1-7.1-2.1-5.0-2.0-1.0	98	140957	142268
HG02622#2#JAHAON010000012.1_51551779_52031001_0	HG02622	142814	158631	4	84	0	0	83	15817	157291	141474	0-3-7-9-4-6-8-5-2-7-9-4-2-5-8-6-4-9-7-2-5-2-1	0.0-3.0-7.0-9.0-4.0-6.0-8.0-5.0-2.0-7.0-9.0-4.0-2.1-5.1-8.1-6.1-4.1-9.1-7.1-2.1-5.0-2.0-1.0	98	142716	158533
HG02622#2#JAHAON010000012.1_51551779_52031001_0	HG02622	158575	161390	6	12	0	0	11	2815	160106	157291	0-3-7-9-4-6-8-5-2-7-9-4-2-5-8-6-4-9-7-2-5-2-1	0.0-3.0-7.0-9.0-4.0-6.0-8.0-5.0-2.0-7.0-9.0-4.0-2.1-5.1-8.1-6.1-4.1-9.1-7.1-2.1-5.0-2.0-1.0	98	158477	161292
HG02622#2#JAHAON010000012.1_51551779_52031001_0	HG02622	161334	163104	8	8	0	0	7	1770	161876	160106	0-3-7-9-4-6-8-5-2-7-9-4-2-5-8-6-4-9-7-2-5-2-1	0.0-3.0-7.0-9.0-4.0-6.0-8.0-5.0-2.0-7.0-9.0-4.0-2.1-5.1-8.1-6.1-4.1-9.1-7.1-2.1-5.0-2.0-1.0	98	161236	163006
HG02622#2#JAHAON010000012.1_51551779_52031001_0	HG02622	163048	176152	5	79	0	0	78	13104	174980	161876	0-3-7-9-4-6-8-5-2-7-9-4-2-5-8-6-4-9-7-2-5-2-1	0.0-3.0-7.0-9.0-4.0-6.0-8.0-5.0-2.0-7.0-9.0-4.0-2.1-5.1-8.1-6.1-4.1-9.1-7.1-2.1-5.0-2.0-1.0	98	162950	176054
HG02622#2#JAHAON010000012.1_51551779_52031001_0	HG02622	176096	210418	2	196	0	0	195	34322	209302	174980	0-3-7-9-4-6-8-5-2-7-9-4-2-5-8-6-4-9-7-2-5-2-1	0.0-3.0-7.0-9.0-4.0-6.0-8.0-5.0-2.0-7.0-9.0-4.0-2.1-5.1-8.1-6.1-4.1-9.1-7.1-2.1-5.0-2.0-1.0	98	175998	210320
HG02622#2#JAHAON010000012.1_51551779_52031001_0	HG02622	211495	213535	7	12	0	0	11	2040	211342	209302	0-3-7-9-4-6-8-5-2-7-9-4-2-5-8-6-4-9-7-2-5-2-1	0.0-3.0-7.0-9.0-4.0-6.0-8.0-5.0-2.0-7.0-9.0-4.0-2.1-5.1-8.1-6.1-4.1-9.1-7.1-2.1-5.0-2.0-1.0	98	211397	213437
HG02622#2#JAHAON010000012.1_51551779_52031001_0	HG02622	213479	214790	9	5	0	0	4	1311	212653	211342	0-3-7-9-4-6-8-5-2-7-9-4-2-5-8-6-4-9-7-2-5-2-1	0.0-3.0-7.0-9.0-4.0-6.0-8.0-5.0-2.0-7.0-9.0-4.0-2.1-5.1-8.1-6.1-4.1-9.1-7.1-2.1-5.0-2.0-1.0	98	213381	214692
HG02622#2#JAHAON010000012.1_51551779_52031001_0	HG02622	215853	227387	4	84	0	4	58	11534	224187	212653	0-3-7-9-4-6-8-5-2-7-9-4-2-5-8-6-4-9-7-2-5-2-1	0.0-3.0-7.0-9.0-4.0-6.0-8.0-5.0-2.0-7.0-9.0-4.0-2.1-5.1-8.1-6.1-4.1-9.1-7.1-2.1-5.0-2.0-1.0	98	215755	227289
HG02622#2#JAHAON010000012.1_51551779_52031001_0	HG02622	229253	263574	2	196	1	195	0	34321	258508	224187	0-3-7-9-4-6-8-5-2-7-9-4-2-5-8-6-4-9-7-2-5-2-1	0.0-3.0-7.0-9.0-4.0-6.0-8.0-5.0-2.0-7.0-9.0-4.0-2.1-5.1-8.1-6.1-4.1-9.1-7.1-2.1-5.0-2.0-1.0	98	229155	263476
HG02622#2#JAHAON010000012.1_51551779_52031001_0	HG02622	263518	276622	5	79	1	78	0	13104	271612	258508	0-3-7-9-4-6-8-5-2-7-9-4-2-5-8-6-4-9-7-2-5-2-1	0.0-3.0-7.0-9.0-4.0-6.0-8.0-5.0-2.0-7.0-9.0-4.0-2.1-5.1-8.1-6.1-4.1-9.1-7.1-2.1-5.0-2.0-1.0	98	263420	276524
HG02622#2#JAHAON010000012.1_51551779_52031001_0	HG02622	276810	278336	8	8	1	6	0	1526	273138	271612	0-3-7-9-4-6-8-5-2-7-9-4-2-5-8-6-4-9-7-2-5-2-1	0.0-3.0-7.0-9.0-4.0-6.0-8.0-5.0-2.0-7.0-9.0-4.0-2.1-5.1-8.1-6.1-4.1-9.1-7.1-2.1-5.0-2.0-1.0	98	276712	278238
HG02622#2#JAHAON010000012.1_51551779_52031001_0	HG02622	278280	280454	6	12	1	11	1	2174	275312	273138	0-3-7-9-4-6-8-5-2-7-9-4-2-5-8-6-4-9-7-2-5-2-1	0.0-3.0-7.0-9.0-4.0-6.0-8.0-5.0-2.0-7.0-9.0-4.0-2.1-5.1-8.1-6.1-4.1-9.1-7.1-2.1-5.0-2.0-1.0	98	278182	280356
HG02622#2#JAHAON010000012.1_51551779_52031001_0	HG02622	281115	296854	4	84	1	82	0	15739	291051	275312	0-3-7-9-4-6-8-5-2-7-9-4-2-5-8-6-4-9-7-2-5-2-1	0.0-3.0-7.0-9.0-4.0-6.0-8.0-5.0-2.0-7.0-9.0-4.0-2.1-5.1-8.1-6.1-4.1-9.1-7.1-2.1-5.0-2.0-1.0	98	281017	296756
HG02622#2#JAHAON010000012.1_51551779_52031001_0	HG02622	297302	298613	9	5	1	4	0	1311	292362	291051	0-3-7-9-4-6-8-5-2-7-9-4-2-5-8-6-4-9-7-2-5-2-1	0.0-3.0-7.0-9.0-4.0-6.0-8.0-5.0-2.0-7.0-9.0-4.0-2.1-5.1-8.1-6.1-4.1-9.1-7.1-2.1-5.0-2.0-1.0	98	297204	298515
HG02622#2#JAHAON010000012.1_51551779_52031001_0	HG02622	298557	300597	7	12	1	11	0	2040	294402	292362	0-3-7-9-4-6-8-5-2-7-9-4-2-5-8-6-4-9-7-2-5-2-1	0.0-3.0-7.0-9.0-4.0-6.0-8.0-5.0-2.0-7.0-9.0-4.0-2.1-5.1-8.1-6.1-4.1-9.1-7.1-2.1-5.0-2.0-1.0	98	298459	300499
HG02622#2#JAHAON010000012.1_51551779_52031001_0	HG02622	301674	329590	2	196	1	195	39	27916	322318	294402	0-3-7-9-4-6-8-5-2-7-9-4-2-5-8-6-4-9-7-2-5-2-1	0.0-3.0-7.0-9.0-4.0-6.0-8.0-5.0-2.0-7.0-9.0-4.0-2.1-5.1-8.1-6.1-4.1-9.1-7.1-2.1-5.0-2.0-1.0	98	301576	329492
HG02622#2#JAHAON010000012.1_51551779_52031001_0	HG02622	330029	342209	5	79	0	3	77	12180	334498	322318	0-3-7-9-4-6-8-5-2-7-9-4-2-5-8-6-4-9-7-2-5-2-1	0.0-3.0-7.0-9.0-4.0-6.0-8.0-5.0-2.0-7.0-9.0-4.0-2.1-5.1-8.1-6.1-4.1-9.1-7.1-2.1-5.0-2.0-1.0	98	329931	342111
HG02622#2#JAHAON010000012.1_51551779_52031001_0	HG02622	342816	376918	2	196	0	1	195	34102	368600	334498	0-3-7-9-4-6-8-5-2-7-9-4-2-5-8-6-4-9-7-2-5-2-1	0.0-3.0-7.0-9.0-4.0-6.0-8.0-5.0-2.0-7.0-9.0-4.0-2.1-5.1-8.1-6.1-4.1-9.1-7.1-2.1-5.0-2.0-1.0	98	342718	376820
HG02622#2#JAHAON010000012.1_51551779_52031001_0	HG02622	376862	479278	1	612	0	0	606	102416	471016	368600	0-3-7-9-4-6-8-5-2-7-9-4-2-5-8-6-4-9-7-2-5-2-1	0.0-3.0-7.0-9.0-4.0-6.0-8.0-5.0-2.0-7.0-9.0-4.0-2.1-5.1-8.1-6.1-4.1-9.1-7.1-2.1-5.0-2.0-1.0	98	376764	479180
HG02630#1#JAHAOQ010000102.1_16672145_17079089_0	HG02630	98	115456	0	672	0	0	671	115358	115358	0	0-3-7-9-4-6-8-5-2-4-9-7-2-5-2-1	0.0-3.0-7.0-9.0-4.0-6.0-8.0-5.0-2.0-4.1-9.1-7.1-2.1-5.0-2.0-1.0	98	0	115358
HG02630#1#JAHAOQ010000102.1_16672145_17079089_0	HG02630	115547	138380	3	132	0	0	131	22833	138191	115358	0-3-7-9-4-6-8-5-2-4-9-7-2-5-2-1	0.0-3.0-7.0-9.0-4.0-6.0-8.0-5.0-2.0-4.1-9.1-7.1-2.1-5.0-2.0-1.0	98	115449	138282
HG02630#1#JAHAOQ010000102.1_16672145_17079089_0	HG02630	139139	141179	7	12	0	0	11	2040	140231	138191	0-3-7-9-4-6-8-5-2-4-9-7-2-5-2-1	0.0-3.0-7.0-9.0-4.0-6.0-8.0-5.0-2.0-4.1-9.1-7.1-2.1-5.0-2.0-1.0	98	139041	141081
HG02630#1#JAHAOQ010000102.1_16672145_17079089_0	HG02630	141123	142434	9	5	0	0	4	1311	141542	140231	0-3-7-9-4-6-8-5-2-4-9-7-2-5-2-1	0.0-3.0-7.0-9.0-4.0-6.0-8.0-5.0-2.0-4.1-9.1-7.1-2.1-5.0-2.0-1.0	98	141025	142336
HG02630#1#JAHAOQ010000102.1_16672145_17079089_0	HG02630	143499	158711	4	84	0	4	83	15212	156754	141542	0-3-7-9-4-6-8-5-2-4-9-7-2-5-2-1	0.0-3.0-7.0-9.0-4.0-6.0-8.0-5.0-2.0-4.1-9.1-7.1-2.1-5.0-2.0-1.0	98	143401	158613
HG02630#1#JAHAOQ010000102.1_16672145_17079089_0	HG02630	158655	161470	6	12	0	0	11	2815	159569	156754	0-3-7-9-4-6-8-5-2-4-9-7-2-5-2-1	0.0-3.0-7.0-9.0-4.0-6.0-8.0-5.0-2.0-4.1-9.1-7.1-2.1-5.0-2.0-1.0	98	158557	161372
HG02630#1#JAHAOQ010000102.1_16672145_17079089_0	HG02630	161414	163184	8	8	0	0	7	1770	161339	159569	0-3-7-9-4-6-8-5-2-4-9-7-2-5-2-1	0.0-3.0-7.0-9.0-4.0-6.0-8.0-5.0-2.0-4.1-9.1-7.1-2.1-5.0-2.0-1.0	98	161316	163086
HG02630#1#JAHAOQ010000102.1_16672145_17079089_0	HG02630	163128	175352	5	79	0	0	75	12224	173563	161339	0-3-7-9-4-6-8-5-2-4-9-7-2-5-2-1	0.0-3.0-7.0-9.0-4.0-6.0-8.0-5.0-2.0-4.1-9.1-7.1-2.1-5.0-2.0-1.0	98	163030	175254
HG02630#1#JAHAOQ010000102.1_16672145_17079089_0	HG02630	176433	210562	2	196	0	1	195	34129	207692	173563	0-3-7-9-4-6-8-5-2-4-9-7-2-5-2-1	0.0-3.0-7.0-9.0-4.0-6.0-8.0-5.0-2.0-4.1-9.1-7.1-2.1-5.0-2.0-1.0	98	176335	210464
HG02630#1#JAHAOQ010000102.1_16672145_17079089_0	HG02630	212878	223973	4	84	1	56	4	11095	218787	207692	0-3-7-9-4-6-8-5-2-4-9-7-2-5-2-1	0.0-3.0-7.0-9.0-4.0-6.0-8.0-5.0-2.0-4.1-9.1-7.1-2.1-5.0-2.0-1.0	98	212780	223875
HG02630#1#JAHAOQ010000102.1_16672145_17079089_0	HG02630	225036	226347	9	5	1	4	0	1311	220098	218787	0-3-7-9-4-6-8-5-2-4-9-7-2-5-2-1	0.0-3.0-7.0-9.0-4.0-6.0-8.0-5.0-2.0-4.1-9.1-7.1-2.1-5.0-2.0-1.0	98	224938	226249
HG02630#1#JAHAOQ010000102.1_16672145_17079089_0	HG02630	226291	228331	7	12	1	11	0	2040	222138	220098	0-3-7-9-4-6-8-5-2-4-9-7-2-5-2-1	0.0-3.0-7.0-9.0-4.0-6.0-8.0-5.0-2.0-4.1-9.1-7.1-2.1-5.0-2.0-1.0	98	226193	228233
HG02630#1#JAHAOQ010000102.1_16672145_17079089_0	HG02630	229408	257316	2	196	1	195	39	27908	250046	222138	0-3-7-9-4-6-8-5-2-4-9-7-2-5-2-1	0.0-3.0-7.0-9.0-4.0-6.0-8.0-5.0-2.0-4.1-9.1-7.1-2.1-5.0-2.0-1.0	98	229310	257218
HG02630#1#JAHAOQ010000102.1_16672145_17079089_0	HG02630	258282	269496	5	79	0	5	75	11214	261260	250046	0-3-7-9-4-6-8-5-2-4-9-7-2-5-2-1	0.0-3.0-7.0-9.0-4.0-6.0-8.0-5.0-2.0-4.1-9.1-7.1-2.1-5.0-2.0-1.0	98	258184	269398
HG02630#1#JAHAOQ010000102.1_16672145_17079089_0	HG02630	270577	304666	2	196	0	1	195	34089	295349	261260	0-3-7-9-4-6-8-5-2-4-9-7-2-5-2-1	0.0-3.0-7.0-9.0-4.0-6.0-8.0-5.0-2.0-4.1-9.1-7.1-2.1-5.0-2.0-1.0	98	270479	304568
HG02630#1#JAHAOQ010000102.1_16672145_17079089_0	HG02630	304610	407000	1	612	0	0	606	102390	397739	295349	0-3-7-9-4-6-8-5-2-4-9-7-2-5-2-1	0.0-3.0-7.0-9.0-4.0-6.0-8.0-5.0-2.0-4.1-9.1-7.1-2.1-5.0-2.0-1.0	98	304512	406902
HG02630#2#JAHAOP010000089.1_16669255_17076135_0	HG02630	98	115461	0	672	0	0	671	115363	115363	0	0-3-7-9-4-6-8-5-2-7-9-4-2-5-2-1	0.0-3.0-7.0-9.0-4.0-6.0-8.0-5.0-2.0-7.0-9.0-4.0-2.1-5.1-2.0-1.0	98	0	115363
HG02630#2#JAHAOP010000089.1_16669255_17076135_0	HG02630	115552	138385	3	132	0	0	131	22833	138196	115363	0-3-7-9-4-6-8-5-2-7-9-4-2-5-2-1	0.0-3.0-7.0-9.0-4.0-6.0-8.0-5.0-2.0-7.0-9.0-4.0-2.1-5.1-2.0-1.0	98	115454	138287
HG02630#2#JAHAOP010000089.1_16669255_17076135_0	HG02630	139144	141184	7	12	0	0	11	2040	140236	138196	0-3-7-9-4-6-8-5-2-7-9-4-2-5-2-1	0.0-3.0-7.0-9.0-4.0-6.0-8.0-5.0-2.0-7.0-9.0-4.0-2.1-5.1-2.0-1.0	98	139046	141086
HG02630#2#JAHAOP010000089.1_16669255_17076135_0	HG02630	141128	142439	9	5	0	0	4	1311	141547	140236	0-3-7-9-4-6-8-5-2-7-9-4-2-5-2-1	0.0-3.0-7.0-9.0-4.0-6.0-8.0-5.0-2.0-7.0-9.0-4.0-2.1-5.1-2.0-1.0	98	141030	142341
HG02630#2#JAHAOP010000089.1_16669255_17076135_0	HG02630	143233	158695	4	84	0	1	83	15462	157009	141547	0-3-7-9-4-6-8-5-2-7-9-4-2-5-2-1	0.0-3.0-7.0-9.0-4.0-6.0-8.0-5.0-2.0-7.0-9.0-4.0-2.1-5.1-2.0-1.0	98	143135	158597
HG02630#2#JAHAOP010000089.1_16669255_17076135_0	HG02630	158639	161454	6	12	0	0	11	2815	159824	157009	0-3-7-9-4-6-8-5-2-7-9-4-2-5-2-1	0.0-3.0-7.0-9.0-4.0-6.0-8.0-5.0-2.0-7.0-9.0-4.0-2.1-5.1-2.0-1.0	98	158541	161356
HG02630#2#JAHAOP010000089.1_16669255_17076135_0	HG02630	161398	163168	8	8	0	0	7	1770	161594	159824	0-3-7-9-4-6-8-5-2-7-9-4-2-5-2-1	0.0-3.0-7.0-9.0-4.0-6.0-8.0-5.0-2.0-7.0-9.0-4.0-2.1-5.1-2.0-1.0	98	161300	163070
HG02630#2#JAHAOP010000089.1_16669255_17076135_0	HG02630	163112	175776	5	79	0	0	77	12664	174258	161594	0-3-7-9-4-6-8-5-2-7-9-4-2-5-2-1	0.0-3.0-7.0-9.0-4.0-6.0-8.0-5.0-2.0-7.0-9.0-4.0-2.1-5.1-2.0-1.0	98	163014	175678
HG02630#2#JAHAOP010000089.1_16669255_17076135_0	HG02630	176383	210495	2	196	0	1	195	34112	208370	174258	0-3-7-9-4-6-8-5-2-7-9-4-2-5-2-1	0.0-3.0-7.0-9.0-4.0-6.0-8.0-5.0-2.0-7.0-9.0-4.0-2.1-5.1-2.0-1.0	98	176285	210397
HG02630#2#JAHAOP010000089.1_16669255_17076135_0	HG02630	211572	213612	7	12	0	0	11	2040	210410	208370	0-3-7-9-4-6-8-5-2-7-9-4-2-5-2-1	0.0-3.0-7.0-9.0-4.0-6.0-8.0-5.0-2.0-7.0-9.0-4.0-2.1-5.1-2.0-1.0	98	211474	213514
HG02630#2#JAHAOP010000089.1_16669255_17076135_0	HG02630	213556	214867	9	5	0	0	4	1311	211721	210410	0-3-7-9-4-6-8-5-2-7-9-4-2-5-2-1	0.0-3.0-7.0-9.0-4.0-6.0-8.0-5.0-2.0-7.0-9.0-4.0-2.1-5.1-2.0-1.0	98	213458	214769
HG02630#2#JAHAOP010000089.1_16669255_17076135_0	HG02630	215934	227489	4	84	0	4	58	11555	223276	211721	0-3-7-9-4-6-8-5-2-7-9-4-2-5-2-1	0.0-3.0-7.0-9.0-4.0-6.0-8.0-5.0-2.0-7.0-9.0-4.0-2.1-5.1-2.0-1.0	98	215836	227391
HG02630#2#JAHAOP010000089.1_16669255_17076135_0	HG02630	229355	263467	2	196	1	195	1	34112	257388	223276	0-3-7-9-4-6-8-5-2-7-9-4-2-5-2-1	0.0-3.0-7.0-9.0-4.0-6.0-8.0-5.0-2.0-7.0-9.0-4.0-2.1-5.1-2.0-1.0	98	229257	263369
HG02630#2#JAHAOP010000089.1_16669255_17076135_0	HG02630	264074	276290	5	79	1	77	3	12216	269604	257388	0-3-7-9-4-6-8-5-2-7-9-4-2-5-2-1	0.0-3.0-7.0-9.0-4.0-6.0-8.0-5.0-2.0-7.0-9.0-4.0-2.1-5.1-2.0-1.0	98	263976	276192
HG02630#2#JAHAOP010000089.1_16669255_17076135_0	HG02630	276729	304643	2	196	0	39	195	27914	297518	269604	0-3-7-9-4-6-8-5-2-7-9-4-2-5-2-1	0.0-3.0-7.0-9.0-4.0-6.0-8.0-5.0-2.0-7.0-9.0-4.0-2.1-5.1-2.0-1.0	98	276631	304545
HG02630#2#JAHAOP010000089.1_16669255_17076135_0	HG02630	305638	406936	1	612	0	5	606	101298	398816	297518	0-3-7-9-4-6-8-5-2-7-9-4-2-5-2-1	0.0-3.0-7.0-9.0-4.0-6.0-8.0-5.0-2.0-7.0-9.0-4.0-2.1-5.1-2.0-1.0	98	305540	406838
HG02647.verkko_filt_mat.fa:haplotype1-0000002_103892584_104321036_0	HG02647.verkko_filt_mat.fa:haplotype1-0000002_103892584_104321036_0	98	115448	0	672	0	0	671	115350	115350	0	0-3-7-9-4-6-8-5-2-4-0-3-7-9-4-6-8-5-2-1	0.0-3.0-7.0-9.0-4.0-6.0-8.0-5.0-2.0-4.1-0.0-3.0-7.0-9.0-4.0-6.0-8.0-5.0-2.0-1.0	98	0	115350
HG02647.verkko_filt_mat.fa:haplotype1-0000002_103892584_104321036_0	HG02647.verkko_filt_mat.fa:haplotype1-0000002_103892584_104321036_0	115539	138371	3	132	0	0	131	22832	138182	115350	0-3-7-9-4-6-8-5-2-4-0-3-7-9-4-6-8-5-2-1	0.0-3.0-7.0-9.0-4.0-6.0-8.0-5.0-2.0-4.1-0.0-3.0-7.0-9.0-4.0-6.0-8.0-5.0-2.0-1.0	98	115441	138273
HG02647.verkko_filt_mat.fa:haplotype1-0000002_103892584_104321036_0	HG02647.verkko_filt_mat.fa:haplotype1-0000002_103892584_104321036_0	139130	141171	7	12	0	0	11	2041	140223	138182	0-3-7-9-4-6-8-5-2-4-0-3-7-9-4-6-8-5-2-1	0.0-3.0-7.0-9.0-4.0-6.0-8.0-5.0-2.0-4.1-0.0-3.0-7.0-9.0-4.0-6.0-8.0-5.0-2.0-1.0	98	139032	141073
HG02647.verkko_filt_mat.fa:haplotype1-0000002_103892584_104321036_0	HG02647.verkko_filt_mat.fa:haplotype1-0000002_103892584_104321036_0	141115	142426	9	5	0	0	4	1311	141534	140223	0-3-7-9-4-6-8-5-2-4-0-3-7-9-4-6-8-5-2-1	0.0-3.0-7.0-9.0-4.0-6.0-8.0-5.0-2.0-4.1-0.0-3.0-7.0-9.0-4.0-6.0-8.0-5.0-2.0-1.0	98	141017	142328
HG02647.verkko_filt_mat.fa:haplotype1-0000002_103892584_104321036_0	HG02647.verkko_filt_mat.fa:haplotype1-0000002_103892584_104321036_0	142874	158686	4	84	0	0	83	15812	157346	141534	0-3-7-9-4-6-8-5-2-4-0-3-7-9-4-6-8-5-2-1	0.0-3.0-7.0-9.0-4.0-6.0-8.0-5.0-2.0-4.1-0.0-3.0-7.0-9.0-4.0-6.0-8.0-5.0-2.0-1.0	98	142776	158588
HG02647.verkko_filt_mat.fa:haplotype1-0000002_103892584_104321036_0	HG02647.verkko_filt_mat.fa:haplotype1-0000002_103892584_104321036_0	158630	161445	6	12	0	0	11	2815	160161	157346	0-3-7-9-4-6-8-5-2-4-0-3-7-9-4-6-8-5-2-1	0.0-3.0-7.0-9.0-4.0-6.0-8.0-5.0-2.0-4.1-0.0-3.0-7.0-9.0-4.0-6.0-8.0-5.0-2.0-1.0	98	158532	161347
HG02647.verkko_filt_mat.fa:haplotype1-0000002_103892584_104321036_0	HG02647.verkko_filt_mat.fa:haplotype1-0000002_103892584_104321036_0	161389	163159	8	8	0	0	7	1770	161931	160161	0-3-7-9-4-6-8-5-2-4-0-3-7-9-4-6-8-5-2-1	0.0-3.0-7.0-9.0-4.0-6.0-8.0-5.0-2.0-4.1-0.0-3.0-7.0-9.0-4.0-6.0-8.0-5.0-2.0-1.0	98	161291	163061
HG02647.verkko_filt_mat.fa:haplotype1-0000002_103892584_104321036_0	HG02647.verkko_filt_mat.fa:haplotype1-0000002_103892584_104321036_0	163103	176207	5	79	0	0	78	13104	175035	161931	0-3-7-9-4-6-8-5-2-4-0-3-7-9-4-6-8-5-2-1	0.0-3.0-7.0-9.0-4.0-6.0-8.0-5.0-2.0-4.1-0.0-3.0-7.0-9.0-4.0-6.0-8.0-5.0-2.0-1.0	98	163005	176109
HG02647.verkko_filt_mat.fa:haplotype1-0000002_103892584_104321036_0	HG02647.verkko_filt_mat.fa:haplotype1-0000002_103892584_104321036_0	176151	210461	2	196	0	0	195	34310	209345	175035	0-3-7-9-4-6-8-5-2-4-0-3-7-9-4-6-8-5-2-1	0.0-3.0-7.0-9.0-4.0-6.0-8.0-5.0-2.0-4.1-0.0-3.0-7.0-9.0-4.0-6.0-8.0-5.0-2.0-1.0	98	176053	210363
HG02647.verkko_filt_mat.fa:haplotype1-0000002_103892584_104321036_0	HG02647.verkko_filt_mat.fa:haplotype1-0000002_103892584_104321036_0	212327	220807	4	84	1	58	22	8480	217825	209345	0-3-7-9-4-6-8-5-2-4-0-3-7-9-4-6-8-5-2-1	0.0-3.0-7.0-9.0-4.0-6.0-8.0-5.0-2.0-4.1-0.0-3.0-7.0-9.0-4.0-6.0-8.0-5.0-2.0-1.0	98	212229	220709
HG02647.verkko_filt_mat.fa:haplotype1-0000002_103892584_104321036_0	HG02647.verkko_filt_mat.fa:haplotype1-0000002_103892584_104321036_0	220984	231191	0	672	0	604	671	10207	228032	217825	0-3-7-9-4-6-8-5-2-4-0-3-7-9-4-6-8-5-2-1	0.0-3.0-7.0-9.0-4.0-6.0-8.0-5.0-2.0-4.1-0.0-3.0-7.0-9.0-4.0-6.0-8.0-5.0-2.0-1.0	98	220886	231093
HG02647.verkko_filt_mat.fa:haplotype1-0000002_103892584_104321036_0	HG02647.verkko_filt_mat.fa:haplotype1-0000002_103892584_104321036_0	231282	254114	3	132	0	0	131	22832	250864	228032	0-3-7-9-4-6-8-5-2-4-0-3-7-9-4-6-8-5-2-1	0.0-3.0-7.0-9.0-4.0-6.0-8.0-5.0-2.0-4.1-0.0-3.0-7.0-9.0-4.0-6.0-8.0-5.0-2.0-1.0	98	231184	254016
HG02647.verkko_filt_mat.fa:haplotype1-0000002_103892584_104321036_0	HG02647.verkko_filt_mat.fa:haplotype1-0000002_103892584_104321036_0	254873	256914	7	12	0	0	11	2041	252905	250864	0-3-7-9-4-6-8-5-2-4-0-3-7-9-4-6-8-5-2-1	0.0-3.0-7.0-9.0-4.0-6.0-8.0-5.0-2.0-4.1-0.0-3.0-7.0-9.0-4.0-6.0-8.0-5.0-2.0-1.0	98	254775	256816
HG02647.verkko_filt_mat.fa:haplotype1-0000002_103892584_104321036_0	HG02647.verkko_filt_mat.fa:haplotype1-0000002_103892584_104321036_0	256858	258169	9	5	0	0	4	1311	254216	252905	0-3-7-9-4-6-8-5-2-4-0-3-7-9-4-6-8-5-2-1	0.0-3.0-7.0-9.0-4.0-6.0-8.0-5.0-2.0-4.1-0.0-3.0-7.0-9.0-4.0-6.0-8.0-5.0-2.0-1.0	98	256760	258071
HG02647.verkko_filt_mat.fa:haplotype1-0000002_103892584_104321036_0	HG02647.verkko_filt_mat.fa:haplotype1-0000002_103892584_104321036_0	258617	274423	4	84	0	0	83	15806	270022	254216	0-3-7-9-4-6-8-5-2-4-0-3-7-9-4-6-8-5-2-1	0.0-3.0-7.0-9.0-4.0-6.0-8.0-5.0-2.0-4.1-0.0-3.0-7.0-9.0-4.0-6.0-8.0-5.0-2.0-1.0	98	258519	274325
HG02647.verkko_filt_mat.fa:haplotype1-0000002_103892584_104321036_0	HG02647.verkko_filt_mat.fa:haplotype1-0000002_103892584_104321036_0	274367	277182	6	12	0	0	11	2815	272837	270022	0-3-7-9-4-6-8-5-2-4-0-3-7-9-4-6-8-5-2-1	0.0-3.0-7.0-9.0-4.0-6.0-8.0-5.0-2.0-4.1-0.0-3.0-7.0-9.0-4.0-6.0-8.0-5.0-2.0-1.0	98	274269	277084
HG02647.verkko_filt_mat.fa:haplotype1-0000002_103892584_104321036_0	HG02647.verkko_filt_mat.fa:haplotype1-0000002_103892584_104321036_0	277126	278896	8	8	0	0	7	1770	274607	272837	0-3-7-9-4-6-8-5-2-4-0-3-7-9-4-6-8-5-2-1	0.0-3.0-7.0-9.0-4.0-6.0-8.0-5.0-2.0-4.1-0.0-3.0-7.0-9.0-4.0-6.0-8.0-5.0-2.0-1.0	98	277028	278798
HG02647.verkko_filt_mat.fa:haplotype1-0000002_103892584_104321036_0	HG02647.verkko_filt_mat.fa:haplotype1-0000002_103892584_104321036_0	278840	291944	5	79	0	0	78	13104	287711	274607	0-3-7-9-4-6-8-5-2-4-0-3-7-9-4-6-8-5-2-1	0.0-3.0-7.0-9.0-4.0-6.0-8.0-5.0-2.0-4.1-0.0-3.0-7.0-9.0-4.0-6.0-8.0-5.0-2.0-1.0	98	278742	291846
HG02647.verkko_filt_mat.fa:haplotype1-0000002_103892584_104321036_0	HG02647.verkko_filt_mat.fa:haplotype1-0000002_103892584_104321036_0	291888	326214	2	196	0	0	195	34326	322037	287711	0-3-7-9-4-6-8-5-2-4-0-3-7-9-4-6-8-5-2-1	0.0-3.0-7.0-9.0-4.0-6.0-8.0-5.0-2.0-4.1-0.0-3.0-7.0-9.0-4.0-6.0-8.0-5.0-2.0-1.0	98	291790	326116
HG02647.verkko_filt_mat.fa:haplotype1-0000002_103892584_104321036_0	HG02647.verkko_filt_mat.fa:haplotype1-0000002_103892584_104321036_0	326158	428508	1	612	0	0	606	102350	424387	322037	0-3-7-9-4-6-8-5-2-4-0-3-7-9-4-6-8-5-2-1	0.0-3.0-7.0-9.0-4.0-6.0-8.0-5.0-2.0-4.1-0.0-3.0-7.0-9.0-4.0-6.0-8.0-5.0-2.0-1.0	98	326060	428410
HG02647.verkko_filt_pat.fa:haplotype2-0000857_103738150_104051769_0	HG02647.verkko_filt_pat.fa:haplotype2-0000857_103738150_104051769_0	98	115410	0	672	0	0	671	115312	115312	0	0-3-7-9-4-6-8-5-2-1	0.0-3.0-7.0-9.0-4.0-6.0-8.0-5.0-2.0-1.0	98	0	115312
HG02647.verkko_filt_pat.fa:haplotype2-0000857_103738150_104051769_0	HG02647.verkko_filt_pat.fa:haplotype2-0000857_103738150_104051769_0	115501	138331	3	132	0	0	131	22830	138142	115312	0-3-7-9-4-6-8-5-2-1	0.0-3.0-7.0-9.0-4.0-6.0-8.0-5.0-2.0-1.0	98	115403	138233
HG02647.verkko_filt_pat.fa:haplotype2-0000857_103738150_104051769_0	HG02647.verkko_filt_pat.fa:haplotype2-0000857_103738150_104051769_0	139090	141130	7	12	0	0	11	2040	140182	138142	0-3-7-9-4-6-8-5-2-1	0.0-3.0-7.0-9.0-4.0-6.0-8.0-5.0-2.0-1.0	98	138992	141032
HG02647.verkko_filt_pat.fa:haplotype2-0000857_103738150_104051769_0	HG02647.verkko_filt_pat.fa:haplotype2-0000857_103738150_104051769_0	141074	142385	9	5	0	0	4	1311	141493	140182	0-3-7-9-4-6-8-5-2-1	0.0-3.0-7.0-9.0-4.0-6.0-8.0-5.0-2.0-1.0	98	140976	142287
HG02647.verkko_filt_pat.fa:haplotype2-0000857_103738150_104051769_0	HG02647.verkko_filt_pat.fa:haplotype2-0000857_103738150_104051769_0	142833	158633	4	84	0	0	83	15800	157293	141493	0-3-7-9-4-6-8-5-2-1	0.0-3.0-7.0-9.0-4.0-6.0-8.0-5.0-2.0-1.0	98	142735	158535
HG02647.verkko_filt_pat.fa:haplotype2-0000857_103738150_104051769_0	HG02647.verkko_filt_pat.fa:haplotype2-0000857_103738150_104051769_0	158577	161392	6	12	0	0	11	2815	160108	157293	0-3-7-9-4-6-8-5-2-1	0.0-3.0-7.0-9.0-4.0-6.0-8.0-5.0-2.0-1.0	98	158479	161294
HG02647.verkko_filt_pat.fa:haplotype2-0000857_103738150_104051769_0	HG02647.verkko_filt_pat.fa:haplotype2-0000857_103738150_104051769_0	161336	163106	8	8	0	0	7	1770	161878	160108	0-3-7-9-4-6-8-5-2-1	0.0-3.0-7.0-9.0-4.0-6.0-8.0-5.0-2.0-1.0	98	161238	163008
HG02647.verkko_filt_pat.fa:haplotype2-0000857_103738150_104051769_0	HG02647.verkko_filt_pat.fa:haplotype2-0000857_103738150_104051769_0	163050	175714	5	79	0	0	77	12664	174542	161878	0-3-7-9-4-6-8-5-2-1	0.0-3.0-7.0-9.0-4.0-6.0-8.0-5.0-2.0-1.0	98	162952	175616
HG02647.verkko_filt_pat.fa:haplotype2-0000857_103738150_104051769_0	HG02647.verkko_filt_pat.fa:haplotype2-0000857_103738150_104051769_0	176321	210423	2	196	0	1	195	34102	208644	174542	0-3-7-9-4-6-8-5-2-1	0.0-3.0-7.0-9.0-4.0-6.0-8.0-5.0-2.0-1.0	98	176223	210325
HG02647.verkko_filt_pat.fa:haplotype2-0000857_103738150_104051769_0	HG02647.verkko_filt_pat.fa:haplotype2-0000857_103738150_104051769_0	210367	313547	1	612	0	0	611	103180	311824	208644	0-3-7-9-4-6-8-5-2-1	0.0-3.0-7.0-9.0-4.0-6.0-8.0-5.0-2.0-1.0	98	210269	313449
HG02717#1#JAHAOS010000015.1_16660311_17067250_0	HG02717	98	115427	0	672	0	0	671	115329	115329	0	0-3-7-9-4-6-8-5-2-4-9-7-2-5-2-1	0.0-3.0-7.0-9.0-4.0-6.0-8.0-5.0-2.0-4.1-9.1-7.1-2.1-5.0-2.0-1.0	98	0	115329
HG02717#1#JAHAOS010000015.1_16660311_17067250_0	HG02717	115518	138349	3	132	0	0	131	22831	138160	115329	0-3-7-9-4-6-8-5-2-4-9-7-2-5-2-1	0.0-3.0-7.0-9.0-4.0-6.0-8.0-5.0-2.0-4.1-9.1-7.1-2.1-5.0-2.0-1.0	98	115420	138251
HG02717#1#JAHAOS010000015.1_16660311_17067250_0	HG02717	139108	141148	7	12	0	0	11	2040	140200	138160	0-3-7-9-4-6-8-5-2-4-9-7-2-5-2-1	0.0-3.0-7.0-9.0-4.0-6.0-8.0-5.0-2.0-4.1-9.1-7.1-2.1-5.0-2.0-1.0	98	139010	141050
HG02717#1#JAHAOS010000015.1_16660311_17067250_0	HG02717	141092	142403	9	5	0	0	4	1311	141511	140200	0-3-7-9-4-6-8-5-2-4-9-7-2-5-2-1	0.0-3.0-7.0-9.0-4.0-6.0-8.0-5.0-2.0-4.1-9.1-7.1-2.1-5.0-2.0-1.0	98	140994	142305
HG02717#1#JAHAOS010000015.1_16660311_17067250_0	HG02717	143466	158659	4	84	0	4	83	15193	156704	141511	0-3-7-9-4-6-8-5-2-4-9-7-2-5-2-1	0.0-3.0-7.0-9.0-4.0-6.0-8.0-5.0-2.0-4.1-9.1-7.1-2.1-5.0-2.0-1.0	98	143368	158561
HG02717#1#JAHAOS010000015.1_16660311_17067250_0	HG02717	158603	161418	6	12	0	0	11	2815	159519	156704	0-3-7-9-4-6-8-5-2-4-9-7-2-5-2-1	0.0-3.0-7.0-9.0-4.0-6.0-8.0-5.0-2.0-4.1-9.1-7.1-2.1-5.0-2.0-1.0	98	158505	161320
HG02717#1#JAHAOS010000015.1_16660311_17067250_0	HG02717	161362	163132	8	8	0	0	7	1770	161289	159519	0-3-7-9-4-6-8-5-2-4-9-7-2-5-2-1	0.0-3.0-7.0-9.0-4.0-6.0-8.0-5.0-2.0-4.1-9.1-7.1-2.1-5.0-2.0-1.0	98	161264	163034
HG02717#1#JAHAOS010000015.1_16660311_17067250_0	HG02717	163076	176214	5	79	0	0	78	13138	174427	161289	0-3-7-9-4-6-8-5-2-4-9-7-2-5-2-1	0.0-3.0-7.0-9.0-4.0-6.0-8.0-5.0-2.0-4.1-9.1-7.1-2.1-5.0-2.0-1.0	98	162978	176116
HG02717#1#JAHAOS010000015.1_16660311_17067250_0	HG02717	176158	210490	2	196	0	0	195	34332	208759	174427	0-3-7-9-4-6-8-5-2-4-9-7-2-5-2-1	0.0-3.0-7.0-9.0-4.0-6.0-8.0-5.0-2.0-4.1-9.1-7.1-2.1-5.0-2.0-1.0	98	176060	210392
HG02717#1#JAHAOS010000015.1_16660311_17067250_0	HG02717	212806	223901	4	84	1	56	4	11095	219854	208759	0-3-7-9-4-6-8-5-2-4-9-7-2-5-2-1	0.0-3.0-7.0-9.0-4.0-6.0-8.0-5.0-2.0-4.1-9.1-7.1-2.1-5.0-2.0-1.0	98	212708	223803
HG02717#1#JAHAOS010000015.1_16660311_17067250_0	HG02717	224964	226275	9	5	1	4	0	1311	221165	219854	0-3-7-9-4-6-8-5-2-4-9-7-2-5-2-1	0.0-3.0-7.0-9.0-4.0-6.0-8.0-5.0-2.0-4.1-9.1-7.1-2.1-5.0-2.0-1.0	98	224866	226177
HG02717#1#JAHAOS010000015.1_16660311_17067250_0	HG02717	226219	228259	7	12	1	11	0	2040	223205	221165	0-3-7-9-4-6-8-5-2-4-9-7-2-5-2-1	0.0-3.0-7.0-9.0-4.0-6.0-8.0-5.0-2.0-4.1-9.1-7.1-2.1-5.0-2.0-1.0	98	226121	228161
HG02717#1#JAHAOS010000015.1_16660311_17067250_0	HG02717	229336	257243	2	196	1	195	39	27907	251112	223205	0-3-7-9-4-6-8-5-2-4-9-7-2-5-2-1	0.0-3.0-7.0-9.0-4.0-6.0-8.0-5.0-2.0-4.1-9.1-7.1-2.1-5.0-2.0-1.0	98	229238	257145
HG02717#1#JAHAOS010000015.1_16660311_17067250_0	HG02717	258209	269423	5	79	0	5	75	11214	262326	251112	0-3-7-9-4-6-8-5-2-4-9-7-2-5-2-1	0.0-3.0-7.0-9.0-4.0-6.0-8.0-5.0-2.0-4.1-9.1-7.1-2.1-5.0-2.0-1.0	98	258111	269325
HG02717#1#JAHAOS010000015.1_16660311_17067250_0	HG02717	270504	304603	2	196	0	1	195	34099	296425	262326	0-3-7-9-4-6-8-5-2-4-9-7-2-5-2-1	0.0-3.0-7.0-9.0-4.0-6.0-8.0-5.0-2.0-4.1-9.1-7.1-2.1-5.0-2.0-1.0	98	270406	304505
HG02717#1#JAHAOS010000015.1_16660311_17067250_0	HG02717	304547	406995	1	612	0	0	606	102448	398873	296425	0-3-7-9-4-6-8-5-2-4-9-7-2-5-2-1	0.0-3.0-7.0-9.0-4.0-6.0-8.0-5.0-2.0-4.1-9.1-7.1-2.1-5.0-2.0-1.0	98	304449	406897
HG02717#2#JAHAOR010000006.1_19663827_20070693_1	HG02717	154	115517	0	672	0	0	671	115363	115363	0	0-3-7-9-4-6-8-5-2-7-9-4-2-5-2-1	0.0-3.0-7.0-9.0-4.0-6.0-8.0-5.0-2.0-7.0-9.0-4.0-2.1-5.1-2.0-1.0	154	0	115363
HG02717#2#JAHAOR010000006.1_19663827_20070693_1	HG02717	115608	138442	3	132	0	0	131	22834	138197	115363	0-3-7-9-4-6-8-5-2-7-9-4-2-5-2-1	0.0-3.0-7.0-9.0-4.0-6.0-8.0-5.0-2.0-7.0-9.0-4.0-2.1-5.1-2.0-1.0	154	115454	138288
HG02717#2#JAHAOR010000006.1_19663827_20070693_1	HG02717	139201	141241	7	12	0	0	11	2040	140237	138197	0-3-7-9-4-6-8-5-2-7-9-4-2-5-2-1	0.0-3.0-7.0-9.0-4.0-6.0-8.0-5.0-2.0-7.0-9.0-4.0-2.1-5.1-2.0-1.0	154	139047	141087
HG02717#2#JAHAOR010000006.1_19663827_20070693_1	HG02717	141185	142497	9	5	0	0	4	1312	141549	140237	0-3-7-9-4-6-8-5-2-7-9-4-2-5-2-1	0.0-3.0-7.0-9.0-4.0-6.0-8.0-5.0-2.0-7.0-9.0-4.0-2.1-5.1-2.0-1.0	154	141031	142343
HG02717#2#JAHAOR010000006.1_19663827_20070693_1	HG02717	143560	158753	4	84	0	4	83	15193	156742	141549	0-3-7-9-4-6-8-5-2-7-9-4-2-5-2-1	0.0-3.0-7.0-9.0-4.0-6.0-8.0-5.0-2.0-7.0-9.0-4.0-2.1-5.1-2.0-1.0	154	143406	158599
HG02717#2#JAHAOR010000006.1_19663827_20070693_1	HG02717	158697	161512	6	12	0	0	11	2815	159557	156742	0-3-7-9-4-6-8-5-2-7-9-4-2-5-2-1	0.0-3.0-7.0-9.0-4.0-6.0-8.0-5.0-2.0-7.0-9.0-4.0-2.1-5.1-2.0-1.0	154	158543	161358
HG02717#2#JAHAOR010000006.1_19663827_20070693_1	HG02717	161456	163226	8	8	0	0	7	1770	161327	159557	0-3-7-9-4-6-8-5-2-7-9-4-2-5-2-1	0.0-3.0-7.0-9.0-4.0-6.0-8.0-5.0-2.0-7.0-9.0-4.0-2.1-5.1-2.0-1.0	154	161302	163072
HG02717#2#JAHAOR010000006.1_19663827_20070693_1	HG02717	163170	175834	5	79	0	0	77	12664	173991	161327	0-3-7-9-4-6-8-5-2-7-9-4-2-5-2-1	0.0-3.0-7.0-9.0-4.0-6.0-8.0-5.0-2.0-7.0-9.0-4.0-2.1-5.1-2.0-1.0	154	163016	175680
HG02717#2#JAHAOR010000006.1_19663827_20070693_1	HG02717	176441	210543	2	196	0	1	195	34102	208093	173991	0-3-7-9-4-6-8-5-2-7-9-4-2-5-2-1	0.0-3.0-7.0-9.0-4.0-6.0-8.0-5.0-2.0-7.0-9.0-4.0-2.1-5.1-2.0-1.0	154	176287	210389
HG02717#2#JAHAOR010000006.1_19663827_20070693_1	HG02717	211620	213660	7	12	0	0	11	2040	210133	208093	0-3-7-9-4-6-8-5-2-7-9-4-2-5-2-1	0.0-3.0-7.0-9.0-4.0-6.0-8.0-5.0-2.0-7.0-9.0-4.0-2.1-5.1-2.0-1.0	154	211466	213506
HG02717#2#JAHAOR010000006.1_19663827_20070693_1	HG02717	213604	214916	9	5	0	0	4	1312	211445	210133	0-3-7-9-4-6-8-5-2-7-9-4-2-5-2-1	0.0-3.0-7.0-9.0-4.0-6.0-8.0-5.0-2.0-7.0-9.0-4.0-2.1-5.1-2.0-1.0	154	213450	214762
HG02717#2#JAHAOR010000006.1_19663827_20070693_1	HG02717	215979	227525	4	84	0	4	58	11546	222991	211445	0-3-7-9-4-6-8-5-2-7-9-4-2-5-2-1	0.0-3.0-7.0-9.0-4.0-6.0-8.0-5.0-2.0-7.0-9.0-4.0-2.1-5.1-2.0-1.0	154	215825	227371
HG02717#2#JAHAOR010000006.1_19663827_20070693_1	HG02717	229391	263499	2	196	1	195	1	34108	257099	222991	0-3-7-9-4-6-8-5-2-7-9-4-2-5-2-1	0.0-3.0-7.0-9.0-4.0-6.0-8.0-5.0-2.0-7.0-9.0-4.0-2.1-5.1-2.0-1.0	154	229237	263345
HG02717#2#JAHAOR010000006.1_19663827_20070693_1	HG02717	264106	276321	5	79	1	77	3	12215	269314	257099	0-3-7-9-4-6-8-5-2-7-9-4-2-5-2-1	0.0-3.0-7.0-9.0-4.0-6.0-8.0-5.0-2.0-7.0-9.0-4.0-2.1-5.1-2.0-1.0	154	263952	276167
HG02717#2#JAHAOR010000006.1_19663827_20070693_1	HG02717	276760	304669	2	196	0	39	195	27909	297223	269314	0-3-7-9-4-6-8-5-2-7-9-4-2-5-2-1	0.0-3.0-7.0-9.0-4.0-6.0-8.0-5.0-2.0-7.0-9.0-4.0-2.1-5.1-2.0-1.0	154	276606	304515
HG02717#2#JAHAOR010000006.1_19663827_20070693_1	HG02717	304613	406804	1	612	0	0	605	102191	399414	297223	0-3-7-9-4-6-8-5-2-7-9-4-2-5-2-1	0.0-3.0-7.0-9.0-4.0-6.0-8.0-5.0-2.0-7.0-9.0-4.0-2.1-5.1-2.0-1.0	154	304459	406650
HG02723#1#JAHEOU010000204.1_2102082_2414876_1	HG02723	154	115510	0	672	0	0	671	115356	115356	0	0-3-7-9-4-6-8-5-2-1	0.0-3.0-7.0-9.0-4.0-6.0-8.0-5.0-2.0-1.0	154	0	115356
HG02723#1#JAHEOU010000204.1_2102082_2414876_1	HG02723	115601	137963	3	132	0	0	128	22362	137718	115356	0-3-7-9-4-6-8-5-2-1	0.0-3.0-7.0-9.0-4.0-6.0-8.0-5.0-2.0-1.0	154	115447	137809
HG02723#1#JAHEOU010000204.1_2102082_2414876_1	HG02723	139195	141235	7	12	0	0	11	2040	139758	137718	0-3-7-9-4-6-8-5-2-1	0.0-3.0-7.0-9.0-4.0-6.0-8.0-5.0-2.0-1.0	154	139041	141081
HG02723#1#JAHEOU010000204.1_2102082_2414876_1	HG02723	141179	142490	9	5	0	0	4	1311	141069	139758	0-3-7-9-4-6-8-5-2-1	0.0-3.0-7.0-9.0-4.0-6.0-8.0-5.0-2.0-1.0	154	141025	142336
HG02723#1#JAHEOU010000204.1_2102082_2414876_1	HG02723	142938	158750	4	84	0	0	83	15812	156881	141069	0-3-7-9-4-6-8-5-2-1	0.0-3.0-7.0-9.0-4.0-6.0-8.0-5.0-2.0-1.0	154	142784	158596
HG02723#1#JAHEOU010000204.1_2102082_2414876_1	HG02723	159599	161101	6	12	0	2	9	1502	158383	156881	0-3-7-9-4-6-8-5-2-1	0.0-3.0-7.0-9.0-4.0-6.0-8.0-5.0-2.0-1.0	154	159445	160947
HG02723#1#JAHEOU010000204.1_2102082_2414876_1	HG02723	161453	163223	8	8	0	0	7	1770	160153	158383	0-3-7-9-4-6-8-5-2-1	0.0-3.0-7.0-9.0-4.0-6.0-8.0-5.0-2.0-1.0	154	161299	163069
HG02723#1#JAHEOU010000204.1_2102082_2414876_1	HG02723	163167	176306	5	79	0	0	78	13139	173292	160153	0-3-7-9-4-6-8-5-2-1	0.0-3.0-7.0-9.0-4.0-6.0-8.0-5.0-2.0-1.0	154	163013	176152
HG02723#1#JAHEOU010000204.1_2102082_2414876_1	HG02723	176250	210570	2	196	0	0	195	34320	207612	173292	0-3-7-9-4-6-8-5-2-1	0.0-3.0-7.0-9.0-4.0-6.0-8.0-5.0-2.0-1.0	154	176096	210416
HG02723#1#JAHEOU010000204.1_2102082_2414876_1	HG02723	210514	312732	1	612	0	0	605	102218	309830	207612	0-3-7-9-4-6-8-5-2-1	0.0-3.0-7.0-9.0-4.0-6.0-8.0-5.0-2.0-1.0	154	210360	312578
HG02723#2#JAHEOT010000034.1_19776337_20321518_1	HG02723	154	115533	0	672	0	0	671	115379	115379	0	0-3-7-9-4-2-5-8-6-4-9-7-3-0-4-6-8-5-2-4-0-3-7-9-4-6-8-5-2-1	0.0-3.0-7.0-9.0-4.0-2.1-5.1-8.1-6.1-4.1-9.1-7.1-3.1-0.1-4.0-6.0-8.0-5.0-2.0-4.1-0.0-3.0-7.0-9.0-4.0-6.0-8.0-5.0-2.0-1.0	154	0	115379
HG02723#2#JAHEOT010000034.1_19776337_20321518_1	HG02723	115624	138456	3	132	0	0	131	22832	138211	115379	0-3-7-9-4-2-5-8-6-4-9-7-3-0-4-6-8-5-2-4-0-3-7-9-4-6-8-5-2-1	0.0-3.0-7.0-9.0-4.0-2.1-5.1-8.1-6.1-4.1-9.1-7.1-3.1-0.1-4.0-6.0-8.0-5.0-2.0-4.1-0.0-3.0-7.0-9.0-4.0-6.0-8.0-5.0-2.0-1.0	154	115470	138302
HG02723#2#JAHEOT010000034.1_19776337_20321518_1	HG02723	139215	141256	7	12	0	0	11	2041	140252	138211	0-3-7-9-4-2-5-8-6-4-9-7-3-0-4-6-8-5-2-4-0-3-7-9-4-6-8-5-2-1	0.0-3.0-7.0-9.0-4.0-2.1-5.1-8.1-6.1-4.1-9.1-7.1-3.1-0.1-4.0-6.0-8.0-5.0-2.0-4.1-0.0-3.0-7.0-9.0-4.0-6.0-8.0-5.0-2.0-1.0	154	139061	141102
HG02723#2#JAHEOT010000034.1_19776337_20321518_1	HG02723	141200	142511	9	5	0	0	4	1311	141563	140252	0-3-7-9-4-2-5-8-6-4-9-7-3-0-4-6-8-5-2-4-0-3-7-9-4-6-8-5-2-1	0.0-3.0-7.0-9.0-4.0-2.1-5.1-8.1-6.1-4.1-9.1-7.1-3.1-0.1-4.0-6.0-8.0-5.0-2.0-4.1-0.0-3.0-7.0-9.0-4.0-6.0-8.0-5.0-2.0-1.0	154	141046	142357
HG02723#2#JAHEOT010000034.1_19776337_20321518_1	HG02723	142959	155118	4	84	0	0	58	12159	153722	141563	0-3-7-9-4-2-5-8-6-4-9-7-3-0-4-6-8-5-2-4-0-3-7-9-4-6-8-5-2-1	0.0-3.0-7.0-9.0-4.0-2.1-5.1-8.1-6.1-4.1-9.1-7.1-3.1-0.1-4.0-6.0-8.0-5.0-2.0-4.1-0.0-3.0-7.0-9.0-4.0-6.0-8.0-5.0-2.0-1.0	154	142805	154964
HG02723#2#JAHEOT010000034.1_19776337_20321518_1	HG02723	156984	191293	2	196	1	195	0	34309	188031	153722	0-3-7-9-4-2-5-8-6-4-9-7-3-0-4-6-8-5-2-4-0-3-7-9-4-6-8-5-2-1	0.0-3.0-7.0-9.0-4.0-2.1-5.1-8.1-6.1-4.1-9.1-7.1-3.1-0.1-4.0-6.0-8.0-5.0-2.0-4.1-0.0-3.0-7.0-9.0-4.0-6.0-8.0-5.0-2.0-1.0	154	156830	191139
HG02723#2#JAHEOT010000034.1_19776337_20321518_1	HG02723	191237	204341	5	79	1	78	0	13104	201135	188031	0-3-7-9-4-2-5-8-6-4-9-7-3-0-4-6-8-5-2-4-0-3-7-9-4-6-8-5-2-1	0.0-3.0-7.0-9.0-4.0-2.1-5.1-8.1-6.1-4.1-9.1-7.1-3.1-0.1-4.0-6.0-8.0-5.0-2.0-4.1-0.0-3.0-7.0-9.0-4.0-6.0-8.0-5.0-2.0-1.0	154	191083	204187
HG02723#2#JAHEOT010000034.1_19776337_20321518_1	HG02723	204285	206055	8	8	1	7	0	1770	202905	201135	0-3-7-9-4-2-5-8-6-4-9-7-3-0-4-6-8-5-2-4-0-3-7-9-4-6-8-5-2-1	0.0-3.0-7.0-9.0-4.0-2.1-5.1-8.1-6.1-4.1-9.1-7.1-3.1-0.1-4.0-6.0-8.0-5.0-2.0-4.1-0.0-3.0-7.0-9.0-4.0-6.0-8.0-5.0-2.0-1.0	154	204131	205901
HG02723#2#JAHEOT010000034.1_19776337_20321518_1	HG02723	205999	208814	6	12	1	11	0	2815	205720	202905	0-3-7-9-4-2-5-8-6-4-9-7-3-0-4-6-8-5-2-4-0-3-7-9-4-6-8-5-2-1	0.0-3.0-7.0-9.0-4.0-2.1-5.1-8.1-6.1-4.1-9.1-7.1-3.1-0.1-4.0-6.0-8.0-5.0-2.0-4.1-0.0-3.0-7.0-9.0-4.0-6.0-8.0-5.0-2.0-1.0	154	205845	208660
HG02723#2#JAHEOT010000034.1_19776337_20321518_1	HG02723	208758	224567	4	84	1	83	0	15809	221529	205720	0-3-7-9-4-2-5-8-6-4-9-7-3-0-4-6-8-5-2-4-0-3-7-9-4-6-8-5-2-1	0.0-3.0-7.0-9.0-4.0-2.1-5.1-8.1-6.1-4.1-9.1-7.1-3.1-0.1-4.0-6.0-8.0-5.0-2.0-4.1-0.0-3.0-7.0-9.0-4.0-6.0-8.0-5.0-2.0-1.0	154	208604	224413
HG02723#2#JAHEOT010000034.1_19776337_20321518_1	HG02723	225015	226326	9	5	1	4	0	1311	222840	221529	0-3-7-9-4-2-5-8-6-4-9-7-3-0-4-6-8-5-2-4-0-3-7-9-4-6-8-5-2-1	0.0-3.0-7.0-9.0-4.0-2.1-5.1-8.1-6.1-4.1-9.1-7.1-3.1-0.1-4.0-6.0-8.0-5.0-2.0-4.1-0.0-3.0-7.0-9.0-4.0-6.0-8.0-5.0-2.0-1.0	154	224861	226172
HG02723#2#JAHEOT010000034.1_19776337_20321518_1	HG02723	226270	228311	7	12	1	11	0	2041	224881	222840	0-3-7-9-4-2-5-8-6-4-9-7-3-0-4-6-8-5-2-4-0-3-7-9-4-6-8-5-2-1	0.0-3.0-7.0-9.0-4.0-2.1-5.1-8.1-6.1-4.1-9.1-7.1-3.1-0.1-4.0-6.0-8.0-5.0-2.0-4.1-0.0-3.0-7.0-9.0-4.0-6.0-8.0-5.0-2.0-1.0	154	226116	228157
HG02723#2#JAHEOT010000034.1_19776337_20321518_1	HG02723	229070	251902	3	132	1	131	0	22832	247713	224881	0-3-7-9-4-2-5-8-6-4-9-7-3-0-4-6-8-5-2-4-0-3-7-9-4-6-8-5-2-1	0.0-3.0-7.0-9.0-4.0-2.1-5.1-8.1-6.1-4.1-9.1-7.1-3.1-0.1-4.0-6.0-8.0-5.0-2.0-4.1-0.0-3.0-7.0-9.0-4.0-6.0-8.0-5.0-2.0-1.0	154	228916	251748
HG02723#2#JAHEOT010000034.1_19776337_20321518_1	HG02723	251993	262202	0	672	1	671	604	10209	257922	247713	0-3-7-9-4-2-5-8-6-4-9-7-3-0-4-6-8-5-2-4-0-3-7-9-4-6-8-5-2-1	0.0-3.0-7.0-9.0-4.0-2.1-5.1-8.1-6.1-4.1-9.1-7.1-3.1-0.1-4.0-6.0-8.0-5.0-2.0-4.1-0.0-3.0-7.0-9.0-4.0-6.0-8.0-5.0-2.0-1.0	154	251839	262048
HG02723#2#JAHEOT010000034.1_19776337_20321518_1	HG02723	262379	274512	4	84	0	22	83	12133	270055	257922	0-3-7-9-4-2-5-8-6-4-9-7-3-0-4-6-8-5-2-4-0-3-7-9-4-6-8-5-2-1	0.0-3.0-7.0-9.0-4.0-2.1-5.1-8.1-6.1-4.1-9.1-7.1-3.1-0.1-4.0-6.0-8.0-5.0-2.0-4.1-0.0-3.0-7.0-9.0-4.0-6.0-8.0-5.0-2.0-1.0	154	262225	274358
HG02723#2#JAHEOT010000034.1_19776337_20321518_1	HG02723	274456	277271	6	12	0	0	11	2815	272870	270055	0-3-7-9-4-2-5-8-6-4-9-7-3-0-4-6-8-5-2-4-0-3-7-9-4-6-8-5-2-1	0.0-3.0-7.0-9.0-4.0-2.1-5.1-8.1-6.1-4.1-9.1-7.1-3.1-0.1-4.0-6.0-8.0-5.0-2.0-4.1-0.0-3.0-7.0-9.0-4.0-6.0-8.0-5.0-2.0-1.0	154	274302	277117
HG02723#2#JAHEOT010000034.1_19776337_20321518_1	HG02723	277215	278985	8	8	0	0	7	1770	274640	272870	0-3-7-9-4-2-5-8-6-4-9-7-3-0-4-6-8-5-2-4-0-3-7-9-4-6-8-5-2-1	0.0-3.0-7.0-9.0-4.0-2.1-5.1-8.1-6.1-4.1-9.1-7.1-3.1-0.1-4.0-6.0-8.0-5.0-2.0-4.1-0.0-3.0-7.0-9.0-4.0-6.0-8.0-5.0-2.0-1.0	154	277061	278831
HG02723#2#JAHEOT010000034.1_19776337_20321518_1	HG02723	278929	292033	5	79	0	0	78	13104	287744	274640	0-3-7-9-4-2-5-8-6-4-9-7-3-0-4-6-8-5-2-4-0-3-7-9-4-6-8-5-2-1	0.0-3.0-7.0-9.0-4.0-2.1-5.1-8.1-6.1-4.1-9.1-7.1-3.1-0.1-4.0-6.0-8.0-5.0-2.0-4.1-0.0-3.0-7.0-9.0-4.0-6.0-8.0-5.0-2.0-1.0	154	278775	291879
HG02723#2#JAHEOT010000034.1_19776337_20321518_1	HG02723	291977	326292	2	196	0	0	195	34315	322059	287744	0-3-7-9-4-2-5-8-6-4-9-7-3-0-4-6-8-5-2-4-0-3-7-9-4-6-8-5-2-1	0.0-3.0-7.0-9.0-4.0-2.1-5.1-8.1-6.1-4.1-9.1-7.1-3.1-0.1-4.0-6.0-8.0-5.0-2.0-4.1-0.0-3.0-7.0-9.0-4.0-6.0-8.0-5.0-2.0-1.0	154	291823	326138
HG02723#2#JAHEOT010000034.1_19776337_20321518_1	HG02723	328158	336642	4	84	1	58	22	8484	330543	322059	0-3-7-9-4-2-5-8-6-4-9-7-3-0-4-6-8-5-2-4-0-3-7-9-4-6-8-5-2-1	0.0-3.0-7.0-9.0-4.0-2.1-5.1-8.1-6.1-4.1-9.1-7.1-3.1-0.1-4.0-6.0-8.0-5.0-2.0-4.1-0.0-3.0-7.0-9.0-4.0-6.0-8.0-5.0-2.0-1.0	154	328004	336488
HG02723#2#JAHEOT010000034.1_19776337_20321518_1	HG02723	336819	347028	0	672	0	604	671	10209	340752	330543	0-3-7-9-4-2-5-8-6-4-9-7-3-0-4-6-8-5-2-4-0-3-7-9-4-6-8-5-2-1	0.0-3.0-7.0-9.0-4.0-2.1-5.1-8.1-6.1-4.1-9.1-7.1-3.1-0.1-4.0-6.0-8.0-5.0-2.0-4.1-0.0-3.0-7.0-9.0-4.0-6.0-8.0-5.0-2.0-1.0	154	336665	346874
HG02723#2#JAHEOT010000034.1_19776337_20321518_1	HG02723	347119	369951	3	132	0	0	131	22832	363584	340752	0-3-7-9-4-2-5-8-6-4-9-7-3-0-4-6-8-5-2-4-0-3-7-9-4-6-8-5-2-1	0.0-3.0-7.0-9.0-4.0-2.1-5.1-8.1-6.1-4.1-9.1-7.1-3.1-0.1-4.0-6.0-8.0-5.0-2.0-4.1-0.0-3.0-7.0-9.0-4.0-6.0-8.0-5.0-2.0-1.0	154	346965	369797
HG02723#2#JAHEOT010000034.1_19776337_20321518_1	HG02723	370710	372751	7	12	0	0	11	2041	365625	363584	0-3-7-9-4-2-5-8-6-4-9-7-3-0-4-6-8-5-2-4-0-3-7-9-4-6-8-5-2-1	0.0-3.0-7.0-9.0-4.0-2.1-5.1-8.1-6.1-4.1-9.1-7.1-3.1-0.1-4.0-6.0-8.0-5.0-2.0-4.1-0.0-3.0-7.0-9.0-4.0-6.0-8.0-5.0-2.0-1.0	154	370556	372597
HG02723#2#JAHEOT010000034.1_19776337_20321518_1	HG02723	372695	374006	9	5	0	0	4	1311	366936	365625	0-3-7-9-4-2-5-8-6-4-9-7-3-0-4-6-8-5-2-4-0-3-7-9-4-6-8-5-2-1	0.0-3.0-7.0-9.0-4.0-2.1-5.1-8.1-6.1-4.1-9.1-7.1-3.1-0.1-4.0-6.0-8.0-5.0-2.0-4.1-0.0-3.0-7.0-9.0-4.0-6.0-8.0-5.0-2.0-1.0	154	372541	373852
HG02723#2#JAHEOT010000034.1_19776337_20321518_1	HG02723	374454	390263	4	84	0	0	83	15809	382745	366936	0-3-7-9-4-2-5-8-6-4-9-7-3-0-4-6-8-5-2-4-0-3-7-9-4-6-8-5-2-1	0.0-3.0-7.0-9.0-4.0-2.1-5.1-8.1-6.1-4.1-9.1-7.1-3.1-0.1-4.0-6.0-8.0-5.0-2.0-4.1-0.0-3.0-7.0-9.0-4.0-6.0-8.0-5.0-2.0-1.0	154	374300	390109
HG02723#2#JAHEOT010000034.1_19776337_20321518_1	HG02723	390207	393022	6	12	0	0	11	2815	385560	382745	0-3-7-9-4-2-5-8-6-4-9-7-3-0-4-6-8-5-2-4-0-3-7-9-4-6-8-5-2-1	0.0-3.0-7.0-9.0-4.0-2.1-5.1-8.1-6.1-4.1-9.1-7.1-3.1-0.1-4.0-6.0-8.0-5.0-2.0-4.1-0.0-3.0-7.0-9.0-4.0-6.0-8.0-5.0-2.0-1.0	154	390053	392868
HG02723#2#JAHEOT010000034.1_19776337_20321518_1	HG02723	392966	394736	8	8	0	0	7	1770	387330	385560	0-3-7-9-4-2-5-8-6-4-9-7-3-0-4-6-8-5-2-4-0-3-7-9-4-6-8-5-2-1	0.0-3.0-7.0-9.0-4.0-2.1-5.1-8.1-6.1-4.1-9.1-7.1-3.1-0.1-4.0-6.0-8.0-5.0-2.0-4.1-0.0-3.0-7.0-9.0-4.0-6.0-8.0-5.0-2.0-1.0	154	392812	394582
HG02723#2#JAHEOT010000034.1_19776337_20321518_1	HG02723	394680	407784	5	79	0	0	78	13104	400434	387330	0-3-7-9-4-2-5-8-6-4-9-7-3-0-4-6-8-5-2-4-0-3-7-9-4-6-8-5-2-1	0.0-3.0-7.0-9.0-4.0-2.1-5.1-8.1-6.1-4.1-9.1-7.1-3.1-0.1-4.0-6.0-8.0-5.0-2.0-4.1-0.0-3.0-7.0-9.0-4.0-6.0-8.0-5.0-2.0-1.0	154	394526	407630
HG02723#2#JAHEOT010000034.1_19776337_20321518_1	HG02723	407728	442054	2	196	0	0	195	34326	434760	400434	0-3-7-9-4-2-5-8-6-4-9-7-3-0-4-6-8-5-2-4-0-3-7-9-4-6-8-5-2-1	0.0-3.0-7.0-9.0-4.0-2.1-5.1-8.1-6.1-4.1-9.1-7.1-3.1-0.1-4.0-6.0-8.0-5.0-2.0-4.1-0.0-3.0-7.0-9.0-4.0-6.0-8.0-5.0-2.0-1.0	154	407574	441900
HG02723#2#JAHEOT010000034.1_19776337_20321518_1	HG02723	441998	545165	1	612	0	0	611	103167	537927	434760	0-3-7-9-4-2-5-8-6-4-9-7-3-0-4-6-8-5-2-4-0-3-7-9-4-6-8-5-2-1	0.0-3.0-7.0-9.0-4.0-2.1-5.1-8.1-6.1-4.1-9.1-7.1-3.1-0.1-4.0-6.0-8.0-5.0-2.0-4.1-0.0-3.0-7.0-9.0-4.0-6.0-8.0-5.0-2.0-1.0	154	441844	545011
HG02809.verkko_filt_mat.fa:haplotype1-0000023_94161320_94589755_0	HG02809.verkko_filt_mat.fa:haplotype1-0000023_94161320_94589755_0	98	115417	0	672	0	0	671	115319	115319	0	0-3-7-9-4-6-8-5-2-4-0-3-7-9-4-6-8-5-2-1	0.0-3.0-7.0-9.0-4.0-6.0-8.0-5.0-2.0-4.1-0.0-3.0-7.0-9.0-4.0-6.0-8.0-5.0-2.0-1.0	98	0	115319
HG02809.verkko_filt_mat.fa:haplotype1-0000023_94161320_94589755_0	HG02809.verkko_filt_mat.fa:haplotype1-0000023_94161320_94589755_0	115508	138340	3	132	0	0	131	22832	138151	115319	0-3-7-9-4-6-8-5-2-4-0-3-7-9-4-6-8-5-2-1	0.0-3.0-7.0-9.0-4.0-6.0-8.0-5.0-2.0-4.1-0.0-3.0-7.0-9.0-4.0-6.0-8.0-5.0-2.0-1.0	98	115410	138242
HG02809.verkko_filt_mat.fa:haplotype1-0000023_94161320_94589755_0	HG02809.verkko_filt_mat.fa:haplotype1-0000023_94161320_94589755_0	139099	141140	7	12	0	0	11	2041	140192	138151	0-3-7-9-4-6-8-5-2-4-0-3-7-9-4-6-8-5-2-1	0.0-3.0-7.0-9.0-4.0-6.0-8.0-5.0-2.0-4.1-0.0-3.0-7.0-9.0-4.0-6.0-8.0-5.0-2.0-1.0	98	139001	141042
HG02809.verkko_filt_mat.fa:haplotype1-0000023_94161320_94589755_0	HG02809.verkko_filt_mat.fa:haplotype1-0000023_94161320_94589755_0	141084	142395	9	5	0	0	4	1311	141503	140192	0-3-7-9-4-6-8-5-2-4-0-3-7-9-4-6-8-5-2-1	0.0-3.0-7.0-9.0-4.0-6.0-8.0-5.0-2.0-4.1-0.0-3.0-7.0-9.0-4.0-6.0-8.0-5.0-2.0-1.0	98	140986	142297
HG02809.verkko_filt_mat.fa:haplotype1-0000023_94161320_94589755_0	HG02809.verkko_filt_mat.fa:haplotype1-0000023_94161320_94589755_0	142843	158656	4	84	0	0	83	15813	157316	141503	0-3-7-9-4-6-8-5-2-4-0-3-7-9-4-6-8-5-2-1	0.0-3.0-7.0-9.0-4.0-6.0-8.0-5.0-2.0-4.1-0.0-3.0-7.0-9.0-4.0-6.0-8.0-5.0-2.0-1.0	98	142745	158558
HG02809.verkko_filt_mat.fa:haplotype1-0000023_94161320_94589755_0	HG02809.verkko_filt_mat.fa:haplotype1-0000023_94161320_94589755_0	158600	161415	6	12	0	0	11	2815	160131	157316	0-3-7-9-4-6-8-5-2-4-0-3-7-9-4-6-8-5-2-1	0.0-3.0-7.0-9.0-4.0-6.0-8.0-5.0-2.0-4.1-0.0-3.0-7.0-9.0-4.0-6.0-8.0-5.0-2.0-1.0	98	158502	161317
HG02809.verkko_filt_mat.fa:haplotype1-0000023_94161320_94589755_0	HG02809.verkko_filt_mat.fa:haplotype1-0000023_94161320_94589755_0	161359	163134	8	8	0	0	7	1775	161906	160131	0-3-7-9-4-6-8-5-2-4-0-3-7-9-4-6-8-5-2-1	0.0-3.0-7.0-9.0-4.0-6.0-8.0-5.0-2.0-4.1-0.0-3.0-7.0-9.0-4.0-6.0-8.0-5.0-2.0-1.0	98	161261	163036
HG02809.verkko_filt_mat.fa:haplotype1-0000023_94161320_94589755_0	HG02809.verkko_filt_mat.fa:haplotype1-0000023_94161320_94589755_0	163078	176182	5	79	0	0	78	13104	175010	161906	0-3-7-9-4-6-8-5-2-4-0-3-7-9-4-6-8-5-2-1	0.0-3.0-7.0-9.0-4.0-6.0-8.0-5.0-2.0-4.1-0.0-3.0-7.0-9.0-4.0-6.0-8.0-5.0-2.0-1.0	98	162980	176084
HG02809.verkko_filt_mat.fa:haplotype1-0000023_94161320_94589755_0	HG02809.verkko_filt_mat.fa:haplotype1-0000023_94161320_94589755_0	176126	210441	2	196	0	0	195	34315	209325	175010	0-3-7-9-4-6-8-5-2-4-0-3-7-9-4-6-8-5-2-1	0.0-3.0-7.0-9.0-4.0-6.0-8.0-5.0-2.0-4.1-0.0-3.0-7.0-9.0-4.0-6.0-8.0-5.0-2.0-1.0	98	176028	210343
HG02809.verkko_filt_mat.fa:haplotype1-0000023_94161320_94589755_0	HG02809.verkko_filt_mat.fa:haplotype1-0000023_94161320_94589755_0	212307	220790	4	84	1	58	22	8483	217808	209325	0-3-7-9-4-6-8-5-2-4-0-3-7-9-4-6-8-5-2-1	0.0-3.0-7.0-9.0-4.0-6.0-8.0-5.0-2.0-4.1-0.0-3.0-7.0-9.0-4.0-6.0-8.0-5.0-2.0-1.0	98	212209	220692
HG02809.verkko_filt_mat.fa:haplotype1-0000023_94161320_94589755_0	HG02809.verkko_filt_mat.fa:haplotype1-0000023_94161320_94589755_0	220967	231178	0	672	0	604	671	10211	228019	217808	0-3-7-9-4-6-8-5-2-4-0-3-7-9-4-6-8-5-2-1	0.0-3.0-7.0-9.0-4.0-6.0-8.0-5.0-2.0-4.1-0.0-3.0-7.0-9.0-4.0-6.0-8.0-5.0-2.0-1.0	98	220869	231080
HG02809.verkko_filt_mat.fa:haplotype1-0000023_94161320_94589755_0	HG02809.verkko_filt_mat.fa:haplotype1-0000023_94161320_94589755_0	231269	254101	3	132	0	0	131	22832	250851	228019	0-3-7-9-4-6-8-5-2-4-0-3-7-9-4-6-8-5-2-1	0.0-3.0-7.0-9.0-4.0-6.0-8.0-5.0-2.0-4.1-0.0-3.0-7.0-9.0-4.0-6.0-8.0-5.0-2.0-1.0	98	231171	254003
HG02809.verkko_filt_mat.fa:haplotype1-0000023_94161320_94589755_0	HG02809.verkko_filt_mat.fa:haplotype1-0000023_94161320_94589755_0	254860	256901	7	12	0	0	11	2041	252892	250851	0-3-7-9-4-6-8-5-2-4-0-3-7-9-4-6-8-5-2-1	0.0-3.0-7.0-9.0-4.0-6.0-8.0-5.0-2.0-4.1-0.0-3.0-7.0-9.0-4.0-6.0-8.0-5.0-2.0-1.0	98	254762	256803
HG02809.verkko_filt_mat.fa:haplotype1-0000023_94161320_94589755_0	HG02809.verkko_filt_mat.fa:haplotype1-0000023_94161320_94589755_0	256845	258156	9	5	0	0	4	1311	254203	252892	0-3-7-9-4-6-8-5-2-4-0-3-7-9-4-6-8-5-2-1	0.0-3.0-7.0-9.0-4.0-6.0-8.0-5.0-2.0-4.1-0.0-3.0-7.0-9.0-4.0-6.0-8.0-5.0-2.0-1.0	98	256747	258058
HG02809.verkko_filt_mat.fa:haplotype1-0000023_94161320_94589755_0	HG02809.verkko_filt_mat.fa:haplotype1-0000023_94161320_94589755_0	258604	274409	4	84	0	0	83	15805	270008	254203	0-3-7-9-4-6-8-5-2-4-0-3-7-9-4-6-8-5-2-1	0.0-3.0-7.0-9.0-4.0-6.0-8.0-5.0-2.0-4.1-0.0-3.0-7.0-9.0-4.0-6.0-8.0-5.0-2.0-1.0	98	258506	274311
HG02809.verkko_filt_mat.fa:haplotype1-0000023_94161320_94589755_0	HG02809.verkko_filt_mat.fa:haplotype1-0000023_94161320_94589755_0	274353	277168	6	12	0	0	11	2815	272823	270008	0-3-7-9-4-6-8-5-2-4-0-3-7-9-4-6-8-5-2-1	0.0-3.0-7.0-9.0-4.0-6.0-8.0-5.0-2.0-4.1-0.0-3.0-7.0-9.0-4.0-6.0-8.0-5.0-2.0-1.0	98	274255	277070
HG02809.verkko_filt_mat.fa:haplotype1-0000023_94161320_94589755_0	HG02809.verkko_filt_mat.fa:haplotype1-0000023_94161320_94589755_0	277112	278882	8	8	0	0	7	1770	274593	272823	0-3-7-9-4-6-8-5-2-4-0-3-7-9-4-6-8-5-2-1	0.0-3.0-7.0-9.0-4.0-6.0-8.0-5.0-2.0-4.1-0.0-3.0-7.0-9.0-4.0-6.0-8.0-5.0-2.0-1.0	98	277014	278784
HG02809.verkko_filt_mat.fa:haplotype1-0000023_94161320_94589755_0	HG02809.verkko_filt_mat.fa:haplotype1-0000023_94161320_94589755_0	278826	291930	5	79	0	0	78	13104	287697	274593	0-3-7-9-4-6-8-5-2-4-0-3-7-9-4-6-8-5-2-1	0.0-3.0-7.0-9.0-4.0-6.0-8.0-5.0-2.0-4.1-0.0-3.0-7.0-9.0-4.0-6.0-8.0-5.0-2.0-1.0	98	278728	291832
HG02809.verkko_filt_mat.fa:haplotype1-0000023_94161320_94589755_0	HG02809.verkko_filt_mat.fa:haplotype1-0000023_94161320_94589755_0	291874	326185	2	196	0	0	195	34311	322008	287697	0-3-7-9-4-6-8-5-2-4-0-3-7-9-4-6-8-5-2-1	0.0-3.0-7.0-9.0-4.0-6.0-8.0-5.0-2.0-4.1-0.0-3.0-7.0-9.0-4.0-6.0-8.0-5.0-2.0-1.0	98	291776	326087
HG02809.verkko_filt_mat.fa:haplotype1-0000023_94161320_94589755_0	HG02809.verkko_filt_mat.fa:haplotype1-0000023_94161320_94589755_0	326129	428491	1	612	0	0	606	102362	424370	322008	0-3-7-9-4-6-8-5-2-4-0-3-7-9-4-6-8-5-2-1	0.0-3.0-7.0-9.0-4.0-6.0-8.0-5.0-2.0-4.1-0.0-3.0-7.0-9.0-4.0-6.0-8.0-5.0-2.0-1.0	98	326031	428393
HG02809.verkko_filt_pat.fa:haplotype2-0001251_103421111_103827972_0	HG02809.verkko_filt_pat.fa:haplotype2-0001251_103421111_103827972_0	98	115438	0	672	0	0	671	115340	115340	0	0-3-7-9-4-6-8-5-2-7-9-4-2-5-2-1	0.0-3.0-7.0-9.0-4.0-6.0-8.0-5.0-2.0-7.0-9.0-4.0-2.1-5.1-2.0-1.0	98	0	115340
HG02809.verkko_filt_pat.fa:haplotype2-0001251_103421111_103827972_0	HG02809.verkko_filt_pat.fa:haplotype2-0001251_103421111_103827972_0	115529	138358	3	132	0	0	131	22829	138169	115340	0-3-7-9-4-6-8-5-2-7-9-4-2-5-2-1	0.0-3.0-7.0-9.0-4.0-6.0-8.0-5.0-2.0-7.0-9.0-4.0-2.1-5.1-2.0-1.0	98	115431	138260
HG02809.verkko_filt_pat.fa:haplotype2-0001251_103421111_103827972_0	HG02809.verkko_filt_pat.fa:haplotype2-0001251_103421111_103827972_0	139117	141157	7	12	0	0	11	2040	140209	138169	0-3-7-9-4-6-8-5-2-7-9-4-2-5-2-1	0.0-3.0-7.0-9.0-4.0-6.0-8.0-5.0-2.0-7.0-9.0-4.0-2.1-5.1-2.0-1.0	98	139019	141059
HG02809.verkko_filt_pat.fa:haplotype2-0001251_103421111_103827972_0	HG02809.verkko_filt_pat.fa:haplotype2-0001251_103421111_103827972_0	141101	142412	9	5	0	0	4	1311	141520	140209	0-3-7-9-4-6-8-5-2-7-9-4-2-5-2-1	0.0-3.0-7.0-9.0-4.0-6.0-8.0-5.0-2.0-7.0-9.0-4.0-2.1-5.1-2.0-1.0	98	141003	142314
HG02809.verkko_filt_pat.fa:haplotype2-0001251_103421111_103827972_0	HG02809.verkko_filt_pat.fa:haplotype2-0001251_103421111_103827972_0	142860	158671	4	84	0	0	83	15811	157331	141520	0-3-7-9-4-6-8-5-2-7-9-4-2-5-2-1	0.0-3.0-7.0-9.0-4.0-6.0-8.0-5.0-2.0-7.0-9.0-4.0-2.1-5.1-2.0-1.0	98	142762	158573
HG02809.verkko_filt_pat.fa:haplotype2-0001251_103421111_103827972_0	HG02809.verkko_filt_pat.fa:haplotype2-0001251_103421111_103827972_0	158615	161021	6	12	0	0	9	2406	159737	157331	0-3-7-9-4-6-8-5-2-7-9-4-2-5-2-1	0.0-3.0-7.0-9.0-4.0-6.0-8.0-5.0-2.0-7.0-9.0-4.0-2.1-5.1-2.0-1.0	98	158517	160923
HG02809.verkko_filt_pat.fa:haplotype2-0001251_103421111_103827972_0	HG02809.verkko_filt_pat.fa:haplotype2-0001251_103421111_103827972_0	161374	163144	8	8	0	0	7	1770	161507	159737	0-3-7-9-4-6-8-5-2-7-9-4-2-5-2-1	0.0-3.0-7.0-9.0-4.0-6.0-8.0-5.0-2.0-7.0-9.0-4.0-2.1-5.1-2.0-1.0	98	161276	163046
HG02809.verkko_filt_pat.fa:haplotype2-0001251_103421111_103827972_0	HG02809.verkko_filt_pat.fa:haplotype2-0001251_103421111_103827972_0	163088	176227	5	79	0	0	78	13139	174646	161507	0-3-7-9-4-6-8-5-2-7-9-4-2-5-2-1	0.0-3.0-7.0-9.0-4.0-6.0-8.0-5.0-2.0-7.0-9.0-4.0-2.1-5.1-2.0-1.0	98	162990	176129
HG02809.verkko_filt_pat.fa:haplotype2-0001251_103421111_103827972_0	HG02809.verkko_filt_pat.fa:haplotype2-0001251_103421111_103827972_0	176171	210492	2	196	0	0	195	34321	208967	174646	0-3-7-9-4-6-8-5-2-7-9-4-2-5-2-1	0.0-3.0-7.0-9.0-4.0-6.0-8.0-5.0-2.0-7.0-9.0-4.0-2.1-5.1-2.0-1.0	98	176073	210394
HG02809.verkko_filt_pat.fa:haplotype2-0001251_103421111_103827972_0	HG02809.verkko_filt_pat.fa:haplotype2-0001251_103421111_103827972_0	211569	213609	7	12	0	0	11	2040	211007	208967	0-3-7-9-4-6-8-5-2-7-9-4-2-5-2-1	0.0-3.0-7.0-9.0-4.0-6.0-8.0-5.0-2.0-7.0-9.0-4.0-2.1-5.1-2.0-1.0	98	211471	213511
HG02809.verkko_filt_pat.fa:haplotype2-0001251_103421111_103827972_0	HG02809.verkko_filt_pat.fa:haplotype2-0001251_103421111_103827972_0	213553	214864	9	5	0	0	4	1311	212318	211007	0-3-7-9-4-6-8-5-2-7-9-4-2-5-2-1	0.0-3.0-7.0-9.0-4.0-6.0-8.0-5.0-2.0-7.0-9.0-4.0-2.1-5.1-2.0-1.0	98	213455	214766
HG02809.verkko_filt_pat.fa:haplotype2-0001251_103421111_103827972_0	HG02809.verkko_filt_pat.fa:haplotype2-0001251_103421111_103827972_0	215927	227473	4	84	0	4	58	11546	223864	212318	0-3-7-9-4-6-8-5-2-7-9-4-2-5-2-1	0.0-3.0-7.0-9.0-4.0-6.0-8.0-5.0-2.0-7.0-9.0-4.0-2.1-5.1-2.0-1.0	98	215829	227375
HG02809.verkko_filt_pat.fa:haplotype2-0001251_103421111_103827972_0	HG02809.verkko_filt_pat.fa:haplotype2-0001251_103421111_103827972_0	229339	263443	2	196	1	195	1	34104	257968	223864	0-3-7-9-4-6-8-5-2-7-9-4-2-5-2-1	0.0-3.0-7.0-9.0-4.0-6.0-8.0-5.0-2.0-7.0-9.0-4.0-2.1-5.1-2.0-1.0	98	229241	263345
HG02809.verkko_filt_pat.fa:haplotype2-0001251_103421111_103827972_0	HG02809.verkko_filt_pat.fa:haplotype2-0001251_103421111_103827972_0	264050	276265	5	79	1	77	3	12215	270183	257968	0-3-7-9-4-6-8-5-2-7-9-4-2-5-2-1	0.0-3.0-7.0-9.0-4.0-6.0-8.0-5.0-2.0-7.0-9.0-4.0-2.1-5.1-2.0-1.0	98	263952	276167
HG02809.verkko_filt_pat.fa:haplotype2-0001251_103421111_103827972_0	HG02809.verkko_filt_pat.fa:haplotype2-0001251_103421111_103827972_0	276704	304612	2	196	0	39	195	27908	298091	270183	0-3-7-9-4-6-8-5-2-7-9-4-2-5-2-1	0.0-3.0-7.0-9.0-4.0-6.0-8.0-5.0-2.0-7.0-9.0-4.0-2.1-5.1-2.0-1.0	98	276606	304514
HG02809.verkko_filt_pat.fa:haplotype2-0001251_103421111_103827972_0	HG02809.verkko_filt_pat.fa:haplotype2-0001251_103421111_103827972_0	304556	406917	1	612	0	0	606	102361	400452	298091	0-3-7-9-4-6-8-5-2-7-9-4-2-5-2-1	0.0-3.0-7.0-9.0-4.0-6.0-8.0-5.0-2.0-7.0-9.0-4.0-2.1-5.1-2.0-1.0	98	304458	406819
HG02818#1#JAHEOS010000101.1_89626_496613_0	HG02818	98	115486	0	672	0	0	671	115388	115388	0	0-3-7-9-4-6-8-5-2-4-9-7-2-5-2-1	0.0-3.0-7.0-9.0-4.0-6.0-8.0-5.0-2.0-4.1-9.1-7.1-2.1-5.0-2.0-1.0	98	0	115388
HG02818#1#JAHEOS010000101.1_89626_496613_0	HG02818	115577	138410	3	132	0	0	131	22833	138221	115388	0-3-7-9-4-6-8-5-2-4-9-7-2-5-2-1	0.0-3.0-7.0-9.0-4.0-6.0-8.0-5.0-2.0-4.1-9.1-7.1-2.1-5.0-2.0-1.0	98	115479	138312
HG02818#1#JAHEOS010000101.1_89626_496613_0	HG02818	139169	141209	7	12	0	0	11	2040	140261	138221	0-3-7-9-4-6-8-5-2-4-9-7-2-5-2-1	0.0-3.0-7.0-9.0-4.0-6.0-8.0-5.0-2.0-4.1-9.1-7.1-2.1-5.0-2.0-1.0	98	139071	141111
HG02818#1#JAHEOS010000101.1_89626_496613_0	HG02818	141153	142464	9	5	0	0	4	1311	141572	140261	0-3-7-9-4-6-8-5-2-4-9-7-2-5-2-1	0.0-3.0-7.0-9.0-4.0-6.0-8.0-5.0-2.0-4.1-9.1-7.1-2.1-5.0-2.0-1.0	98	141055	142366
HG02818#1#JAHEOS010000101.1_89626_496613_0	HG02818	143529	158739	4	84	0	4	83	15210	156782	141572	0-3-7-9-4-6-8-5-2-4-9-7-2-5-2-1	0.0-3.0-7.0-9.0-4.0-6.0-8.0-5.0-2.0-4.1-9.1-7.1-2.1-5.0-2.0-1.0	98	143431	158641
HG02818#1#JAHEOS010000101.1_89626_496613_0	HG02818	158683	161498	6	12	0	0	11	2815	159597	156782	0-3-7-9-4-6-8-5-2-4-9-7-2-5-2-1	0.0-3.0-7.0-9.0-4.0-6.0-8.0-5.0-2.0-4.1-9.1-7.1-2.1-5.0-2.0-1.0	98	158585	161400
HG02818#1#JAHEOS010000101.1_89626_496613_0	HG02818	161442	163212	8	8	0	0	7	1770	161367	159597	0-3-7-9-4-6-8-5-2-4-9-7-2-5-2-1	0.0-3.0-7.0-9.0-4.0-6.0-8.0-5.0-2.0-4.1-9.1-7.1-2.1-5.0-2.0-1.0	98	161344	163114
HG02818#1#JAHEOS010000101.1_89626_496613_0	HG02818	163156	175854	5	79	0	0	77	12698	174065	161367	0-3-7-9-4-6-8-5-2-4-9-7-2-5-2-1	0.0-3.0-7.0-9.0-4.0-6.0-8.0-5.0-2.0-4.1-9.1-7.1-2.1-5.0-2.0-1.0	98	163058	175756
HG02818#1#JAHEOS010000101.1_89626_496613_0	HG02818	176461	210591	2	196	0	1	195	34130	208195	174065	0-3-7-9-4-6-8-5-2-4-9-7-2-5-2-1	0.0-3.0-7.0-9.0-4.0-6.0-8.0-5.0-2.0-4.1-9.1-7.1-2.1-5.0-2.0-1.0	98	176363	210493
HG02818#1#JAHEOS010000101.1_89626_496613_0	HG02818	212907	224001	4	84	1	56	4	11094	219289	208195	0-3-7-9-4-6-8-5-2-4-9-7-2-5-2-1	0.0-3.0-7.0-9.0-4.0-6.0-8.0-5.0-2.0-4.1-9.1-7.1-2.1-5.0-2.0-1.0	98	212809	223903
HG02818#1#JAHEOS010000101.1_89626_496613_0	HG02818	225064	226375	9	5	1	4	0	1311	220600	219289	0-3-7-9-4-6-8-5-2-4-9-7-2-5-2-1	0.0-3.0-7.0-9.0-4.0-6.0-8.0-5.0-2.0-4.1-9.1-7.1-2.1-5.0-2.0-1.0	98	224966	226277
HG02818#1#JAHEOS010000101.1_89626_496613_0	HG02818	226319	228359	7	12	1	11	0	2040	222640	220600	0-3-7-9-4-6-8-5-2-4-9-7-2-5-2-1	0.0-3.0-7.0-9.0-4.0-6.0-8.0-5.0-2.0-4.1-9.1-7.1-2.1-5.0-2.0-1.0	98	226221	228261
HG02818#1#JAHEOS010000101.1_89626_496613_0	HG02818	229436	257349	2	196	1	195	39	27913	250553	222640	0-3-7-9-4-6-8-5-2-4-9-7-2-5-2-1	0.0-3.0-7.0-9.0-4.0-6.0-8.0-5.0-2.0-4.1-9.1-7.1-2.1-5.0-2.0-1.0	98	229338	257251
HG02818#1#JAHEOS010000101.1_89626_496613_0	HG02818	258315	269529	5	79	0	5	75	11214	261767	250553	0-3-7-9-4-6-8-5-2-4-9-7-2-5-2-1	0.0-3.0-7.0-9.0-4.0-6.0-8.0-5.0-2.0-4.1-9.1-7.1-2.1-5.0-2.0-1.0	98	258217	269431
HG02818#1#JAHEOS010000101.1_89626_496613_0	HG02818	270610	304706	2	196	0	1	195	34096	295863	261767	0-3-7-9-4-6-8-5-2-4-9-7-2-5-2-1	0.0-3.0-7.0-9.0-4.0-6.0-8.0-5.0-2.0-4.1-9.1-7.1-2.1-5.0-2.0-1.0	98	270512	304608
HG02818#1#JAHEOS010000101.1_89626_496613_0	HG02818	304650	407043	1	612	0	0	606	102393	398256	295863	0-3-7-9-4-6-8-5-2-4-9-7-2-5-2-1	0.0-3.0-7.0-9.0-4.0-6.0-8.0-5.0-2.0-4.1-9.1-7.1-2.1-5.0-2.0-1.0	98	304552	406945
HG02818#2#JAHEOR010000010.1_31775319_32183091_1	HG02818	154	115501	0	672	0	0	671	115347	115347	0	0-3-7-9-4-6-8-5-2-4-9-7-2-5-2-1	0.0-3.0-7.0-9.0-4.0-6.0-8.0-5.0-2.0-4.1-9.1-7.1-2.1-5.0-2.0-1.0	154	0	115347
HG02818#2#JAHEOR010000010.1_31775319_32183091_1	HG02818	115592	138427	3	132	0	0	131	22835	138182	115347	0-3-7-9-4-6-8-5-2-4-9-7-2-5-2-1	0.0-3.0-7.0-9.0-4.0-6.0-8.0-5.0-2.0-4.1-9.1-7.1-2.1-5.0-2.0-1.0	154	115438	138273
HG02818#2#JAHEOR010000010.1_31775319_32183091_1	HG02818	139186	141226	7	12	0	0	11	2040	140222	138182	0-3-7-9-4-6-8-5-2-4-9-7-2-5-2-1	0.0-3.0-7.0-9.0-4.0-6.0-8.0-5.0-2.0-4.1-9.1-7.1-2.1-5.0-2.0-1.0	154	139032	141072
HG02818#2#JAHEOR010000010.1_31775319_32183091_1	HG02818	141170	142481	9	5	0	0	4	1311	141533	140222	0-3-7-9-4-6-8-5-2-4-9-7-2-5-2-1	0.0-3.0-7.0-9.0-4.0-6.0-8.0-5.0-2.0-4.1-9.1-7.1-2.1-5.0-2.0-1.0	154	141016	142327
HG02818#2#JAHEOR010000010.1_31775319_32183091_1	HG02818	142929	158731	4	84	0	0	83	15802	157335	141533	0-3-7-9-4-6-8-5-2-4-9-7-2-5-2-1	0.0-3.0-7.0-9.0-4.0-6.0-8.0-5.0-2.0-4.1-9.1-7.1-2.1-5.0-2.0-1.0	154	142775	158577
HG02818#2#JAHEOR010000010.1_31775319_32183091_1	HG02818	158675	161490	6	12	0	0	11	2815	160150	157335	0-3-7-9-4-6-8-5-2-4-9-7-2-5-2-1	0.0-3.0-7.0-9.0-4.0-6.0-8.0-5.0-2.0-4.1-9.1-7.1-2.1-5.0-2.0-1.0	154	158521	161336
HG02818#2#JAHEOR010000010.1_31775319_32183091_1	HG02818	161434	163204	8	8	0	0	7	1770	161920	160150	0-3-7-9-4-6-8-5-2-4-9-7-2-5-2-1	0.0-3.0-7.0-9.0-4.0-6.0-8.0-5.0-2.0-4.1-9.1-7.1-2.1-5.0-2.0-1.0	154	161280	163050
HG02818#2#JAHEOR010000010.1_31775319_32183091_1	HG02818	163148	175372	5	79	0	0	75	12224	174144	161920	0-3-7-9-4-6-8-5-2-4-9-7-2-5-2-1	0.0-3.0-7.0-9.0-4.0-6.0-8.0-5.0-2.0-4.1-9.1-7.1-2.1-5.0-2.0-1.0	154	162994	175218
HG02818#2#JAHEOR010000010.1_31775319_32183091_1	HG02818	176453	210563	2	196	0	1	195	34110	208254	174144	0-3-7-9-4-6-8-5-2-4-9-7-2-5-2-1	0.0-3.0-7.0-9.0-4.0-6.0-8.0-5.0-2.0-4.1-9.1-7.1-2.1-5.0-2.0-1.0	154	176299	210409
HG02818#2#JAHEOR010000010.1_31775319_32183091_1	HG02818	212429	223963	4	84	1	58	4	11534	219788	208254	0-3-7-9-4-6-8-5-2-4-9-7-2-5-2-1	0.0-3.0-7.0-9.0-4.0-6.0-8.0-5.0-2.0-4.1-9.1-7.1-2.1-5.0-2.0-1.0	154	212275	223809
HG02818#2#JAHEOR010000010.1_31775319_32183091_1	HG02818	225028	226339	9	5	1	4	0	1311	221099	219788	0-3-7-9-4-6-8-5-2-4-9-7-2-5-2-1	0.0-3.0-7.0-9.0-4.0-6.0-8.0-5.0-2.0-4.1-9.1-7.1-2.1-5.0-2.0-1.0	154	224874	226185
HG02818#2#JAHEOR010000010.1_31775319_32183091_1	HG02818	226283	228323	7	12	1	11	0	2040	223139	221099	0-3-7-9-4-6-8-5-2-4-9-7-2-5-2-1	0.0-3.0-7.0-9.0-4.0-6.0-8.0-5.0-2.0-4.1-9.1-7.1-2.1-5.0-2.0-1.0	154	226129	228169
HG02818#2#JAHEOR010000010.1_31775319_32183091_1	HG02818	229400	257321	2	196	1	195	39	27921	251060	223139	0-3-7-9-4-6-8-5-2-4-9-7-2-5-2-1	0.0-3.0-7.0-9.0-4.0-6.0-8.0-5.0-2.0-4.1-9.1-7.1-2.1-5.0-2.0-1.0	154	229246	257167
HG02818#2#JAHEOR010000010.1_31775319_32183091_1	HG02818	257760	269502	5	79	0	3	75	11742	262802	251060	0-3-7-9-4-6-8-5-2-4-9-7-2-5-2-1	0.0-3.0-7.0-9.0-4.0-6.0-8.0-5.0-2.0-4.1-9.1-7.1-2.1-5.0-2.0-1.0	154	257606	269348
HG02818#2#JAHEOR010000010.1_31775319_32183091_1	HG02818	270583	304684	2	196	0	1	195	34101	296903	262802	0-3-7-9-4-6-8-5-2-4-9-7-2-5-2-1	0.0-3.0-7.0-9.0-4.0-6.0-8.0-5.0-2.0-4.1-9.1-7.1-2.1-5.0-2.0-1.0	154	270429	304530
HG02818#2#JAHEOR010000010.1_31775319_32183091_1	HG02818	304628	407756	1	612	0	0	611	103128	400031	296903	0-3-7-9-4-6-8-5-2-4-9-7-2-5-2-1	0.0-3.0-7.0-9.0-4.0-6.0-8.0-5.0-2.0-4.1-9.1-7.1-2.1-5.0-2.0-1.0	154	304474	407602
HG02886#1#JAHAOU010000178.1_62411_469262_0	HG02886	98	115446	0	672	0	0	671	115348	115348	0	0-3-7-9-4-6-8-5-2-4-9-7-2-5-2-1	0.0-3.0-7.0-9.0-4.0-6.0-8.0-5.0-2.0-4.1-9.1-7.1-2.1-5.1-2.0-1.0	98	0	115348
HG02886#1#JAHAOU010000178.1_62411_469262_0	HG02886	115537	138373	3	132	0	0	131	22836	138184	115348	0-3-7-9-4-6-8-5-2-4-9-7-2-5-2-1	0.0-3.0-7.0-9.0-4.0-6.0-8.0-5.0-2.0-4.1-9.1-7.1-2.1-5.1-2.0-1.0	98	115439	138275
HG02886#1#JAHAOU010000178.1_62411_469262_0	HG02886	139132	141172	7	12	0	0	11	2040	140224	138184	0-3-7-9-4-6-8-5-2-4-9-7-2-5-2-1	0.0-3.0-7.0-9.0-4.0-6.0-8.0-5.0-2.0-4.1-9.1-7.1-2.1-5.1-2.0-1.0	98	139034	141074
HG02886#1#JAHAOU010000178.1_62411_469262_0	HG02886	141116	142427	9	5	0	0	4	1311	141535	140224	0-3-7-9-4-6-8-5-2-4-9-7-2-5-2-1	0.0-3.0-7.0-9.0-4.0-6.0-8.0-5.0-2.0-4.1-9.1-7.1-2.1-5.1-2.0-1.0	98	141018	142329
HG02886#1#JAHAOU010000178.1_62411_469262_0	HG02886	142875	158688	4	84	0	0	83	15813	157348	141535	0-3-7-9-4-6-8-5-2-4-9-7-2-5-2-1	0.0-3.0-7.0-9.0-4.0-6.0-8.0-5.0-2.0-4.1-9.1-7.1-2.1-5.1-2.0-1.0	98	142777	158590
HG02886#1#JAHAOU010000178.1_62411_469262_0	HG02886	158632	161447	6	12	0	0	11	2815	160163	157348	0-3-7-9-4-6-8-5-2-4-9-7-2-5-2-1	0.0-3.0-7.0-9.0-4.0-6.0-8.0-5.0-2.0-4.1-9.1-7.1-2.1-5.1-2.0-1.0	98	158534	161349
HG02886#1#JAHAOU010000178.1_62411_469262_0	HG02886	161391	163161	8	8	0	0	7	1770	161933	160163	0-3-7-9-4-6-8-5-2-4-9-7-2-5-2-1	0.0-3.0-7.0-9.0-4.0-6.0-8.0-5.0-2.0-4.1-9.1-7.1-2.1-5.1-2.0-1.0	98	161293	163063
HG02886#1#JAHAOU010000178.1_62411_469262_0	HG02886	163105	175769	5	79	0	0	77	12664	174597	161933	0-3-7-9-4-6-8-5-2-4-9-7-2-5-2-1	0.0-3.0-7.0-9.0-4.0-6.0-8.0-5.0-2.0-4.1-9.1-7.1-2.1-5.1-2.0-1.0	98	163007	175671
HG02886#1#JAHAOU010000178.1_62411_469262_0	HG02886	176376	210472	2	196	0	1	195	34096	208693	174597	0-3-7-9-4-6-8-5-2-4-9-7-2-5-2-1	0.0-3.0-7.0-9.0-4.0-6.0-8.0-5.0-2.0-4.1-9.1-7.1-2.1-5.1-2.0-1.0	98	176278	210374
HG02886#1#JAHAOU010000178.1_62411_469262_0	HG02886	212338	223888	4	84	1	58	4	11550	220243	208693	0-3-7-9-4-6-8-5-2-4-9-7-2-5-2-1	0.0-3.0-7.0-9.0-4.0-6.0-8.0-5.0-2.0-4.1-9.1-7.1-2.1-5.1-2.0-1.0	98	212240	223790
HG02886#1#JAHAOU010000178.1_62411_469262_0	HG02886	224953	226264	9	5	1	4	0	1311	221554	220243	0-3-7-9-4-6-8-5-2-4-9-7-2-5-2-1	0.0-3.0-7.0-9.0-4.0-6.0-8.0-5.0-2.0-4.1-9.1-7.1-2.1-5.1-2.0-1.0	98	224855	226166
HG02886#1#JAHAOU010000178.1_62411_469262_0	HG02886	226208	228248	7	12	1	11	0	2040	223594	221554	0-3-7-9-4-6-8-5-2-4-9-7-2-5-2-1	0.0-3.0-7.0-9.0-4.0-6.0-8.0-5.0-2.0-4.1-9.1-7.1-2.1-5.1-2.0-1.0	98	226110	228150
HG02886#1#JAHAOU010000178.1_62411_469262_0	HG02886	229325	263427	2	196	1	195	1	34102	257696	223594	0-3-7-9-4-6-8-5-2-4-9-7-2-5-2-1	0.0-3.0-7.0-9.0-4.0-6.0-8.0-5.0-2.0-4.1-9.1-7.1-2.1-5.1-2.0-1.0	98	229227	263329
HG02886#1#JAHAOU010000178.1_62411_469262_0	HG02886	264034	276249	5	79	1	77	3	12215	269911	257696	0-3-7-9-4-6-8-5-2-4-9-7-2-5-2-1	0.0-3.0-7.0-9.0-4.0-6.0-8.0-5.0-2.0-4.1-9.1-7.1-2.1-5.1-2.0-1.0	98	263936	276151
HG02886#1#JAHAOU010000178.1_62411_469262_0	HG02886	276688	304599	2	196	0	39	195	27911	297822	269911	0-3-7-9-4-6-8-5-2-4-9-7-2-5-2-1	0.0-3.0-7.0-9.0-4.0-6.0-8.0-5.0-2.0-4.1-9.1-7.1-2.1-5.1-2.0-1.0	98	276590	304501
HG02886#1#JAHAOU010000178.1_62411_469262_0	HG02886	304543	406907	1	612	0	0	606	102364	400186	297822	0-3-7-9-4-6-8-5-2-4-9-7-2-5-2-1	0.0-3.0-7.0-9.0-4.0-6.0-8.0-5.0-2.0-4.1-9.1-7.1-2.1-5.1-2.0-1.0	98	304445	406809
HG02886#2#JAHAOT010000031.1_87393_401061_0	HG02886	98	115457	0	672	0	0	671	115359	115359	0	0-3-7-9-4-6-8-5-2-1	0.0-3.0-7.0-9.0-4.0-6.0-8.0-5.0-2.0-1.0	98	0	115359
HG02886#2#JAHAOT010000031.1_87393_401061_0	HG02886	115548	138379	3	132	0	0	131	22831	138190	115359	0-3-7-9-4-6-8-5-2-1	0.0-3.0-7.0-9.0-4.0-6.0-8.0-5.0-2.0-1.0	98	115450	138281
HG02886#2#JAHAOT010000031.1_87393_401061_0	HG02886	139138	141178	7	12	0	0	11	2040	140230	138190	0-3-7-9-4-6-8-5-2-1	0.0-3.0-7.0-9.0-4.0-6.0-8.0-5.0-2.0-1.0	98	139040	141080
HG02886#2#JAHAOT010000031.1_87393_401061_0	HG02886	141122	142433	9	5	0	0	4	1311	141541	140230	0-3-7-9-4-6-8-5-2-1	0.0-3.0-7.0-9.0-4.0-6.0-8.0-5.0-2.0-1.0	98	141024	142335
HG02886#2#JAHAOT010000031.1_87393_401061_0	HG02886	143224	158684	4	84	0	1	83	15460	157001	141541	0-3-7-9-4-6-8-5-2-1	0.0-3.0-7.0-9.0-4.0-6.0-8.0-5.0-2.0-1.0	98	143126	158586
HG02886#2#JAHAOT010000031.1_87393_401061_0	HG02886	158628	161443	6	12	0	0	11	2815	159816	157001	0-3-7-9-4-6-8-5-2-1	0.0-3.0-7.0-9.0-4.0-6.0-8.0-5.0-2.0-1.0	98	158530	161345
HG02886#2#JAHAOT010000031.1_87393_401061_0	HG02886	161387	163157	8	8	0	0	7	1770	161586	159816	0-3-7-9-4-6-8-5-2-1	0.0-3.0-7.0-9.0-4.0-6.0-8.0-5.0-2.0-1.0	98	161289	163059
HG02886#2#JAHAOT010000031.1_87393_401061_0	HG02886	163101	175765	5	79	0	0	77	12664	174250	161586	0-3-7-9-4-6-8-5-2-1	0.0-3.0-7.0-9.0-4.0-6.0-8.0-5.0-2.0-1.0	98	163003	175667
HG02886#2#JAHAOT010000031.1_87393_401061_0	HG02886	176372	210477	2	196	0	1	195	34105	208355	174250	0-3-7-9-4-6-8-5-2-1	0.0-3.0-7.0-9.0-4.0-6.0-8.0-5.0-2.0-1.0	98	176274	210379
HG02886#2#JAHAOT010000031.1_87393_401061_0	HG02886	210421	313596	1	612	0	0	611	103175	311530	208355	0-3-7-9-4-6-8-5-2-1	0.0-3.0-7.0-9.0-4.0-6.0-8.0-5.0-2.0-1.0	98	210323	313498
HG03098#1#JAHEPM010000059.1_16676208_17105596_0	HG03098	98	115428	0	672	0	0	671	115330	115330	0	0-3-7-9-4-6-8-5-2-4-0-3-7-9-4-6-8-5-2-1	0.0-3.0-7.0-9.0-4.0-6.0-8.0-5.0-2.0-4.1-0.0-3.0-7.0-9.0-4.0-6.0-8.0-5.0-2.0-1.0	98	0	115330
HG03098#1#JAHEPM010000059.1_16676208_17105596_0	HG03098	115519	138351	3	132	0	0	131	22832	138162	115330	0-3-7-9-4-6-8-5-2-4-0-3-7-9-4-6-8-5-2-1	0.0-3.0-7.0-9.0-4.0-6.0-8.0-5.0-2.0-4.1-0.0-3.0-7.0-9.0-4.0-6.0-8.0-5.0-2.0-1.0	98	115421	138253
HG03098#1#JAHEPM010000059.1_16676208_17105596_0	HG03098	139110	141150	7	12	0	0	11	2040	140202	138162	0-3-7-9-4-6-8-5-2-4-0-3-7-9-4-6-8-5-2-1	0.0-3.0-7.0-9.0-4.0-6.0-8.0-5.0-2.0-4.1-0.0-3.0-7.0-9.0-4.0-6.0-8.0-5.0-2.0-1.0	98	139012	141052
HG03098#1#JAHEPM010000059.1_16676208_17105596_0	HG03098	141094	142405	9	5	0	0	4	1311	141513	140202	0-3-7-9-4-6-8-5-2-4-0-3-7-9-4-6-8-5-2-1	0.0-3.0-7.0-9.0-4.0-6.0-8.0-5.0-2.0-4.1-0.0-3.0-7.0-9.0-4.0-6.0-8.0-5.0-2.0-1.0	98	140996	142307
HG03098#1#JAHEPM010000059.1_16676208_17105596_0	HG03098	142853	158664	4	84	0	0	83	15811	157324	141513	0-3-7-9-4-6-8-5-2-4-0-3-7-9-4-6-8-5-2-1	0.0-3.0-7.0-9.0-4.0-6.0-8.0-5.0-2.0-4.1-0.0-3.0-7.0-9.0-4.0-6.0-8.0-5.0-2.0-1.0	98	142755	158566
HG03098#1#JAHEPM010000059.1_16676208_17105596_0	HG03098	158608	161423	6	12	0	0	11	2815	160139	157324	0-3-7-9-4-6-8-5-2-4-0-3-7-9-4-6-8-5-2-1	0.0-3.0-7.0-9.0-4.0-6.0-8.0-5.0-2.0-4.1-0.0-3.0-7.0-9.0-4.0-6.0-8.0-5.0-2.0-1.0	98	158510	161325
HG03098#1#JAHEPM010000059.1_16676208_17105596_0	HG03098	161367	163137	8	8	0	0	7	1770	161909	160139	0-3-7-9-4-6-8-5-2-4-0-3-7-9-4-6-8-5-2-1	0.0-3.0-7.0-9.0-4.0-6.0-8.0-5.0-2.0-4.1-0.0-3.0-7.0-9.0-4.0-6.0-8.0-5.0-2.0-1.0	98	161269	163039
HG03098#1#JAHEPM010000059.1_16676208_17105596_0	HG03098	163081	176185	5	79	0	0	78	13104	175013	161909	0-3-7-9-4-6-8-5-2-4-0-3-7-9-4-6-8-5-2-1	0.0-3.0-7.0-9.0-4.0-6.0-8.0-5.0-2.0-4.1-0.0-3.0-7.0-9.0-4.0-6.0-8.0-5.0-2.0-1.0	98	162983	176087
HG03098#1#JAHEPM010000059.1_16676208_17105596_0	HG03098	176129	210448	2	196	0	0	195	34319	209332	175013	0-3-7-9-4-6-8-5-2-4-0-3-7-9-4-6-8-5-2-1	0.0-3.0-7.0-9.0-4.0-6.0-8.0-5.0-2.0-4.1-0.0-3.0-7.0-9.0-4.0-6.0-8.0-5.0-2.0-1.0	98	176031	210350
HG03098#1#JAHEPM010000059.1_16676208_17105596_0	HG03098	212314	220794	4	84	1	58	22	8480	217812	209332	0-3-7-9-4-6-8-5-2-4-0-3-7-9-4-6-8-5-2-1	0.0-3.0-7.0-9.0-4.0-6.0-8.0-5.0-2.0-4.1-0.0-3.0-7.0-9.0-4.0-6.0-8.0-5.0-2.0-1.0	98	212216	220696
HG03098#1#JAHEPM010000059.1_16676208_17105596_0	HG03098	220971	231178	0	672	0	604	671	10207	228019	217812	0-3-7-9-4-6-8-5-2-4-0-3-7-9-4-6-8-5-2-1	0.0-3.0-7.0-9.0-4.0-6.0-8.0-5.0-2.0-4.1-0.0-3.0-7.0-9.0-4.0-6.0-8.0-5.0-2.0-1.0	98	220873	231080
HG03098#1#JAHEPM010000059.1_16676208_17105596_0	HG03098	231269	254101	3	132	0	0	131	22832	250851	228019	0-3-7-9-4-6-8-5-2-4-0-3-7-9-4-6-8-5-2-1	0.0-3.0-7.0-9.0-4.0-6.0-8.0-5.0-2.0-4.1-0.0-3.0-7.0-9.0-4.0-6.0-8.0-5.0-2.0-1.0	98	231171	254003
HG03098#1#JAHEPM010000059.1_16676208_17105596_0	HG03098	254860	256900	7	12	0	0	11	2040	252891	250851	0-3-7-9-4-6-8-5-2-4-0-3-7-9-4-6-8-5-2-1	0.0-3.0-7.0-9.0-4.0-6.0-8.0-5.0-2.0-4.1-0.0-3.0-7.0-9.0-4.0-6.0-8.0-5.0-2.0-1.0	98	254762	256802
HG03098#1#JAHEPM010000059.1_16676208_17105596_0	HG03098	256844	258155	9	5	0	0	4	1311	254202	252891	0-3-7-9-4-6-8-5-2-4-0-3-7-9-4-6-8-5-2-1	0.0-3.0-7.0-9.0-4.0-6.0-8.0-5.0-2.0-4.1-0.0-3.0-7.0-9.0-4.0-6.0-8.0-5.0-2.0-1.0	98	256746	258057
HG03098#1#JAHEPM010000059.1_16676208_17105596_0	HG03098	258603	274414	4	84	0	0	83	15811	270013	254202	0-3-7-9-4-6-8-5-2-4-0-3-7-9-4-6-8-5-2-1	0.0-3.0-7.0-9.0-4.0-6.0-8.0-5.0-2.0-4.1-0.0-3.0-7.0-9.0-4.0-6.0-8.0-5.0-2.0-1.0	98	258505	274316
HG03098#1#JAHEPM010000059.1_16676208_17105596_0	HG03098	274358	277173	6	12	0	0	11	2815	272828	270013	0-3-7-9-4-6-8-5-2-4-0-3-7-9-4-6-8-5-2-1	0.0-3.0-7.0-9.0-4.0-6.0-8.0-5.0-2.0-4.1-0.0-3.0-7.0-9.0-4.0-6.0-8.0-5.0-2.0-1.0	98	274260	277075
HG03098#1#JAHEPM010000059.1_16676208_17105596_0	HG03098	277117	278887	8	8	0	0	7	1770	274598	272828	0-3-7-9-4-6-8-5-2-4-0-3-7-9-4-6-8-5-2-1	0.0-3.0-7.0-9.0-4.0-6.0-8.0-5.0-2.0-4.1-0.0-3.0-7.0-9.0-4.0-6.0-8.0-5.0-2.0-1.0	98	277019	278789
HG03098#1#JAHEPM010000059.1_16676208_17105596_0	HG03098	278831	291935	5	79	0	0	78	13104	287702	274598	0-3-7-9-4-6-8-5-2-4-0-3-7-9-4-6-8-5-2-1	0.0-3.0-7.0-9.0-4.0-6.0-8.0-5.0-2.0-4.1-0.0-3.0-7.0-9.0-4.0-6.0-8.0-5.0-2.0-1.0	98	278733	291837
HG03098#1#JAHEPM010000059.1_16676208_17105596_0	HG03098	291879	326208	2	196	0	0	195	34329	322031	287702	0-3-7-9-4-6-8-5-2-4-0-3-7-9-4-6-8-5-2-1	0.0-3.0-7.0-9.0-4.0-6.0-8.0-5.0-2.0-4.1-0.0-3.0-7.0-9.0-4.0-6.0-8.0-5.0-2.0-1.0	98	291781	326110
HG03098#1#JAHEPM010000059.1_16676208_17105596_0	HG03098	326152	429316	1	612	0	0	611	103164	425195	322031	0-3-7-9-4-6-8-5-2-4-0-3-7-9-4-6-8-5-2-1	0.0-3.0-7.0-9.0-4.0-6.0-8.0-5.0-2.0-4.1-0.0-3.0-7.0-9.0-4.0-6.0-8.0-5.0-2.0-1.0	98	326054	429218
HG03098#2#JAHEPL010000003.1_93803759_94117426_0	HG03098	98	115463	0	672	0	0	671	115365	115365	0	0-3-7-9-4-6-8-5-2-1	0.0-3.0-7.0-9.0-4.0-6.0-8.0-5.0-2.0-1.0	98	0	115365
HG03098#2#JAHEPL010000003.1_93803759_94117426_0	HG03098	115554	138389	3	132	0	0	131	22835	138200	115365	0-3-7-9-4-6-8-5-2-1	0.0-3.0-7.0-9.0-4.0-6.0-8.0-5.0-2.0-1.0	98	115456	138291
HG03098#2#JAHEPL010000003.1_93803759_94117426_0	HG03098	139148	141188	7	12	0	0	11	2040	140240	138200	0-3-7-9-4-6-8-5-2-1	0.0-3.0-7.0-9.0-4.0-6.0-8.0-5.0-2.0-1.0	98	139050	141090
HG03098#2#JAHEPL010000003.1_93803759_94117426_0	HG03098	141132	142443	9	5	0	0	4	1311	141551	140240	0-3-7-9-4-6-8-5-2-1	0.0-3.0-7.0-9.0-4.0-6.0-8.0-5.0-2.0-1.0	98	141034	142345
HG03098#2#JAHEPL010000003.1_93803759_94117426_0	HG03098	142891	158691	4	84	0	0	83	15800	157351	141551	0-3-7-9-4-6-8-5-2-1	0.0-3.0-7.0-9.0-4.0-6.0-8.0-5.0-2.0-1.0	98	142793	158593
HG03098#2#JAHEPL010000003.1_93803759_94117426_0	HG03098	158635	161450	6	12	0	0	11	2815	160166	157351	0-3-7-9-4-6-8-5-2-1	0.0-3.0-7.0-9.0-4.0-6.0-8.0-5.0-2.0-1.0	98	158537	161352
HG03098#2#JAHEPL010000003.1_93803759_94117426_0	HG03098	161394	163164	8	8	0	0	7	1770	161936	160166	0-3-7-9-4-6-8-5-2-1	0.0-3.0-7.0-9.0-4.0-6.0-8.0-5.0-2.0-1.0	98	161296	163066
HG03098#2#JAHEPL010000003.1_93803759_94117426_0	HG03098	163108	175332	5	79	0	0	75	12224	174160	161936	0-3-7-9-4-6-8-5-2-1	0.0-3.0-7.0-9.0-4.0-6.0-8.0-5.0-2.0-1.0	98	163010	175234
HG03098#2#JAHEPL010000003.1_93803759_94117426_0	HG03098	176413	210521	2	196	0	1	195	34108	208268	174160	0-3-7-9-4-6-8-5-2-1	0.0-3.0-7.0-9.0-4.0-6.0-8.0-5.0-2.0-1.0	98	176315	210423
HG03098#2#JAHEPL010000003.1_93803759_94117426_0	HG03098	210465	313595	1	612	0	0	611	103130	311398	208268	0-3-7-9-4-6-8-5-2-1	0.0-3.0-7.0-9.0-4.0-6.0-8.0-5.0-2.0-1.0	98	210367	313497
HG03453#1#JAGYVW010000157.1_2105722_2585000_1	HG03453	154	115487	0	672	0	0	671	115333	115333	0	0-3-7-9-4-6-8-5-2-7-9-4-6-8-5-2-7-9-4-2-5-2-1	0.0-3.0-7.0-9.0-4.0-6.0-8.0-5.0-2.0-7.0-9.0-4.0-6.0-8.0-5.0-2.0-7.0-9.0-4.0-2.1-5.0-2.0-1.0	154	0	115333
HG03453#1#JAGYVW010000157.1_2105722_2585000_1	HG03453	115578	138404	3	132	0	0	131	22826	138159	115333	0-3-7-9-4-6-8-5-2-7-9-4-6-8-5-2-7-9-4-2-5-2-1	0.0-3.0-7.0-9.0-4.0-6.0-8.0-5.0-2.0-7.0-9.0-4.0-6.0-8.0-5.0-2.0-7.0-9.0-4.0-2.1-5.0-2.0-1.0	154	115424	138250
HG03453#1#JAGYVW010000157.1_2105722_2585000_1	HG03453	139163	141203	7	12	0	0	11	2040	140199	138159	0-3-7-9-4-6-8-5-2-7-9-4-6-8-5-2-7-9-4-2-5-2-1	0.0-3.0-7.0-9.0-4.0-6.0-8.0-5.0-2.0-7.0-9.0-4.0-6.0-8.0-5.0-2.0-7.0-9.0-4.0-2.1-5.0-2.0-1.0	154	139009	141049
HG03453#1#JAGYVW010000157.1_2105722_2585000_1	HG03453	141147	142458	9	5	0	0	4	1311	141510	140199	0-3-7-9-4-6-8-5-2-7-9-4-6-8-5-2-7-9-4-2-5-2-1	0.0-3.0-7.0-9.0-4.0-6.0-8.0-5.0-2.0-7.0-9.0-4.0-6.0-8.0-5.0-2.0-7.0-9.0-4.0-2.1-5.0-2.0-1.0	154	140993	142304
HG03453#1#JAGYVW010000157.1_2105722_2585000_1	HG03453	143521	158714	4	84	0	4	83	15193	156703	141510	0-3-7-9-4-6-8-5-2-7-9-4-6-8-5-2-7-9-4-2-5-2-1	0.0-3.0-7.0-9.0-4.0-6.0-8.0-5.0-2.0-7.0-9.0-4.0-6.0-8.0-5.0-2.0-7.0-9.0-4.0-2.1-5.0-2.0-1.0	154	143367	158560
HG03453#1#JAGYVW010000157.1_2105722_2585000_1	HG03453	158658	161473	6	12	0	0	11	2815	159518	156703	0-3-7-9-4-6-8-5-2-7-9-4-6-8-5-2-7-9-4-2-5-2-1	0.0-3.0-7.0-9.0-4.0-6.0-8.0-5.0-2.0-7.0-9.0-4.0-6.0-8.0-5.0-2.0-7.0-9.0-4.0-2.1-5.0-2.0-1.0	154	158504	161319
HG03453#1#JAGYVW010000157.1_2105722_2585000_1	HG03453	161417	163187	8	8	0	0	7	1770	161288	159518	0-3-7-9-4-6-8-5-2-7-9-4-6-8-5-2-7-9-4-2-5-2-1	0.0-3.0-7.0-9.0-4.0-6.0-8.0-5.0-2.0-7.0-9.0-4.0-6.0-8.0-5.0-2.0-7.0-9.0-4.0-2.1-5.0-2.0-1.0	154	161263	163033
HG03453#1#JAGYVW010000157.1_2105722_2585000_1	HG03453	163131	175795	5	79	0	0	77	12664	173952	161288	0-3-7-9-4-6-8-5-2-7-9-4-6-8-5-2-7-9-4-2-5-2-1	0.0-3.0-7.0-9.0-4.0-6.0-8.0-5.0-2.0-7.0-9.0-4.0-6.0-8.0-5.0-2.0-7.0-9.0-4.0-2.1-5.0-2.0-1.0	154	162977	175641
HG03453#1#JAGYVW010000157.1_2105722_2585000_1	HG03453	176402	210507	2	196	0	1	195	34105	208057	173952	0-3-7-9-4-6-8-5-2-7-9-4-6-8-5-2-7-9-4-2-5-2-1	0.0-3.0-7.0-9.0-4.0-6.0-8.0-5.0-2.0-7.0-9.0-4.0-6.0-8.0-5.0-2.0-7.0-9.0-4.0-2.1-5.0-2.0-1.0	154	176248	210353
HG03453#1#JAGYVW010000157.1_2105722_2585000_1	HG03453	211584	213624	7	12	0	0	11	2040	210097	208057	0-3-7-9-4-6-8-5-2-7-9-4-6-8-5-2-7-9-4-2-5-2-1	0.0-3.0-7.0-9.0-4.0-6.0-8.0-5.0-2.0-7.0-9.0-4.0-6.0-8.0-5.0-2.0-7.0-9.0-4.0-2.1-5.0-2.0-1.0	154	211430	213470
HG03453#1#JAGYVW010000157.1_2105722_2585000_1	HG03453	213568	214879	9	5	0	0	4	1311	211408	210097	0-3-7-9-4-6-8-5-2-7-9-4-6-8-5-2-7-9-4-2-5-2-1	0.0-3.0-7.0-9.0-4.0-6.0-8.0-5.0-2.0-7.0-9.0-4.0-6.0-8.0-5.0-2.0-7.0-9.0-4.0-2.1-5.0-2.0-1.0	154	213414	214725
HG03453#1#JAGYVW010000157.1_2105722_2585000_1	HG03453	215942	231136	4	84	0	4	83	15194	226602	211408	0-3-7-9-4-6-8-5-2-7-9-4-6-8-5-2-7-9-4-2-5-2-1	0.0-3.0-7.0-9.0-4.0-6.0-8.0-5.0-2.0-7.0-9.0-4.0-6.0-8.0-5.0-2.0-7.0-9.0-4.0-2.1-5.0-2.0-1.0	154	215788	230982
HG03453#1#JAGYVW010000157.1_2105722_2585000_1	HG03453	231080	233895	6	12	0	0	11	2815	229417	226602	0-3-7-9-4-6-8-5-2-7-9-4-6-8-5-2-7-9-4-2-5-2-1	0.0-3.0-7.0-9.0-4.0-6.0-8.0-5.0-2.0-7.0-9.0-4.0-6.0-8.0-5.0-2.0-7.0-9.0-4.0-2.1-5.0-2.0-1.0	154	230926	233741
HG03453#1#JAGYVW010000157.1_2105722_2585000_1	HG03453	233839	235609	8	8	0	0	7	1770	231187	229417	0-3-7-9-4-6-8-5-2-7-9-4-6-8-5-2-7-9-4-2-5-2-1	0.0-3.0-7.0-9.0-4.0-6.0-8.0-5.0-2.0-7.0-9.0-4.0-6.0-8.0-5.0-2.0-7.0-9.0-4.0-2.1-5.0-2.0-1.0	154	233685	235455
HG03453#1#JAGYVW010000157.1_2105722_2585000_1	HG03453	235553	248217	5	79	0	0	77	12664	243851	231187	0-3-7-9-4-6-8-5-2-7-9-4-6-8-5-2-7-9-4-2-5-2-1	0.0-3.0-7.0-9.0-4.0-6.0-8.0-5.0-2.0-7.0-9.0-4.0-6.0-8.0-5.0-2.0-7.0-9.0-4.0-2.1-5.0-2.0-1.0	154	235399	248063
HG03453#1#JAGYVW010000157.1_2105722_2585000_1	HG03453	248824	282930	2	196	0	1	195	34106	277957	243851	0-3-7-9-4-6-8-5-2-7-9-4-6-8-5-2-7-9-4-2-5-2-1	0.0-3.0-7.0-9.0-4.0-6.0-8.0-5.0-2.0-7.0-9.0-4.0-6.0-8.0-5.0-2.0-7.0-9.0-4.0-2.1-5.0-2.0-1.0	154	248670	282776
HG03453#1#JAGYVW010000157.1_2105722_2585000_1	HG03453	284007	286047	7	12	0	0	11	2040	279997	277957	0-3-7-9-4-6-8-5-2-7-9-4-6-8-5-2-7-9-4-2-5-2-1	0.0-3.0-7.0-9.0-4.0-6.0-8.0-5.0-2.0-7.0-9.0-4.0-6.0-8.0-5.0-2.0-7.0-9.0-4.0-2.1-5.0-2.0-1.0	154	283853	285893
HG03453#1#JAGYVW010000157.1_2105722_2585000_1	HG03453	285991	287302	9	5	0	0	4	1311	281308	279997	0-3-7-9-4-6-8-5-2-7-9-4-6-8-5-2-7-9-4-2-5-2-1	0.0-3.0-7.0-9.0-4.0-6.0-8.0-5.0-2.0-7.0-9.0-4.0-6.0-8.0-5.0-2.0-7.0-9.0-4.0-2.1-5.0-2.0-1.0	154	285837	287148
HG03453#1#JAGYVW010000157.1_2105722_2585000_1	HG03453	288365	299910	4	84	0	4	58	11545	292853	281308	0-3-7-9-4-6-8-5-2-7-9-4-6-8-5-2-7-9-4-2-5-2-1	0.0-3.0-7.0-9.0-4.0-6.0-8.0-5.0-2.0-7.0-9.0-4.0-6.0-8.0-5.0-2.0-7.0-9.0-4.0-2.1-5.0-2.0-1.0	154	288211	299756
HG03453#1#JAGYVW010000157.1_2105722_2585000_1	HG03453	302161	329697	2	196	1	194	39	27536	320389	292853	0-3-7-9-4-6-8-5-2-7-9-4-6-8-5-2-7-9-4-2-5-2-1	0.0-3.0-7.0-9.0-4.0-6.0-8.0-5.0-2.0-7.0-9.0-4.0-6.0-8.0-5.0-2.0-7.0-9.0-4.0-2.1-5.0-2.0-1.0	154	302007	329543
HG03453#1#JAGYVW010000157.1_2105722_2585000_1	HG03453	330136	342351	5	79	0	3	77	12215	332604	320389	0-3-7-9-4-6-8-5-2-7-9-4-6-8-5-2-7-9-4-2-5-2-1	0.0-3.0-7.0-9.0-4.0-6.0-8.0-5.0-2.0-7.0-9.0-4.0-6.0-8.0-5.0-2.0-7.0-9.0-4.0-2.1-5.0-2.0-1.0	154	329982	342197
HG03453#1#JAGYVW010000157.1_2105722_2585000_1	HG03453	342958	377061	2	196	0	1	195	34103	366707	332604	0-3-7-9-4-6-8-5-2-7-9-4-6-8-5-2-7-9-4-2-5-2-1	0.0-3.0-7.0-9.0-4.0-6.0-8.0-5.0-2.0-7.0-9.0-4.0-6.0-8.0-5.0-2.0-7.0-9.0-4.0-2.1-5.0-2.0-1.0	154	342804	376907
HG03453#1#JAGYVW010000157.1_2105722_2585000_1	HG03453	377005	479216	1	612	0	0	605	102211	468918	366707	0-3-7-9-4-6-8-5-2-7-9-4-6-8-5-2-7-9-4-2-5-2-1	0.0-3.0-7.0-9.0-4.0-6.0-8.0-5.0-2.0-7.0-9.0-4.0-6.0-8.0-5.0-2.0-7.0-9.0-4.0-2.1-5.0-2.0-1.0	154	376851	479062
HG03453#2#JAGYVV010000088.1_22597550_23005370_1	HG03453	154	115518	0	672	0	0	671	115364	115364	0	0-3-7-9-4-6-8-5-2-7-9-4-2-5-2-1	0.0-3.0-7.0-9.0-4.0-6.0-8.0-5.0-2.0-7.0-9.0-4.0-2.1-5.1-2.0-1.0	154	0	115364
HG03453#2#JAGYVV010000088.1_22597550_23005370_1	HG03453	115609	138443	3	132	0	0	131	22834	138198	115364	0-3-7-9-4-6-8-5-2-7-9-4-2-5-2-1	0.0-3.0-7.0-9.0-4.0-6.0-8.0-5.0-2.0-7.0-9.0-4.0-2.1-5.1-2.0-1.0	154	115455	138289
HG03453#2#JAGYVV010000088.1_22597550_23005370_1	HG03453	139202	141242	7	12	0	0	11	2040	140238	138198	0-3-7-9-4-6-8-5-2-7-9-4-2-5-2-1	0.0-3.0-7.0-9.0-4.0-6.0-8.0-5.0-2.0-7.0-9.0-4.0-2.1-5.1-2.0-1.0	154	139048	141088
HG03453#2#JAGYVV010000088.1_22597550_23005370_1	HG03453	141186	142498	9	5	0	0	4	1312	141550	140238	0-3-7-9-4-6-8-5-2-7-9-4-2-5-2-1	0.0-3.0-7.0-9.0-4.0-6.0-8.0-5.0-2.0-7.0-9.0-4.0-2.1-5.1-2.0-1.0	154	141032	142344
HG03453#2#JAGYVV010000088.1_22597550_23005370_1	HG03453	142946	158741	4	84	0	0	83	15795	157345	141550	0-3-7-9-4-6-8-5-2-7-9-4-2-5-2-1	0.0-3.0-7.0-9.0-4.0-6.0-8.0-5.0-2.0-7.0-9.0-4.0-2.1-5.1-2.0-1.0	154	142792	158587
HG03453#2#JAGYVV010000088.1_22597550_23005370_1	HG03453	158685	161501	6	12	0	0	11	2816	160161	157345	0-3-7-9-4-6-8-5-2-7-9-4-2-5-2-1	0.0-3.0-7.0-9.0-4.0-6.0-8.0-5.0-2.0-7.0-9.0-4.0-2.1-5.1-2.0-1.0	154	158531	161347
HG03453#2#JAGYVV010000088.1_22597550_23005370_1	HG03453	161445	163215	8	8	0	0	7	1770	161931	160161	0-3-7-9-4-6-8-5-2-7-9-4-2-5-2-1	0.0-3.0-7.0-9.0-4.0-6.0-8.0-5.0-2.0-7.0-9.0-4.0-2.1-5.1-2.0-1.0	154	161291	163061
HG03453#2#JAGYVV010000088.1_22597550_23005370_1	HG03453	163159	176263	5	79	0	0	78	13104	175035	161931	0-3-7-9-4-6-8-5-2-7-9-4-2-5-2-1	0.0-3.0-7.0-9.0-4.0-6.0-8.0-5.0-2.0-7.0-9.0-4.0-2.1-5.1-2.0-1.0	154	163005	176109
HG03453#2#JAGYVV010000088.1_22597550_23005370_1	HG03453	176207	210152	2	196	0	0	194	33945	208980	175035	0-3-7-9-4-6-8-5-2-7-9-4-2-5-2-1	0.0-3.0-7.0-9.0-4.0-6.0-8.0-5.0-2.0-7.0-9.0-4.0-2.1-5.1-2.0-1.0	154	176053	209998
HG03453#2#JAGYVV010000088.1_22597550_23005370_1	HG03453	211614	213654	7	12	0	0	11	2040	211020	208980	0-3-7-9-4-6-8-5-2-7-9-4-2-5-2-1	0.0-3.0-7.0-9.0-4.0-6.0-8.0-5.0-2.0-7.0-9.0-4.0-2.1-5.1-2.0-1.0	154	211460	213500
HG03453#2#JAGYVV010000088.1_22597550_23005370_1	HG03453	213598	214909	9	5	0	0	4	1311	212331	211020	0-3-7-9-4-6-8-5-2-7-9-4-2-5-2-1	0.0-3.0-7.0-9.0-4.0-6.0-8.0-5.0-2.0-7.0-9.0-4.0-2.1-5.1-2.0-1.0	154	213444	214755
HG03453#2#JAGYVV010000088.1_22597550_23005370_1	HG03453	215974	227522	4	84	0	4	58	11548	223879	212331	0-3-7-9-4-6-8-5-2-7-9-4-2-5-2-1	0.0-3.0-7.0-9.0-4.0-6.0-8.0-5.0-2.0-7.0-9.0-4.0-2.1-5.1-2.0-1.0	154	215820	227368
HG03453#2#JAGYVV010000088.1_22597550_23005370_1	HG03453	229773	263493	2	196	1	194	1	33720	257599	223879	0-3-7-9-4-6-8-5-2-7-9-4-2-5-2-1	0.0-3.0-7.0-9.0-4.0-6.0-8.0-5.0-2.0-7.0-9.0-4.0-2.1-5.1-2.0-1.0	154	229619	263339
HG03453#2#JAGYVV010000088.1_22597550_23005370_1	HG03453	264100	275788	5	79	1	77	5	11688	269287	257599	0-3-7-9-4-6-8-5-2-7-9-4-2-5-2-1	0.0-3.0-7.0-9.0-4.0-6.0-8.0-5.0-2.0-7.0-9.0-4.0-2.1-5.1-2.0-1.0	154	263946	275634
HG03453#2#JAGYVV010000088.1_22597550_23005370_1	HG03453	276754	304665	2	196	0	39	195	27911	297198	269287	0-3-7-9-4-6-8-5-2-7-9-4-2-5-2-1	0.0-3.0-7.0-9.0-4.0-6.0-8.0-5.0-2.0-7.0-9.0-4.0-2.1-5.1-2.0-1.0	154	276600	304511
HG03453#2#JAGYVV010000088.1_22597550_23005370_1	HG03453	304609	407804	1	612	0	0	611	103195	400393	297198	0-3-7-9-4-6-8-5-2-7-9-4-2-5-2-1	0.0-3.0-7.0-9.0-4.0-6.0-8.0-5.0-2.0-7.0-9.0-4.0-2.1-5.1-2.0-1.0	154	304455	407650
HG03486#1#JAHEOQ010000123.1_16677696_17085575_0	HG03486	99	115494	0	672	0	0	671	115395	115395	0	0-3-7-9-4-6-8-5-2-4-9-7-2-5-2-1	0.0-3.0-7.0-9.0-4.0-6.0-8.0-5.0-2.0-4.1-9.1-7.1-2.1-5.0-2.0-1.0	99	0	115395
HG03486#1#JAHEOQ010000123.1_16677696_17085575_0	HG03486	115585	138420	3	132	0	0	131	22835	138230	115395	0-3-7-9-4-6-8-5-2-4-9-7-2-5-2-1	0.0-3.0-7.0-9.0-4.0-6.0-8.0-5.0-2.0-4.1-9.1-7.1-2.1-5.0-2.0-1.0	99	115486	138321
HG03486#1#JAHEOQ010000123.1_16677696_17085575_0	HG03486	139179	141219	7	12	0	0	11	2040	140270	138230	0-3-7-9-4-6-8-5-2-4-9-7-2-5-2-1	0.0-3.0-7.0-9.0-4.0-6.0-8.0-5.0-2.0-4.1-9.1-7.1-2.1-5.0-2.0-1.0	99	139080	141120
HG03486#1#JAHEOQ010000123.1_16677696_17085575_0	HG03486	141163	142475	9	5	0	0	4	1312	141582	140270	0-3-7-9-4-6-8-5-2-4-9-7-2-5-2-1	0.0-3.0-7.0-9.0-4.0-6.0-8.0-5.0-2.0-4.1-9.1-7.1-2.1-5.0-2.0-1.0	99	141064	142376
HG03486#1#JAHEOQ010000123.1_16677696_17085575_0	HG03486	142923	158716	4	84	0	0	83	15793	157375	141582	0-3-7-9-4-6-8-5-2-4-9-7-2-5-2-1	0.0-3.0-7.0-9.0-4.0-6.0-8.0-5.0-2.0-4.1-9.1-7.1-2.1-5.0-2.0-1.0	99	142824	158617
HG03486#1#JAHEOQ010000123.1_16677696_17085575_0	HG03486	158660	161476	6	12	0	0	11	2816	160191	157375	0-3-7-9-4-6-8-5-2-4-9-7-2-5-2-1	0.0-3.0-7.0-9.0-4.0-6.0-8.0-5.0-2.0-4.1-9.1-7.1-2.1-5.0-2.0-1.0	99	158561	161377
HG03486#1#JAHEOQ010000123.1_16677696_17085575_0	HG03486	161420	163190	8	8	0	0	7	1770	161961	160191	0-3-7-9-4-6-8-5-2-4-9-7-2-5-2-1	0.0-3.0-7.0-9.0-4.0-6.0-8.0-5.0-2.0-4.1-9.1-7.1-2.1-5.0-2.0-1.0	99	161321	163091
HG03486#1#JAHEOQ010000123.1_16677696_17085575_0	HG03486	163134	176238	5	79	0	0	78	13104	175065	161961	0-3-7-9-4-6-8-5-2-4-9-7-2-5-2-1	0.0-3.0-7.0-9.0-4.0-6.0-8.0-5.0-2.0-4.1-9.1-7.1-2.1-5.0-2.0-1.0	99	163035	176139
HG03486#1#JAHEOQ010000123.1_16677696_17085575_0	HG03486	176182	209778	2	196	0	0	191	33596	208661	175065	0-3-7-9-4-6-8-5-2-4-9-7-2-5-2-1	0.0-3.0-7.0-9.0-4.0-6.0-8.0-5.0-2.0-4.1-9.1-7.1-2.1-5.0-2.0-1.0	99	176083	209679
HG03486#1#JAHEOQ010000123.1_16677696_17085575_0	HG03486	212370	223915	4	84	1	58	4	11545	220206	208661	0-3-7-9-4-6-8-5-2-4-9-7-2-5-2-1	0.0-3.0-7.0-9.0-4.0-6.0-8.0-5.0-2.0-4.1-9.1-7.1-2.1-5.0-2.0-1.0	99	212271	223816
HG03486#1#JAHEOQ010000123.1_16677696_17085575_0	HG03486	224982	226293	9	5	1	4	0	1311	221517	220206	0-3-7-9-4-6-8-5-2-4-9-7-2-5-2-1	0.0-3.0-7.0-9.0-4.0-6.0-8.0-5.0-2.0-4.1-9.1-7.1-2.1-5.0-2.0-1.0	99	224883	226194
HG03486#1#JAHEOQ010000123.1_16677696_17085575_0	HG03486	226237	228277	7	12	1	11	0	2040	223557	221517	0-3-7-9-4-6-8-5-2-4-9-7-2-5-2-1	0.0-3.0-7.0-9.0-4.0-6.0-8.0-5.0-2.0-4.1-9.1-7.1-2.1-5.0-2.0-1.0	99	226138	228178
HG03486#1#JAHEOQ010000123.1_16677696_17085575_0	HG03486	229739	257267	2	196	1	194	39	27528	251085	223557	0-3-7-9-4-6-8-5-2-4-9-7-2-5-2-1	0.0-3.0-7.0-9.0-4.0-6.0-8.0-5.0-2.0-4.1-9.1-7.1-2.1-5.0-2.0-1.0	99	229640	257168
HG03486#1#JAHEOQ010000123.1_16677696_17085575_0	HG03486	258233	269921	5	79	0	5	77	11688	262773	251085	0-3-7-9-4-6-8-5-2-4-9-7-2-5-2-1	0.0-3.0-7.0-9.0-4.0-6.0-8.0-5.0-2.0-4.1-9.1-7.1-2.1-5.0-2.0-1.0	99	258134	269822
HG03486#1#JAHEOQ010000123.1_16677696_17085575_0	HG03486	270528	304631	2	196	0	1	195	34103	296876	262773	0-3-7-9-4-6-8-5-2-4-9-7-2-5-2-1	0.0-3.0-7.0-9.0-4.0-6.0-8.0-5.0-2.0-4.1-9.1-7.1-2.1-5.0-2.0-1.0	99	270429	304532
HG03486#1#JAHEOQ010000123.1_16677696_17085575_0	HG03486	304575	407807	1	612	0	0	611	103232	400108	296876	0-3-7-9-4-6-8-5-2-4-9-7-2-5-2-1	0.0-3.0-7.0-9.0-4.0-6.0-8.0-5.0-2.0-4.1-9.1-7.1-2.1-5.0-2.0-1.0	99	304476	407708
HG03486#2#JAHEOP010000248.1_2105565_2584784_1	HG03486	154	115473	0	672	0	0	671	115319	115319	0	0-3-7-9-4-6-8-5-2-7-9-4-6-8-5-2-7-9-4-2-5-2-1	0.0-3.0-7.0-9.0-4.0-6.0-8.0-5.0-2.0-7.0-9.0-4.0-6.0-8.0-5.0-2.0-7.0-9.0-4.0-2.1-5.1-2.0-1.0	154	0	115319
HG03486#2#JAHEOP010000248.1_2105565_2584784_1	HG03486	115564	138393	3	132	0	0	131	22829	138148	115319	0-3-7-9-4-6-8-5-2-7-9-4-6-8-5-2-7-9-4-2-5-2-1	0.0-3.0-7.0-9.0-4.0-6.0-8.0-5.0-2.0-7.0-9.0-4.0-6.0-8.0-5.0-2.0-7.0-9.0-4.0-2.1-5.1-2.0-1.0	154	115410	138239
HG03486#2#JAHEOP010000248.1_2105565_2584784_1	HG03486	139152	141192	7	12	0	0	11	2040	140188	138148	0-3-7-9-4-6-8-5-2-7-9-4-6-8-5-2-7-9-4-2-5-2-1	0.0-3.0-7.0-9.0-4.0-6.0-8.0-5.0-2.0-7.0-9.0-4.0-6.0-8.0-5.0-2.0-7.0-9.0-4.0-2.1-5.1-2.0-1.0	154	138998	141038
HG03486#2#JAHEOP010000248.1_2105565_2584784_1	HG03486	141136	142447	9	5	0	0	4	1311	141499	140188	0-3-7-9-4-6-8-5-2-7-9-4-6-8-5-2-7-9-4-2-5-2-1	0.0-3.0-7.0-9.0-4.0-6.0-8.0-5.0-2.0-7.0-9.0-4.0-6.0-8.0-5.0-2.0-7.0-9.0-4.0-2.1-5.1-2.0-1.0	154	140982	142293
HG03486#2#JAHEOP010000248.1_2105565_2584784_1	HG03486	142895	158703	4	84	0	0	83	15808	157307	141499	0-3-7-9-4-6-8-5-2-7-9-4-6-8-5-2-7-9-4-2-5-2-1	0.0-3.0-7.0-9.0-4.0-6.0-8.0-5.0-2.0-7.0-9.0-4.0-6.0-8.0-5.0-2.0-7.0-9.0-4.0-2.1-5.1-2.0-1.0	154	142741	158549
HG03486#2#JAHEOP010000248.1_2105565_2584784_1	HG03486	158647	161462	6	12	0	0	11	2815	160122	157307	0-3-7-9-4-6-8-5-2-7-9-4-6-8-5-2-7-9-4-2-5-2-1	0.0-3.0-7.0-9.0-4.0-6.0-8.0-5.0-2.0-7.0-9.0-4.0-6.0-8.0-5.0-2.0-7.0-9.0-4.0-2.1-5.1-2.0-1.0	154	158493	161308
HG03486#2#JAHEOP010000248.1_2105565_2584784_1	HG03486	161406	163176	8	8	0	0	7	1770	161892	160122	0-3-7-9-4-6-8-5-2-7-9-4-6-8-5-2-7-9-4-2-5-2-1	0.0-3.0-7.0-9.0-4.0-6.0-8.0-5.0-2.0-7.0-9.0-4.0-6.0-8.0-5.0-2.0-7.0-9.0-4.0-2.1-5.1-2.0-1.0	154	161252	163022
HG03486#2#JAHEOP010000248.1_2105565_2584784_1	HG03486	163120	176224	5	79	0	0	78	13104	174996	161892	0-3-7-9-4-6-8-5-2-7-9-4-6-8-5-2-7-9-4-2-5-2-1	0.0-3.0-7.0-9.0-4.0-6.0-8.0-5.0-2.0-7.0-9.0-4.0-6.0-8.0-5.0-2.0-7.0-9.0-4.0-2.1-5.1-2.0-1.0	154	162966	176070
HG03486#2#JAHEOP010000248.1_2105565_2584784_1	HG03486	176168	210493	2	196	0	0	195	34325	209321	174996	0-3-7-9-4-6-8-5-2-7-9-4-6-8-5-2-7-9-4-2-5-2-1	0.0-3.0-7.0-9.0-4.0-6.0-8.0-5.0-2.0-7.0-9.0-4.0-6.0-8.0-5.0-2.0-7.0-9.0-4.0-2.1-5.1-2.0-1.0	154	176014	210339
HG03486#2#JAHEOP010000248.1_2105565_2584784_1	HG03486	211570	213610	7	12	0	0	11	2040	211361	209321	0-3-7-9-4-6-8-5-2-7-9-4-6-8-5-2-7-9-4-2-5-2-1	0.0-3.0-7.0-9.0-4.0-6.0-8.0-5.0-2.0-7.0-9.0-4.0-6.0-8.0-5.0-2.0-7.0-9.0-4.0-2.1-5.1-2.0-1.0	154	211416	213456
HG03486#2#JAHEOP010000248.1_2105565_2584784_1	HG03486	213554	214865	9	5	0	0	4	1311	212672	211361	0-3-7-9-4-6-8-5-2-7-9-4-6-8-5-2-7-9-4-2-5-2-1	0.0-3.0-7.0-9.0-4.0-6.0-8.0-5.0-2.0-7.0-9.0-4.0-6.0-8.0-5.0-2.0-7.0-9.0-4.0-2.1-5.1-2.0-1.0	154	213400	214711
HG03486#2#JAHEOP010000248.1_2105565_2584784_1	HG03486	215313	231121	4	84	0	0	83	15808	228480	212672	0-3-7-9-4-6-8-5-2-7-9-4-6-8-5-2-7-9-4-2-5-2-1	0.0-3.0-7.0-9.0-4.0-6.0-8.0-5.0-2.0-7.0-9.0-4.0-6.0-8.0-5.0-2.0-7.0-9.0-4.0-2.1-5.1-2.0-1.0	154	215159	230967
HG03486#2#JAHEOP010000248.1_2105565_2584784_1	HG03486	231065	233880	6	12	0	0	11	2815	231295	228480	0-3-7-9-4-6-8-5-2-7-9-4-6-8-5-2-7-9-4-2-5-2-1	0.0-3.0-7.0-9.0-4.0-6.0-8.0-5.0-2.0-7.0-9.0-4.0-6.0-8.0-5.0-2.0-7.0-9.0-4.0-2.1-5.1-2.0-1.0	154	230911	233726
HG03486#2#JAHEOP010000248.1_2105565_2584784_1	HG03486	233824	235594	8	8	0	0	7	1770	233065	231295	0-3-7-9-4-6-8-5-2-7-9-4-6-8-5-2-7-9-4-2-5-2-1	0.0-3.0-7.0-9.0-4.0-6.0-8.0-5.0-2.0-7.0-9.0-4.0-6.0-8.0-5.0-2.0-7.0-9.0-4.0-2.1-5.1-2.0-1.0	154	233670	235440
HG03486#2#JAHEOP010000248.1_2105565_2584784_1	HG03486	235538	248642	5	79	0	0	78	13104	246169	233065	0-3-7-9-4-6-8-5-2-7-9-4-6-8-5-2-7-9-4-2-5-2-1	0.0-3.0-7.0-9.0-4.0-6.0-8.0-5.0-2.0-7.0-9.0-4.0-6.0-8.0-5.0-2.0-7.0-9.0-4.0-2.1-5.1-2.0-1.0	154	235384	248488
HG03486#2#JAHEOP010000248.1_2105565_2584784_1	HG03486	248586	282903	2	196	0	0	195	34317	280486	246169	0-3-7-9-4-6-8-5-2-7-9-4-6-8-5-2-7-9-4-2-5-2-1	0.0-3.0-7.0-9.0-4.0-6.0-8.0-5.0-2.0-7.0-9.0-4.0-6.0-8.0-5.0-2.0-7.0-9.0-4.0-2.1-5.1-2.0-1.0	154	248432	282749
HG03486#2#JAHEOP010000248.1_2105565_2584784_1	HG03486	283980	286020	7	12	0	0	11	2040	282526	280486	0-3-7-9-4-6-8-5-2-7-9-4-6-8-5-2-7-9-4-2-5-2-1	0.0-3.0-7.0-9.0-4.0-6.0-8.0-5.0-2.0-7.0-9.0-4.0-6.0-8.0-5.0-2.0-7.0-9.0-4.0-2.1-5.1-2.0-1.0	154	283826	285866
HG03486#2#JAHEOP010000248.1_2105565_2584784_1	HG03486	285964	287275	9	5	0	0	4	1311	283837	282526	0-3-7-9-4-6-8-5-2-7-9-4-6-8-5-2-7-9-4-2-5-2-1	0.0-3.0-7.0-9.0-4.0-6.0-8.0-5.0-2.0-7.0-9.0-4.0-6.0-8.0-5.0-2.0-7.0-9.0-4.0-2.1-5.1-2.0-1.0	154	285810	287121
HG03486#2#JAHEOP010000248.1_2105565_2584784_1	HG03486	288338	299885	4	84	0	4	58	11547	295384	283837	0-3-7-9-4-6-8-5-2-7-9-4-6-8-5-2-7-9-4-2-5-2-1	0.0-3.0-7.0-9.0-4.0-6.0-8.0-5.0-2.0-7.0-9.0-4.0-6.0-8.0-5.0-2.0-7.0-9.0-4.0-2.1-5.1-2.0-1.0	154	288184	299731
HG03486#2#JAHEOP010000248.1_2105565_2584784_1	HG03486	301751	335850	2	196	1	195	1	34099	329483	295384	0-3-7-9-4-6-8-5-2-7-9-4-6-8-5-2-7-9-4-2-5-2-1	0.0-3.0-7.0-9.0-4.0-6.0-8.0-5.0-2.0-7.0-9.0-4.0-6.0-8.0-5.0-2.0-7.0-9.0-4.0-2.1-5.1-2.0-1.0	154	301597	335696
HG03486#2#JAHEOP010000248.1_2105565_2584784_1	HG03486	336457	348672	5	79	1	77	3	12215	341698	329483	0-3-7-9-4-6-8-5-2-7-9-4-6-8-5-2-7-9-4-2-5-2-1	0.0-3.0-7.0-9.0-4.0-6.0-8.0-5.0-2.0-7.0-9.0-4.0-6.0-8.0-5.0-2.0-7.0-9.0-4.0-2.1-5.1-2.0-1.0	154	336303	348518
HG03486#2#JAHEOP010000248.1_2105565_2584784_1	HG03486	349111	377019	2	196	0	39	195	27908	369606	341698	0-3-7-9-4-6-8-5-2-7-9-4-6-8-5-2-7-9-4-2-5-2-1	0.0-3.0-7.0-9.0-4.0-6.0-8.0-5.0-2.0-7.0-9.0-4.0-6.0-8.0-5.0-2.0-7.0-9.0-4.0-2.1-5.1-2.0-1.0	154	348957	376865
HG03486#2#JAHEOP010000248.1_2105565_2584784_1	HG03486	376963	479157	1	612	0	0	605	102194	471800	369606	0-3-7-9-4-6-8-5-2-7-9-4-6-8-5-2-7-9-4-2-5-2-1	0.0-3.0-7.0-9.0-4.0-6.0-8.0-5.0-2.0-7.0-9.0-4.0-6.0-8.0-5.0-2.0-7.0-9.0-4.0-2.1-5.1-2.0-1.0	154	376809	479003
HG03492#1#JAHEPI010000180.1_2103395_2543326_1	HG03492	154	115516	0	672	0	0	671	115362	115362	0	0-3-7-9-4-6-8-5-2-7-9-4-6-8-5-2-4-2-5-2-1	0.0-3.0-7.0-9.0-4.0-6.0-8.0-5.0-2.0-7.0-9.0-4.0-6.0-8.0-5.0-2.0-4.0-2.1-5.1-2.0-1.0	154	0	115362
HG03492#1#JAHEPI010000180.1_2103395_2543326_1	HG03492	115607	138441	3	132	0	0	131	22834	138196	115362	0-3-7-9-4-6-8-5-2-7-9-4-6-8-5-2-4-2-5-2-1	0.0-3.0-7.0-9.0-4.0-6.0-8.0-5.0-2.0-7.0-9.0-4.0-6.0-8.0-5.0-2.0-4.0-2.1-5.1-2.0-1.0	154	115453	138287
HG03492#1#JAHEPI010000180.1_2103395_2543326_1	HG03492	139200	141240	7	12	0	0	11	2040	140236	138196	0-3-7-9-4-6-8-5-2-7-9-4-6-8-5-2-4-2-5-2-1	0.0-3.0-7.0-9.0-4.0-6.0-8.0-5.0-2.0-7.0-9.0-4.0-6.0-8.0-5.0-2.0-4.0-2.1-5.1-2.0-1.0	154	139046	141086
HG03492#1#JAHEPI010000180.1_2103395_2543326_1	HG03492	141184	142496	9	5	0	0	4	1312	141548	140236	0-3-7-9-4-6-8-5-2-7-9-4-6-8-5-2-4-2-5-2-1	0.0-3.0-7.0-9.0-4.0-6.0-8.0-5.0-2.0-7.0-9.0-4.0-6.0-8.0-5.0-2.0-4.0-2.1-5.1-2.0-1.0	154	141030	142342
HG03492#1#JAHEPI010000180.1_2103395_2543326_1	HG03492	142944	158743	4	84	0	0	83	15799	157347	141548	0-3-7-9-4-6-8-5-2-7-9-4-6-8-5-2-4-2-5-2-1	0.0-3.0-7.0-9.0-4.0-6.0-8.0-5.0-2.0-7.0-9.0-4.0-6.0-8.0-5.0-2.0-4.0-2.1-5.1-2.0-1.0	154	142790	158589
HG03492#1#JAHEPI010000180.1_2103395_2543326_1	HG03492	158687	161502	6	12	0	0	11	2815	160162	157347	0-3-7-9-4-6-8-5-2-7-9-4-6-8-5-2-4-2-5-2-1	0.0-3.0-7.0-9.0-4.0-6.0-8.0-5.0-2.0-7.0-9.0-4.0-6.0-8.0-5.0-2.0-4.0-2.1-5.1-2.0-1.0	154	158533	161348
HG03492#1#JAHEPI010000180.1_2103395_2543326_1	HG03492	161446	163216	8	8	0	0	7	1770	161932	160162	0-3-7-9-4-6-8-5-2-7-9-4-6-8-5-2-4-2-5-2-1	0.0-3.0-7.0-9.0-4.0-6.0-8.0-5.0-2.0-7.0-9.0-4.0-6.0-8.0-5.0-2.0-4.0-2.1-5.1-2.0-1.0	154	161292	163062
HG03492#1#JAHEPI010000180.1_2103395_2543326_1	HG03492	163160	175824	5	79	0	0	77	12664	174596	161932	0-3-7-9-4-6-8-5-2-7-9-4-6-8-5-2-4-2-5-2-1	0.0-3.0-7.0-9.0-4.0-6.0-8.0-5.0-2.0-7.0-9.0-4.0-6.0-8.0-5.0-2.0-4.0-2.1-5.1-2.0-1.0	154	163006	175670
HG03492#1#JAHEPI010000180.1_2103395_2543326_1	HG03492	176434	210540	2	196	0	1	195	34106	208702	174596	0-3-7-9-4-6-8-5-2-7-9-4-6-8-5-2-4-2-5-2-1	0.0-3.0-7.0-9.0-4.0-6.0-8.0-5.0-2.0-7.0-9.0-4.0-6.0-8.0-5.0-2.0-4.0-2.1-5.1-2.0-1.0	154	176280	210386
HG03492#1#JAHEPI010000180.1_2103395_2543326_1	HG03492	211617	213657	7	12	0	0	11	2040	210742	208702	0-3-7-9-4-6-8-5-2-7-9-4-6-8-5-2-4-2-5-2-1	0.0-3.0-7.0-9.0-4.0-6.0-8.0-5.0-2.0-7.0-9.0-4.0-6.0-8.0-5.0-2.0-4.0-2.1-5.1-2.0-1.0	154	211463	213503
HG03492#1#JAHEPI010000180.1_2103395_2543326_1	HG03492	213601	214913	9	5	0	0	4	1312	212054	210742	0-3-7-9-4-6-8-5-2-7-9-4-6-8-5-2-4-2-5-2-1	0.0-3.0-7.0-9.0-4.0-6.0-8.0-5.0-2.0-7.0-9.0-4.0-6.0-8.0-5.0-2.0-4.0-2.1-5.1-2.0-1.0	154	213447	214759
HG03492#1#JAHEPI010000180.1_2103395_2543326_1	HG03492	215976	231164	4	84	0	4	83	15188	227242	212054	0-3-7-9-4-6-8-5-2-7-9-4-6-8-5-2-4-2-5-2-1	0.0-3.0-7.0-9.0-4.0-6.0-8.0-5.0-2.0-7.0-9.0-4.0-6.0-8.0-5.0-2.0-4.0-2.1-5.1-2.0-1.0	154	215822	231010
HG03492#1#JAHEPI010000180.1_2103395_2543326_1	HG03492	231108	233923	6	12	0	0	11	2815	230057	227242	0-3-7-9-4-6-8-5-2-7-9-4-6-8-5-2-4-2-5-2-1	0.0-3.0-7.0-9.0-4.0-6.0-8.0-5.0-2.0-7.0-9.0-4.0-6.0-8.0-5.0-2.0-4.0-2.1-5.1-2.0-1.0	154	230954	233769
HG03492#1#JAHEPI010000180.1_2103395_2543326_1	HG03492	233867	235637	8	8	0	0	7	1770	231827	230057	0-3-7-9-4-6-8-5-2-7-9-4-6-8-5-2-4-2-5-2-1	0.0-3.0-7.0-9.0-4.0-6.0-8.0-5.0-2.0-7.0-9.0-4.0-6.0-8.0-5.0-2.0-4.0-2.1-5.1-2.0-1.0	154	233713	235483
HG03492#1#JAHEPI010000180.1_2103395_2543326_1	HG03492	235581	248245	5	79	0	0	77	12664	244491	231827	0-3-7-9-4-6-8-5-2-7-9-4-6-8-5-2-4-2-5-2-1	0.0-3.0-7.0-9.0-4.0-6.0-8.0-5.0-2.0-7.0-9.0-4.0-6.0-8.0-5.0-2.0-4.0-2.1-5.1-2.0-1.0	154	235427	248091
HG03492#1#JAHEPI010000180.1_2103395_2543326_1	HG03492	248855	256956	2	196	0	1	49	8101	252592	244491	0-3-7-9-4-6-8-5-2-7-9-4-6-8-5-2-4-2-5-2-1	0.0-3.0-7.0-9.0-4.0-6.0-8.0-5.0-2.0-7.0-9.0-4.0-6.0-8.0-5.0-2.0-4.0-2.1-5.1-2.0-1.0	154	248701	256802
HG03492#1#JAHEPI010000180.1_2103395_2543326_1	HG03492	257179	259446	4	84	0	47	57	2267	254859	252592	0-3-7-9-4-6-8-5-2-7-9-4-6-8-5-2-4-2-5-2-1	0.0-3.0-7.0-9.0-4.0-6.0-8.0-5.0-2.0-7.0-9.0-4.0-6.0-8.0-5.0-2.0-4.0-2.1-5.1-2.0-1.0	154	257025	259292
HG03492#1#JAHEPI010000180.1_2103395_2543326_1	HG03492	261538	295643	2	196	1	195	1	34105	288964	254859	0-3-7-9-4-6-8-5-2-7-9-4-6-8-5-2-4-2-5-2-1	0.0-3.0-7.0-9.0-4.0-6.0-8.0-5.0-2.0-7.0-9.0-4.0-6.0-8.0-5.0-2.0-4.0-2.1-5.1-2.0-1.0	154	261384	295489
HG03492#1#JAHEPI010000180.1_2103395_2543326_1	HG03492	296250	308465	5	79	1	77	3	12215	301179	288964	0-3-7-9-4-6-8-5-2-7-9-4-6-8-5-2-4-2-5-2-1	0.0-3.0-7.0-9.0-4.0-6.0-8.0-5.0-2.0-7.0-9.0-4.0-6.0-8.0-5.0-2.0-4.0-2.1-5.1-2.0-1.0	154	296096	308311
HG03492#1#JAHEPI010000180.1_2103395_2543326_1	HG03492	308904	336818	2	196	0	39	195	27914	329093	301179	0-3-7-9-4-6-8-5-2-7-9-4-6-8-5-2-4-2-5-2-1	0.0-3.0-7.0-9.0-4.0-6.0-8.0-5.0-2.0-7.0-9.0-4.0-6.0-8.0-5.0-2.0-4.0-2.1-5.1-2.0-1.0	154	308750	336664
HG03492#1#JAHEPI010000180.1_2103395_2543326_1	HG03492	336762	439915	1	612	0	0	611	103153	432246	329093	0-3-7-9-4-6-8-5-2-7-9-4-6-8-5-2-4-2-5-2-1	0.0-3.0-7.0-9.0-4.0-6.0-8.0-5.0-2.0-7.0-9.0-4.0-6.0-8.0-5.0-2.0-4.0-2.1-5.1-2.0-1.0	154	336608	439761
HG03492#2#JAHEPH010000288.1_2098270_2432686_1	HG03492	154	115514	0	672	0	0	671	115360	115360	0	0-3-7-9-4-2-5-2-1	0.0-3.0-7.0-9.0-4.0-2.1-5.1-2.0-1.0	154	0	115360
HG03492#2#JAHEPH010000288.1_2098270_2432686_1	HG03492	115605	138440	3	132	0	0	131	22835	138195	115360	0-3-7-9-4-2-5-2-1	0.0-3.0-7.0-9.0-4.0-2.1-5.1-2.0-1.0	154	115451	138286
HG03492#2#JAHEPH010000288.1_2098270_2432686_1	HG03492	139199	141239	7	12	0	0	11	2040	140235	138195	0-3-7-9-4-2-5-2-1	0.0-3.0-7.0-9.0-4.0-2.1-5.1-2.0-1.0	154	139045	141085
HG03492#2#JAHEPH010000288.1_2098270_2432686_1	HG03492	141183	142495	9	5	0	0	4	1312	141547	140235	0-3-7-9-4-2-5-2-1	0.0-3.0-7.0-9.0-4.0-2.1-5.1-2.0-1.0	154	141029	142341
HG03492#2#JAHEPH010000288.1_2098270_2432686_1	HG03492	142943	155100	4	84	0	0	58	12157	153704	141547	0-3-7-9-4-2-5-2-1	0.0-3.0-7.0-9.0-4.0-2.1-5.1-2.0-1.0	154	142789	154946
HG03492#2#JAHEPH010000288.1_2098270_2432686_1	HG03492	156966	191072	2	196	1	195	1	34106	187810	153704	0-3-7-9-4-2-5-2-1	0.0-3.0-7.0-9.0-4.0-2.1-5.1-2.0-1.0	154	156812	190918
HG03492#2#JAHEPH010000288.1_2098270_2432686_1	HG03492	191679	203894	5	79	1	77	3	12215	200025	187810	0-3-7-9-4-2-5-2-1	0.0-3.0-7.0-9.0-4.0-2.1-5.1-2.0-1.0	154	191525	203740
HG03492#2#JAHEPH010000288.1_2098270_2432686_1	HG03492	204333	231862	2	196	0	39	194	27529	227554	200025	0-3-7-9-4-2-5-2-1	0.0-3.0-7.0-9.0-4.0-2.1-5.1-2.0-1.0	154	204179	231708
HG03492#2#JAHEPH010000288.1_2098270_2432686_1	HG03492	232286	334354	1	612	0	1	605	102068	329622	227554	0-3-7-9-4-2-5-2-1	0.0-3.0-7.0-9.0-4.0-2.1-5.1-2.0-1.0	154	232132	334200
HG03516#1#JAGYYT010000012.1_24170958_24578778_1	HG03516	154	115552	0	672	0	0	671	115398	115398	0	0-3-7-9-4-6-8-5-2-7-9-4-2-5-2-1	0.0-3.0-7.0-9.0-4.0-6.0-8.0-5.0-2.0-7.0-9.0-4.0-2.1-5.1-2.0-1.0	154	0	115398
HG03516#1#JAGYYT010000012.1_24170958_24578778_1	HG03516	115643	138474	3	132	0	0	131	22831	138229	115398	0-3-7-9-4-6-8-5-2-7-9-4-2-5-2-1	0.0-3.0-7.0-9.0-4.0-6.0-8.0-5.0-2.0-7.0-9.0-4.0-2.1-5.1-2.0-1.0	154	115489	138320
HG03516#1#JAGYYT010000012.1_24170958_24578778_1	HG03516	139233	141273	7	12	0	0	11	2040	140269	138229	0-3-7-9-4-6-8-5-2-7-9-4-2-5-2-1	0.0-3.0-7.0-9.0-4.0-6.0-8.0-5.0-2.0-7.0-9.0-4.0-2.1-5.1-2.0-1.0	154	139079	141119
HG03516#1#JAGYYT010000012.1_24170958_24578778_1	HG03516	141217	142528	9	5	0	0	4	1311	141580	140269	0-3-7-9-4-6-8-5-2-7-9-4-2-5-2-1	0.0-3.0-7.0-9.0-4.0-6.0-8.0-5.0-2.0-7.0-9.0-4.0-2.1-5.1-2.0-1.0	154	141063	142374
HG03516#1#JAGYYT010000012.1_24170958_24578778_1	HG03516	143319	158768	4	84	0	1	83	15449	157029	141580	0-3-7-9-4-6-8-5-2-7-9-4-2-5-2-1	0.0-3.0-7.0-9.0-4.0-6.0-8.0-5.0-2.0-7.0-9.0-4.0-2.1-5.1-2.0-1.0	154	143165	158614
HG03516#1#JAGYYT010000012.1_24170958_24578778_1	HG03516	158712	161527	6	12	0	0	11	2815	159844	157029	0-3-7-9-4-6-8-5-2-7-9-4-2-5-2-1	0.0-3.0-7.0-9.0-4.0-6.0-8.0-5.0-2.0-7.0-9.0-4.0-2.1-5.1-2.0-1.0	154	158558	161373
HG03516#1#JAGYYT010000012.1_24170958_24578778_1	HG03516	161471	163241	8	8	0	0	7	1770	161614	159844	0-3-7-9-4-6-8-5-2-7-9-4-2-5-2-1	0.0-3.0-7.0-9.0-4.0-6.0-8.0-5.0-2.0-7.0-9.0-4.0-2.1-5.1-2.0-1.0	154	161317	163087
HG03516#1#JAGYYT010000012.1_24170958_24578778_1	HG03516	163185	175849	5	79	0	0	77	12664	174278	161614	0-3-7-9-4-6-8-5-2-7-9-4-2-5-2-1	0.0-3.0-7.0-9.0-4.0-6.0-8.0-5.0-2.0-7.0-9.0-4.0-2.1-5.1-2.0-1.0	154	163031	175695
HG03516#1#JAGYYT010000012.1_24170958_24578778_1	HG03516	176233	210553	2	196	0	0	195	34320	208598	174278	0-3-7-9-4-6-8-5-2-7-9-4-2-5-2-1	0.0-3.0-7.0-9.0-4.0-6.0-8.0-5.0-2.0-7.0-9.0-4.0-2.1-5.1-2.0-1.0	154	176079	210399
HG03516#1#JAGYYT010000012.1_24170958_24578778_1	HG03516	211630	213670	7	12	0	0	11	2040	210638	208598	0-3-7-9-4-6-8-5-2-7-9-4-2-5-2-1	0.0-3.0-7.0-9.0-4.0-6.0-8.0-5.0-2.0-7.0-9.0-4.0-2.1-5.1-2.0-1.0	154	211476	213516
HG03516#1#JAGYYT010000012.1_24170958_24578778_1	HG03516	213614	214925	9	5	0	0	4	1311	211949	210638	0-3-7-9-4-6-8-5-2-7-9-4-2-5-2-1	0.0-3.0-7.0-9.0-4.0-6.0-8.0-5.0-2.0-7.0-9.0-4.0-2.1-5.1-2.0-1.0	154	213460	214771
HG03516#1#JAGYYT010000012.1_24170958_24578778_1	HG03516	215988	227531	4	84	0	4	58	11543	223492	211949	0-3-7-9-4-6-8-5-2-7-9-4-2-5-2-1	0.0-3.0-7.0-9.0-4.0-6.0-8.0-5.0-2.0-7.0-9.0-4.0-2.1-5.1-2.0-1.0	154	215834	227377
HG03516#1#JAGYYT010000012.1_24170958_24578778_1	HG03516	229397	263496	2	196	1	195	1	34099	257591	223492	0-3-7-9-4-6-8-5-2-7-9-4-2-5-2-1	0.0-3.0-7.0-9.0-4.0-6.0-8.0-5.0-2.0-7.0-9.0-4.0-2.1-5.1-2.0-1.0	154	229243	263342
HG03516#1#JAGYYT010000012.1_24170958_24578778_1	HG03516	264103	276318	5	79	1	77	3	12215	269806	257591	0-3-7-9-4-6-8-5-2-7-9-4-2-5-2-1	0.0-3.0-7.0-9.0-4.0-6.0-8.0-5.0-2.0-7.0-9.0-4.0-2.1-5.1-2.0-1.0	154	263949	276164
HG03516#1#JAGYYT010000012.1_24170958_24578778_1	HG03516	276757	304675	2	196	0	39	195	27918	297724	269806	0-3-7-9-4-6-8-5-2-7-9-4-2-5-2-1	0.0-3.0-7.0-9.0-4.0-6.0-8.0-5.0-2.0-7.0-9.0-4.0-2.1-5.1-2.0-1.0	154	276603	304521
HG03516#1#JAGYYT010000012.1_24170958_24578778_1	HG03516	304619	407804	1	612	0	0	611	103185	400909	297724	0-3-7-9-4-6-8-5-2-7-9-4-2-5-2-1	0.0-3.0-7.0-9.0-4.0-6.0-8.0-5.0-2.0-7.0-9.0-4.0-2.1-5.1-2.0-1.0	154	304465	407650
HG03516#2#JAGYYS010000004.1_24452130_24859892_1	HG03516	154	115524	0	672	0	0	671	115370	115370	0	0-3-7-9-4-6-8-5-2-4-9-7-2-5-2-1	0.0-3.0-7.0-9.0-4.0-6.0-8.0-5.0-2.0-4.1-9.1-7.1-2.1-5.1-2.0-1.0	154	0	115370
HG03516#2#JAGYYS010000004.1_24452130_24859892_1	HG03516	115615	138449	3	132	0	0	131	22834	138204	115370	0-3-7-9-4-6-8-5-2-4-9-7-2-5-2-1	0.0-3.0-7.0-9.0-4.0-6.0-8.0-5.0-2.0-4.1-9.1-7.1-2.1-5.1-2.0-1.0	154	115461	138295
HG03516#2#JAGYYS010000004.1_24452130_24859892_1	HG03516	139208	141248	7	12	0	0	11	2040	140244	138204	0-3-7-9-4-6-8-5-2-4-9-7-2-5-2-1	0.0-3.0-7.0-9.0-4.0-6.0-8.0-5.0-2.0-4.1-9.1-7.1-2.1-5.1-2.0-1.0	154	139054	141094
HG03516#2#JAGYYS010000004.1_24452130_24859892_1	HG03516	141192	142503	9	5	0	0	4	1311	141555	140244	0-3-7-9-4-6-8-5-2-4-9-7-2-5-2-1	0.0-3.0-7.0-9.0-4.0-6.0-8.0-5.0-2.0-4.1-9.1-7.1-2.1-5.1-2.0-1.0	154	141038	142349
HG03516#2#JAGYYS010000004.1_24452130_24859892_1	HG03516	142951	158751	4	84	0	0	83	15800	157355	141555	0-3-7-9-4-6-8-5-2-4-9-7-2-5-2-1	0.0-3.0-7.0-9.0-4.0-6.0-8.0-5.0-2.0-4.1-9.1-7.1-2.1-5.1-2.0-1.0	154	142797	158597
HG03516#2#JAGYYS010000004.1_24452130_24859892_1	HG03516	158695	161510	6	12	0	0	11	2815	160170	157355	0-3-7-9-4-6-8-5-2-4-9-7-2-5-2-1	0.0-3.0-7.0-9.0-4.0-6.0-8.0-5.0-2.0-4.1-9.1-7.1-2.1-5.1-2.0-1.0	154	158541	161356
HG03516#2#JAGYYS010000004.1_24452130_24859892_1	HG03516	161454	163224	8	8	0	0	7	1770	161940	160170	0-3-7-9-4-6-8-5-2-4-9-7-2-5-2-1	0.0-3.0-7.0-9.0-4.0-6.0-8.0-5.0-2.0-4.1-9.1-7.1-2.1-5.1-2.0-1.0	154	161300	163070
HG03516#2#JAGYYS010000004.1_24452130_24859892_1	HG03516	163168	175358	5	79	0	0	75	12190	174130	161940	0-3-7-9-4-6-8-5-2-4-9-7-2-5-2-1	0.0-3.0-7.0-9.0-4.0-6.0-8.0-5.0-2.0-4.1-9.1-7.1-2.1-5.1-2.0-1.0	154	163014	175204
HG03516#2#JAGYYS010000004.1_24452130_24859892_1	HG03516	176439	210545	2	196	0	1	195	34106	208236	174130	0-3-7-9-4-6-8-5-2-4-9-7-2-5-2-1	0.0-3.0-7.0-9.0-4.0-6.0-8.0-5.0-2.0-4.1-9.1-7.1-2.1-5.1-2.0-1.0	154	176285	210391
HG03516#2#JAGYYS010000004.1_24452130_24859892_1	HG03516	212411	223532	4	84	1	58	6	11121	219357	208236	0-3-7-9-4-6-8-5-2-4-9-7-2-5-2-1	0.0-3.0-7.0-9.0-4.0-6.0-8.0-5.0-2.0-4.1-9.1-7.1-2.1-5.1-2.0-1.0	154	212257	223378
HG03516#2#JAGYYS010000004.1_24452130_24859892_1	HG03516	225019	226330	9	5	1	4	0	1311	220668	219357	0-3-7-9-4-6-8-5-2-4-9-7-2-5-2-1	0.0-3.0-7.0-9.0-4.0-6.0-8.0-5.0-2.0-4.1-9.1-7.1-2.1-5.1-2.0-1.0	154	224865	226176
HG03516#2#JAGYYS010000004.1_24452130_24859892_1	HG03516	226274	228314	7	12	1	11	0	2040	222708	220668	0-3-7-9-4-6-8-5-2-4-9-7-2-5-2-1	0.0-3.0-7.0-9.0-4.0-6.0-8.0-5.0-2.0-4.1-9.1-7.1-2.1-5.1-2.0-1.0	154	226120	228160
HG03516#2#JAGYYS010000004.1_24452130_24859892_1	HG03516	229776	263497	2	196	1	194	1	33721	256429	222708	0-3-7-9-4-6-8-5-2-4-9-7-2-5-2-1	0.0-3.0-7.0-9.0-4.0-6.0-8.0-5.0-2.0-4.1-9.1-7.1-2.1-5.1-2.0-1.0	154	229622	263343
HG03516#2#JAGYYS010000004.1_24452130_24859892_1	HG03516	264578	276318	5	79	1	75	3	11740	268169	256429	0-3-7-9-4-6-8-5-2-4-9-7-2-5-2-1	0.0-3.0-7.0-9.0-4.0-6.0-8.0-5.0-2.0-4.1-9.1-7.1-2.1-5.1-2.0-1.0	154	264424	276164
HG03516#2#JAGYYS010000004.1_24452130_24859892_1	HG03516	276757	304666	2	196	0	39	195	27909	296078	268169	0-3-7-9-4-6-8-5-2-4-9-7-2-5-2-1	0.0-3.0-7.0-9.0-4.0-6.0-8.0-5.0-2.0-4.1-9.1-7.1-2.1-5.1-2.0-1.0	154	276603	304512
HG03516#2#JAGYYS010000004.1_24452130_24859892_1	HG03516	304610	407746	1	612	0	0	611	103136	399214	296078	0-3-7-9-4-6-8-5-2-4-9-7-2-5-2-1	0.0-3.0-7.0-9.0-4.0-6.0-8.0-5.0-2.0-4.1-9.1-7.1-2.1-5.1-2.0-1.0	154	304456	407592
HG03540#1#JAGYVY010000208.1_95187_596142_0	HG03540	98	115434	0	672	0	0	671	115336	115336	0	0-3-7-9-4-6-8-5-2-4-9-7-2-5-2-4-9-7-2-5-2-1	0.0-3.0-7.0-9.0-4.0-6.0-8.0-5.0-2.0-4.1-9.1-7.1-2.1-5.0-2.0-4.1-9.1-7.1-2.1-5.1-2.0-1.0	98	0	115336
HG03540#1#JAGYVY010000208.1_95187_596142_0	HG03540	115525	138360	3	132	0	0	131	22835	138171	115336	0-3-7-9-4-6-8-5-2-4-9-7-2-5-2-4-9-7-2-5-2-1	0.0-3.0-7.0-9.0-4.0-6.0-8.0-5.0-2.0-4.1-9.1-7.1-2.1-5.0-2.0-4.1-9.1-7.1-2.1-5.1-2.0-1.0	98	115427	138262
HG03540#1#JAGYVY010000208.1_95187_596142_0	HG03540	139119	141159	7	12	0	0	11	2040	140211	138171	0-3-7-9-4-6-8-5-2-4-9-7-2-5-2-4-9-7-2-5-2-1	0.0-3.0-7.0-9.0-4.0-6.0-8.0-5.0-2.0-4.1-9.1-7.1-2.1-5.0-2.0-4.1-9.1-7.1-2.1-5.1-2.0-1.0	98	139021	141061
HG03540#1#JAGYVY010000208.1_95187_596142_0	HG03540	141103	142414	9	5	0	0	4	1311	141522	140211	0-3-7-9-4-6-8-5-2-4-9-7-2-5-2-4-9-7-2-5-2-1	0.0-3.0-7.0-9.0-4.0-6.0-8.0-5.0-2.0-4.1-9.1-7.1-2.1-5.0-2.0-4.1-9.1-7.1-2.1-5.1-2.0-1.0	98	141005	142316
HG03540#1#JAGYVY010000208.1_95187_596142_0	HG03540	142862	158663	4	84	0	0	83	15801	157323	141522	0-3-7-9-4-6-8-5-2-4-9-7-2-5-2-4-9-7-2-5-2-1	0.0-3.0-7.0-9.0-4.0-6.0-8.0-5.0-2.0-4.1-9.1-7.1-2.1-5.0-2.0-4.1-9.1-7.1-2.1-5.1-2.0-1.0	98	142764	158565
HG03540#1#JAGYVY010000208.1_95187_596142_0	HG03540	158607	161422	6	12	0	0	11	2815	160138	157323	0-3-7-9-4-6-8-5-2-4-9-7-2-5-2-4-9-7-2-5-2-1	0.0-3.0-7.0-9.0-4.0-6.0-8.0-5.0-2.0-4.1-9.1-7.1-2.1-5.0-2.0-4.1-9.1-7.1-2.1-5.1-2.0-1.0	98	158509	161324
HG03540#1#JAGYVY010000208.1_95187_596142_0	HG03540	161366	163136	8	8	0	0	7	1770	161908	160138	0-3-7-9-4-6-8-5-2-4-9-7-2-5-2-4-9-7-2-5-2-1	0.0-3.0-7.0-9.0-4.0-6.0-8.0-5.0-2.0-4.1-9.1-7.1-2.1-5.0-2.0-4.1-9.1-7.1-2.1-5.1-2.0-1.0	98	161268	163038
HG03540#1#JAGYVY010000208.1_95187_596142_0	HG03540	163080	175270	5	79	0	0	75	12190	174098	161908	0-3-7-9-4-6-8-5-2-4-9-7-2-5-2-4-9-7-2-5-2-1	0.0-3.0-7.0-9.0-4.0-6.0-8.0-5.0-2.0-4.1-9.1-7.1-2.1-5.0-2.0-4.1-9.1-7.1-2.1-5.1-2.0-1.0	98	162982	175172
HG03540#1#JAGYVY010000208.1_95187_596142_0	HG03540	176351	210462	2	196	0	1	195	34111	208209	174098	0-3-7-9-4-6-8-5-2-4-9-7-2-5-2-4-9-7-2-5-2-1	0.0-3.0-7.0-9.0-4.0-6.0-8.0-5.0-2.0-4.1-9.1-7.1-2.1-5.0-2.0-4.1-9.1-7.1-2.1-5.1-2.0-1.0	98	176253	210364
HG03540#1#JAGYVY010000208.1_95187_596142_0	HG03540	212328	223874	4	84	1	58	4	11546	219755	208209	0-3-7-9-4-6-8-5-2-4-9-7-2-5-2-4-9-7-2-5-2-1	0.0-3.0-7.0-9.0-4.0-6.0-8.0-5.0-2.0-4.1-9.1-7.1-2.1-5.0-2.0-4.1-9.1-7.1-2.1-5.1-2.0-1.0	98	212230	223776
HG03540#1#JAGYVY010000208.1_95187_596142_0	HG03540	224939	226250	9	5	1	4	0	1311	221066	219755	0-3-7-9-4-6-8-5-2-4-9-7-2-5-2-4-9-7-2-5-2-1	0.0-3.0-7.0-9.0-4.0-6.0-8.0-5.0-2.0-4.1-9.1-7.1-2.1-5.0-2.0-4.1-9.1-7.1-2.1-5.1-2.0-1.0	98	224841	226152
HG03540#1#JAGYVY010000208.1_95187_596142_0	HG03540	226194	228234	7	12	1	11	0	2040	223106	221066	0-3-7-9-4-6-8-5-2-4-9-7-2-5-2-4-9-7-2-5-2-1	0.0-3.0-7.0-9.0-4.0-6.0-8.0-5.0-2.0-4.1-9.1-7.1-2.1-5.0-2.0-4.1-9.1-7.1-2.1-5.1-2.0-1.0	98	226096	228136
HG03540#1#JAGYVY010000208.1_95187_596142_0	HG03540	229311	257232	2	196	1	195	39	27921	251027	223106	0-3-7-9-4-6-8-5-2-4-9-7-2-5-2-4-9-7-2-5-2-1	0.0-3.0-7.0-9.0-4.0-6.0-8.0-5.0-2.0-4.1-9.1-7.1-2.1-5.0-2.0-4.1-9.1-7.1-2.1-5.1-2.0-1.0	98	229213	257134
HG03540#1#JAGYVY010000208.1_95187_596142_0	HG03540	257671	269413	5	79	0	3	75	11742	262769	251027	0-3-7-9-4-6-8-5-2-4-9-7-2-5-2-4-9-7-2-5-2-1	0.0-3.0-7.0-9.0-4.0-6.0-8.0-5.0-2.0-4.1-9.1-7.1-2.1-5.0-2.0-4.1-9.1-7.1-2.1-5.1-2.0-1.0	98	257573	269315
HG03540#1#JAGYVY010000208.1_95187_596142_0	HG03540	270494	304599	2	196	0	1	195	34105	296874	262769	0-3-7-9-4-6-8-5-2-4-9-7-2-5-2-4-9-7-2-5-2-1	0.0-3.0-7.0-9.0-4.0-6.0-8.0-5.0-2.0-4.1-9.1-7.1-2.1-5.0-2.0-4.1-9.1-7.1-2.1-5.1-2.0-1.0	98	270396	304501
HG03540#1#JAGYVY010000208.1_95187_596142_0	HG03540	306465	317587	4	84	1	58	6	11122	307996	296874	0-3-7-9-4-6-8-5-2-4-9-7-2-5-2-4-9-7-2-5-2-1	0.0-3.0-7.0-9.0-4.0-6.0-8.0-5.0-2.0-4.1-9.1-7.1-2.1-5.0-2.0-4.1-9.1-7.1-2.1-5.1-2.0-1.0	98	306367	317489
HG03540#1#JAGYVY010000208.1_95187_596142_0	HG03540	319074	320385	9	5	1	4	0	1311	309307	307996	0-3-7-9-4-6-8-5-2-4-9-7-2-5-2-4-9-7-2-5-2-1	0.0-3.0-7.0-9.0-4.0-6.0-8.0-5.0-2.0-4.1-9.1-7.1-2.1-5.0-2.0-4.1-9.1-7.1-2.1-5.1-2.0-1.0	98	318976	320287
HG03540#1#JAGYVY010000208.1_95187_596142_0	HG03540	320329	322369	7	12	1	11	0	2040	311347	309307	0-3-7-9-4-6-8-5-2-4-9-7-2-5-2-4-9-7-2-5-2-1	0.0-3.0-7.0-9.0-4.0-6.0-8.0-5.0-2.0-4.1-9.1-7.1-2.1-5.0-2.0-4.1-9.1-7.1-2.1-5.1-2.0-1.0	98	320231	322271
HG03540#1#JAGYVY010000208.1_95187_596142_0	HG03540	323831	357556	2	196	1	194	1	33725	345072	311347	0-3-7-9-4-6-8-5-2-4-9-7-2-5-2-4-9-7-2-5-2-1	0.0-3.0-7.0-9.0-4.0-6.0-8.0-5.0-2.0-4.1-9.1-7.1-2.1-5.0-2.0-4.1-9.1-7.1-2.1-5.1-2.0-1.0	98	323733	357458
HG03540#1#JAGYVY010000208.1_95187_596142_0	HG03540	358637	370377	5	79	1	75	3	11740	356812	345072	0-3-7-9-4-6-8-5-2-4-9-7-2-5-2-4-9-7-2-5-2-1	0.0-3.0-7.0-9.0-4.0-6.0-8.0-5.0-2.0-4.1-9.1-7.1-2.1-5.0-2.0-4.1-9.1-7.1-2.1-5.1-2.0-1.0	98	358539	370279
HG03540#1#JAGYVY010000208.1_95187_596142_0	HG03540	370816	398725	2	196	0	39	195	27909	384721	356812	0-3-7-9-4-6-8-5-2-4-9-7-2-5-2-4-9-7-2-5-2-1	0.0-3.0-7.0-9.0-4.0-6.0-8.0-5.0-2.0-4.1-9.1-7.1-2.1-5.0-2.0-4.1-9.1-7.1-2.1-5.1-2.0-1.0	98	370718	398627
HG03540#1#JAGYVY010000208.1_95187_596142_0	HG03540	398669	501011	1	612	0	0	606	102342	487063	384721	0-3-7-9-4-6-8-5-2-4-9-7-2-5-2-4-9-7-2-5-2-1	0.0-3.0-7.0-9.0-4.0-6.0-8.0-5.0-2.0-4.1-9.1-7.1-2.1-5.0-2.0-4.1-9.1-7.1-2.1-5.1-2.0-1.0	98	398571	500913
HG03540#2#JAGYVX010000148.1_1368955_1877115_0	HG03540	98	115513	0	672	0	0	671	115415	115415	0	0-3-7-9-4-6-8-5-2-4-4-2-5-2-4-4-2-5-2-1	0.0-3.0-7.0-9.0-4.0-6.0-8.0-5.0-2.0-4.1-4.0-2.1-5.0-2.0-4.1-4.0-2.1-5.1-2.0-1.0	98	0	115415
HG03540#2#JAGYVX010000148.1_1368955_1877115_0	HG03540	115604	138437	3	132	0	0	131	22833	138248	115415	0-3-7-9-4-6-8-5-2-4-4-2-5-2-4-4-2-5-2-1	0.0-3.0-7.0-9.0-4.0-6.0-8.0-5.0-2.0-4.1-4.0-2.1-5.0-2.0-4.1-4.0-2.1-5.1-2.0-1.0	98	115506	138339
HG03540#2#JAGYVX010000148.1_1368955_1877115_0	HG03540	139196	140307	7	12	0	0	6	1111	139359	138248	0-3-7-9-4-6-8-5-2-4-4-2-5-2-4-4-2-5-2-1	0.0-3.0-7.0-9.0-4.0-6.0-8.0-5.0-2.0-4.1-4.0-2.1-5.0-2.0-4.1-4.0-2.1-5.1-2.0-1.0	98	139098	140209
HG03540#2#JAGYVX010000148.1_1368955_1877115_0	HG03540	141180	142491	9	5	0	0	4	1311	140670	139359	0-3-7-9-4-6-8-5-2-4-4-2-5-2-4-4-2-5-2-1	0.0-3.0-7.0-9.0-4.0-6.0-8.0-5.0-2.0-4.1-4.0-2.1-5.0-2.0-4.1-4.0-2.1-5.1-2.0-1.0	98	141082	142393
HG03540#2#JAGYVX010000148.1_1368955_1877115_0	HG03540	142939	159089	4	84	0	0	83	16150	156820	140670	0-3-7-9-4-6-8-5-2-4-4-2-5-2-4-4-2-5-2-1	0.0-3.0-7.0-9.0-4.0-6.0-8.0-5.0-2.0-4.1-4.0-2.1-5.0-2.0-4.1-4.0-2.1-5.1-2.0-1.0	98	142841	158991
HG03540#2#JAGYVX010000148.1_1368955_1877115_0	HG03540	159033	161848	6	12	0	0	11	2815	159635	156820	0-3-7-9-4-6-8-5-2-4-4-2-5-2-4-4-2-5-2-1	0.0-3.0-7.0-9.0-4.0-6.0-8.0-5.0-2.0-4.1-4.0-2.1-5.0-2.0-4.1-4.0-2.1-5.1-2.0-1.0	98	158935	161750
HG03540#2#JAGYVX010000148.1_1368955_1877115_0	HG03540	161792	163562	8	8	0	0	7	1770	161405	159635	0-3-7-9-4-6-8-5-2-4-4-2-5-2-4-4-2-5-2-1	0.0-3.0-7.0-9.0-4.0-6.0-8.0-5.0-2.0-4.1-4.0-2.1-5.0-2.0-4.1-4.0-2.1-5.1-2.0-1.0	98	161694	163464
HG03540#2#JAGYVX010000148.1_1368955_1877115_0	HG03540	163506	176610	5	79	0	0	78	13104	174509	161405	0-3-7-9-4-6-8-5-2-4-4-2-5-2-4-4-2-5-2-1	0.0-3.0-7.0-9.0-4.0-6.0-8.0-5.0-2.0-4.1-4.0-2.1-5.0-2.0-4.1-4.0-2.1-5.1-2.0-1.0	98	163408	176512
HG03540#2#JAGYVX010000148.1_1368955_1877115_0	HG03540	176554	210882	2	196	0	0	195	34328	208837	174509	0-3-7-9-4-6-8-5-2-4-4-2-5-2-4-4-2-5-2-1	0.0-3.0-7.0-9.0-4.0-6.0-8.0-5.0-2.0-4.1-4.0-2.1-5.0-2.0-4.1-4.0-2.1-5.1-2.0-1.0	98	176456	210784
HG03540#2#JAGYVX010000148.1_1368955_1877115_0	HG03540	213199	221968	4	84	1	56	20	8769	217606	208837	0-3-7-9-4-6-8-5-2-4-4-2-5-2-4-4-2-5-2-1	0.0-3.0-7.0-9.0-4.0-6.0-8.0-5.0-2.0-4.1-4.0-2.1-5.0-2.0-4.1-4.0-2.1-5.1-2.0-1.0	98	213101	221870
HG03540#2#JAGYVX010000148.1_1368955_1877115_0	HG03540	222276	230756	4	84	0	22	58	8480	226086	217606	0-3-7-9-4-6-8-5-2-4-4-2-5-2-4-4-2-5-2-1	0.0-3.0-7.0-9.0-4.0-6.0-8.0-5.0-2.0-4.1-4.0-2.1-5.0-2.0-4.1-4.0-2.1-5.1-2.0-1.0	98	222178	230658
HG03540#2#JAGYVX010000148.1_1368955_1877115_0	HG03540	232622	260526	2	196	1	195	39	27904	253990	226086	0-3-7-9-4-6-8-5-2-4-4-2-5-2-4-4-2-5-2-1	0.0-3.0-7.0-9.0-4.0-6.0-8.0-5.0-2.0-4.1-4.0-2.1-5.0-2.0-4.1-4.0-2.1-5.1-2.0-1.0	98	232524	260428
HG03540#2#JAGYVX010000148.1_1368955_1877115_0	HG03540	260965	273620	5	79	0	3	78	12655	266645	253990	0-3-7-9-4-6-8-5-2-4-4-2-5-2-4-4-2-5-2-1	0.0-3.0-7.0-9.0-4.0-6.0-8.0-5.0-2.0-4.1-4.0-2.1-5.0-2.0-4.1-4.0-2.1-5.1-2.0-1.0	98	260867	273522
HG03540#2#JAGYVX010000148.1_1368955_1877115_0	HG03540	273564	307471	2	196	0	0	193	33907	300552	266645	0-3-7-9-4-6-8-5-2-4-4-2-5-2-4-4-2-5-2-1	0.0-3.0-7.0-9.0-4.0-6.0-8.0-5.0-2.0-4.1-4.0-2.1-5.0-2.0-4.1-4.0-2.1-5.1-2.0-1.0	98	273466	307373
HG03540#2#JAGYVX010000148.1_1368955_1877115_0	HG03540	309761	318238	4	84	1	58	22	8477	309029	300552	0-3-7-9-4-6-8-5-2-4-4-2-5-2-4-4-2-5-2-1	0.0-3.0-7.0-9.0-4.0-6.0-8.0-5.0-2.0-4.1-4.0-2.1-5.0-2.0-4.1-4.0-2.1-5.1-2.0-1.0	98	309663	318140
HG03540#2#JAGYVX010000148.1_1368955_1877115_0	HG03540	318546	327775	4	84	0	20	58	9229	318258	309029	0-3-7-9-4-6-8-5-2-4-4-2-5-2-4-4-2-5-2-1	0.0-3.0-7.0-9.0-4.0-6.0-8.0-5.0-2.0-4.1-4.0-2.1-5.0-2.0-4.1-4.0-2.1-5.1-2.0-1.0	98	318448	327677
HG03540#2#JAGYVX010000148.1_1368955_1877115_0	HG03540	329641	363961	2	196	1	195	0	34320	352578	318258	0-3-7-9-4-6-8-5-2-4-4-2-5-2-4-4-2-5-2-1	0.0-3.0-7.0-9.0-4.0-6.0-8.0-5.0-2.0-4.1-4.0-2.1-5.0-2.0-4.1-4.0-2.1-5.1-2.0-1.0	98	329543	363863
HG03540#2#JAGYVX010000148.1_1368955_1877115_0	HG03540	363905	376560	5	79	1	78	3	12655	365233	352578	0-3-7-9-4-6-8-5-2-4-4-2-5-2-4-4-2-5-2-1	0.0-3.0-7.0-9.0-4.0-6.0-8.0-5.0-2.0-4.1-4.0-2.1-5.0-2.0-4.1-4.0-2.1-5.1-2.0-1.0	98	363807	376462
HG03540#2#JAGYVX010000148.1_1368955_1877115_0	HG03540	376999	404924	2	196	0	39	195	27925	393158	365233	0-3-7-9-4-6-8-5-2-4-4-2-5-2-4-4-2-5-2-1	0.0-3.0-7.0-9.0-4.0-6.0-8.0-5.0-2.0-4.1-4.0-2.1-5.0-2.0-4.1-4.0-2.1-5.1-2.0-1.0	98	376901	404826
HG03540#2#JAGYVX010000148.1_1368955_1877115_0	HG03540	404868	508088	1	612	0	0	611	103220	496378	393158	0-3-7-9-4-6-8-5-2-4-4-2-5-2-4-4-2-5-2-1	0.0-3.0-7.0-9.0-4.0-6.0-8.0-5.0-2.0-4.1-4.0-2.1-5.0-2.0-4.1-4.0-2.1-5.1-2.0-1.0	98	404770	507990
HG03579#1#JAGYVU010000029.1_91404_499180_0	HG03579	98	115483	0	672	0	0	671	115385	115385	0	0-3-7-9-4-6-8-5-2-7-9-4-2-5-2-1	0.0-3.0-7.0-9.0-4.0-6.0-8.0-5.0-2.0-7.0-9.0-4.0-2.1-5.1-2.0-1.0	98	0	115385
HG03579#1#JAGYVU010000029.1_91404_499180_0	HG03579	115574	138407	3	132	0	0	131	22833	138218	115385	0-3-7-9-4-6-8-5-2-7-9-4-2-5-2-1	0.0-3.0-7.0-9.0-4.0-6.0-8.0-5.0-2.0-7.0-9.0-4.0-2.1-5.1-2.0-1.0	98	115476	138309
HG03579#1#JAGYVU010000029.1_91404_499180_0	HG03579	139166	141206	7	12	0	0	11	2040	140258	138218	0-3-7-9-4-6-8-5-2-7-9-4-2-5-2-1	0.0-3.0-7.0-9.0-4.0-6.0-8.0-5.0-2.0-7.0-9.0-4.0-2.1-5.1-2.0-1.0	98	139068	141108
HG03579#1#JAGYVU010000029.1_91404_499180_0	HG03579	141150	142461	9	5	0	0	4	1311	141569	140258	0-3-7-9-4-6-8-5-2-7-9-4-2-5-2-1	0.0-3.0-7.0-9.0-4.0-6.0-8.0-5.0-2.0-7.0-9.0-4.0-2.1-5.1-2.0-1.0	98	141052	142363
HG03579#1#JAGYVU010000029.1_91404_499180_0	HG03579	142909	158708	4	84	0	0	83	15799	157368	141569	0-3-7-9-4-6-8-5-2-7-9-4-2-5-2-1	0.0-3.0-7.0-9.0-4.0-6.0-8.0-5.0-2.0-7.0-9.0-4.0-2.1-5.1-2.0-1.0	98	142811	158610
HG03579#1#JAGYVU010000029.1_91404_499180_0	HG03579	158652	161467	6	12	0	0	11	2815	160183	157368	0-3-7-9-4-6-8-5-2-7-9-4-2-5-2-1	0.0-3.0-7.0-9.0-4.0-6.0-8.0-5.0-2.0-7.0-9.0-4.0-2.1-5.1-2.0-1.0	98	158554	161369
HG03579#1#JAGYVU010000029.1_91404_499180_0	HG03579	161411	163181	8	8	0	0	7	1770	161953	160183	0-3-7-9-4-6-8-5-2-7-9-4-2-5-2-1	0.0-3.0-7.0-9.0-4.0-6.0-8.0-5.0-2.0-7.0-9.0-4.0-2.1-5.1-2.0-1.0	98	161313	163083
HG03579#1#JAGYVU010000029.1_91404_499180_0	HG03579	163125	175315	5	79	0	0	75	12190	174143	161953	0-3-7-9-4-6-8-5-2-7-9-4-2-5-2-1	0.0-3.0-7.0-9.0-4.0-6.0-8.0-5.0-2.0-7.0-9.0-4.0-2.1-5.1-2.0-1.0	98	163027	175217
HG03579#1#JAGYVU010000029.1_91404_499180_0	HG03579	176396	210115	2	196	0	1	194	33719	207862	174143	0-3-7-9-4-6-8-5-2-7-9-4-2-5-2-1	0.0-3.0-7.0-9.0-4.0-6.0-8.0-5.0-2.0-7.0-9.0-4.0-2.1-5.1-2.0-1.0	98	176298	210017
HG03579#1#JAGYVU010000029.1_91404_499180_0	HG03579	211577	213617	7	12	0	0	11	2040	209902	207862	0-3-7-9-4-6-8-5-2-7-9-4-2-5-2-1	0.0-3.0-7.0-9.0-4.0-6.0-8.0-5.0-2.0-7.0-9.0-4.0-2.1-5.1-2.0-1.0	98	211479	213519
HG03579#1#JAGYVU010000029.1_91404_499180_0	HG03579	213561	214872	9	5	0	0	4	1311	211213	209902	0-3-7-9-4-6-8-5-2-7-9-4-2-5-2-1	0.0-3.0-7.0-9.0-4.0-6.0-8.0-5.0-2.0-7.0-9.0-4.0-2.1-5.1-2.0-1.0	98	213463	214774
HG03579#1#JAGYVU010000029.1_91404_499180_0	HG03579	216359	227482	4	84	0	6	58	11123	222336	211213	0-3-7-9-4-6-8-5-2-7-9-4-2-5-2-1	0.0-3.0-7.0-9.0-4.0-6.0-8.0-5.0-2.0-7.0-9.0-4.0-2.1-5.1-2.0-1.0	98	216261	227384
HG03579#1#JAGYVU010000029.1_91404_499180_0	HG03579	229348	263458	2	196	1	195	1	34110	256446	222336	0-3-7-9-4-6-8-5-2-7-9-4-2-5-2-1	0.0-3.0-7.0-9.0-4.0-6.0-8.0-5.0-2.0-7.0-9.0-4.0-2.1-5.1-2.0-1.0	98	229250	263360
HG03579#1#JAGYVU010000029.1_91404_499180_0	HG03579	264539	276281	5	79	1	75	3	11742	268188	256446	0-3-7-9-4-6-8-5-2-7-9-4-2-5-2-1	0.0-3.0-7.0-9.0-4.0-6.0-8.0-5.0-2.0-7.0-9.0-4.0-2.1-5.1-2.0-1.0	98	264441	276183
HG03579#1#JAGYVU010000029.1_91404_499180_0	HG03579	276720	304631	2	196	0	39	195	27911	296099	268188	0-3-7-9-4-6-8-5-2-7-9-4-2-5-2-1	0.0-3.0-7.0-9.0-4.0-6.0-8.0-5.0-2.0-7.0-9.0-4.0-2.1-5.1-2.0-1.0	98	276622	304533
HG03579#1#JAGYVU010000029.1_91404_499180_0	HG03579	304575	407704	1	612	0	0	611	103129	399228	296099	0-3-7-9-4-6-8-5-2-7-9-4-2-5-2-1	0.0-3.0-7.0-9.0-4.0-6.0-8.0-5.0-2.0-7.0-9.0-4.0-2.1-5.1-2.0-1.0	98	304477	407606
HG03579#2#JAGYVT010000094.1_51581892_51895531_0	HG03579	98	115428	0	672	0	0	671	115330	115330	0	0-3-7-9-4-6-8-5-2-1	0.0-3.0-7.0-9.0-4.0-6.0-8.0-5.0-2.0-1.0	98	0	115330
HG03579#2#JAGYVT010000094.1_51581892_51895531_0	HG03579	115519	138349	3	132	0	0	131	22830	138160	115330	0-3-7-9-4-6-8-5-2-1	0.0-3.0-7.0-9.0-4.0-6.0-8.0-5.0-2.0-1.0	98	115421	138251
HG03579#2#JAGYVT010000094.1_51581892_51895531_0	HG03579	139108	141148	7	12	0	0	11	2040	140200	138160	0-3-7-9-4-6-8-5-2-1	0.0-3.0-7.0-9.0-4.0-6.0-8.0-5.0-2.0-1.0	98	139010	141050
HG03579#2#JAGYVT010000094.1_51581892_51895531_0	HG03579	141092	142403	9	5	0	0	4	1311	141511	140200	0-3-7-9-4-6-8-5-2-1	0.0-3.0-7.0-9.0-4.0-6.0-8.0-5.0-2.0-1.0	98	140994	142305
HG03579#2#JAGYVT010000094.1_51581892_51895531_0	HG03579	142851	158653	4	84	0	0	83	15802	157313	141511	0-3-7-9-4-6-8-5-2-1	0.0-3.0-7.0-9.0-4.0-6.0-8.0-5.0-2.0-1.0	98	142753	158555
HG03579#2#JAGYVT010000094.1_51581892_51895531_0	HG03579	158597	161412	6	12	0	0	11	2815	160128	157313	0-3-7-9-4-6-8-5-2-1	0.0-3.0-7.0-9.0-4.0-6.0-8.0-5.0-2.0-1.0	98	158499	161314
HG03579#2#JAGYVT010000094.1_51581892_51895531_0	HG03579	161356	163126	8	8	0	0	7	1770	161898	160128	0-3-7-9-4-6-8-5-2-1	0.0-3.0-7.0-9.0-4.0-6.0-8.0-5.0-2.0-1.0	98	161258	163028
HG03579#2#JAGYVT010000094.1_51581892_51895531_0	HG03579	163070	175734	5	79	0	0	77	12664	174562	161898	0-3-7-9-4-6-8-5-2-1	0.0-3.0-7.0-9.0-4.0-6.0-8.0-5.0-2.0-1.0	98	162972	175636
HG03579#2#JAGYVT010000094.1_51581892_51895531_0	HG03579	176341	210443	2	196	0	1	195	34102	208664	174562	0-3-7-9-4-6-8-5-2-1	0.0-3.0-7.0-9.0-4.0-6.0-8.0-5.0-2.0-1.0	98	176243	210345
HG03579#2#JAGYVT010000094.1_51581892_51895531_0	HG03579	210387	313567	1	612	0	0	611	103180	311844	208664	0-3-7-9-4-6-8-5-2-1	0.0-3.0-7.0-9.0-4.0-6.0-8.0-5.0-2.0-1.0	98	210289	313469
HG03710.verkko_filt_mat.fa:haplotype1-0000029_102593394_102907063_0	HG03710.verkko_filt_mat.fa:haplotype1-0000029_102593394_102907063_0	98	115428	0	672	0	0	671	115330	115330	0	0-3-7-9-4-6-8-5-2-1	0.0-3.0-7.0-9.0-4.0-6.0-8.0-5.0-2.0-1.0	98	0	115330
HG03710.verkko_filt_mat.fa:haplotype1-0000029_102593394_102907063_0	HG03710.verkko_filt_mat.fa:haplotype1-0000029_102593394_102907063_0	115519	138352	3	132	0	0	131	22833	138163	115330	0-3-7-9-4-6-8-5-2-1	0.0-3.0-7.0-9.0-4.0-6.0-8.0-5.0-2.0-1.0	98	115421	138254
HG03710.verkko_filt_mat.fa:haplotype1-0000029_102593394_102907063_0	HG03710.verkko_filt_mat.fa:haplotype1-0000029_102593394_102907063_0	139111	141151	7	12	0	0	11	2040	140203	138163	0-3-7-9-4-6-8-5-2-1	0.0-3.0-7.0-9.0-4.0-6.0-8.0-5.0-2.0-1.0	98	139013	141053
HG03710.verkko_filt_mat.fa:haplotype1-0000029_102593394_102907063_0	HG03710.verkko_filt_mat.fa:haplotype1-0000029_102593394_102907063_0	141095	142406	9	5	0	0	4	1311	141514	140203	0-3-7-9-4-6-8-5-2-1	0.0-3.0-7.0-9.0-4.0-6.0-8.0-5.0-2.0-1.0	98	140997	142308
HG03710.verkko_filt_mat.fa:haplotype1-0000029_102593394_102907063_0	HG03710.verkko_filt_mat.fa:haplotype1-0000029_102593394_102907063_0	142854	158658	4	84	0	0	83	15804	157318	141514	0-3-7-9-4-6-8-5-2-1	0.0-3.0-7.0-9.0-4.0-6.0-8.0-5.0-2.0-1.0	98	142756	158560
HG03710.verkko_filt_mat.fa:haplotype1-0000029_102593394_102907063_0	HG03710.verkko_filt_mat.fa:haplotype1-0000029_102593394_102907063_0	158602	161417	6	12	0	0	11	2815	160133	157318	0-3-7-9-4-6-8-5-2-1	0.0-3.0-7.0-9.0-4.0-6.0-8.0-5.0-2.0-1.0	98	158504	161319
HG03710.verkko_filt_mat.fa:haplotype1-0000029_102593394_102907063_0	HG03710.verkko_filt_mat.fa:haplotype1-0000029_102593394_102907063_0	161361	163131	8	8	0	0	7	1770	161903	160133	0-3-7-9-4-6-8-5-2-1	0.0-3.0-7.0-9.0-4.0-6.0-8.0-5.0-2.0-1.0	98	161263	163033
HG03710.verkko_filt_mat.fa:haplotype1-0000029_102593394_102907063_0	HG03710.verkko_filt_mat.fa:haplotype1-0000029_102593394_102907063_0	163075	175739	5	79	0	0	77	12664	174567	161903	0-3-7-9-4-6-8-5-2-1	0.0-3.0-7.0-9.0-4.0-6.0-8.0-5.0-2.0-1.0	98	162977	175641
HG03710.verkko_filt_mat.fa:haplotype1-0000029_102593394_102907063_0	HG03710.verkko_filt_mat.fa:haplotype1-0000029_102593394_102907063_0	176123	210445	2	196	0	0	195	34322	208889	174567	0-3-7-9-4-6-8-5-2-1	0.0-3.0-7.0-9.0-4.0-6.0-8.0-5.0-2.0-1.0	98	176025	210347
HG03710.verkko_filt_mat.fa:haplotype1-0000029_102593394_102907063_0	HG03710.verkko_filt_mat.fa:haplotype1-0000029_102593394_102907063_0	210389	313597	1	612	0	0	611	103208	312097	208889	0-3-7-9-4-6-8-5-2-1	0.0-3.0-7.0-9.0-4.0-6.0-8.0-5.0-2.0-1.0	98	210291	313499
HG03710.verkko_filt_pat.fa:haplotype2-0000488_101614437_102218208_0	HG03710.verkko_filt_pat.fa:haplotype2-0000488_101614437_102218208_0	98	115400	0	672	0	0	671	115302	115302	0	0-3-7-9-4-6-8-5-2-4-4-2-5-2-4-4-2-5-2-4-4-2-5-2-1	0.0-3.0-7.0-9.0-4.0-6.0-8.0-5.0-2.0-4.1-4.0-2.1-5.0-2.0-4.1-4.0-2.1-5.1-2.0-4.1-4.0-2.1-5.0-2.0-1.0	98	0	115302
HG03710.verkko_filt_pat.fa:haplotype2-0000488_101614437_102218208_0	HG03710.verkko_filt_pat.fa:haplotype2-0000488_101614437_102218208_0	115491	138325	3	132	0	0	131	22834	138136	115302	0-3-7-9-4-6-8-5-2-4-4-2-5-2-4-4-2-5-2-4-4-2-5-2-1	0.0-3.0-7.0-9.0-4.0-6.0-8.0-5.0-2.0-4.1-4.0-2.1-5.0-2.0-4.1-4.0-2.1-5.1-2.0-4.1-4.0-2.1-5.0-2.0-1.0	98	115393	138227
HG03710.verkko_filt_pat.fa:haplotype2-0000488_101614437_102218208_0	HG03710.verkko_filt_pat.fa:haplotype2-0000488_101614437_102218208_0	139084	141124	7	12	0	0	11	2040	140176	138136	0-3-7-9-4-6-8-5-2-4-4-2-5-2-4-4-2-5-2-4-4-2-5-2-1	0.0-3.0-7.0-9.0-4.0-6.0-8.0-5.0-2.0-4.1-4.0-2.1-5.0-2.0-4.1-4.0-2.1-5.1-2.0-4.1-4.0-2.1-5.0-2.0-1.0	98	138986	141026
HG03710.verkko_filt_pat.fa:haplotype2-0000488_101614437_102218208_0	HG03710.verkko_filt_pat.fa:haplotype2-0000488_101614437_102218208_0	141068	142379	9	5	0	0	4	1311	141487	140176	0-3-7-9-4-6-8-5-2-4-4-2-5-2-4-4-2-5-2-4-4-2-5-2-1	0.0-3.0-7.0-9.0-4.0-6.0-8.0-5.0-2.0-4.1-4.0-2.1-5.0-2.0-4.1-4.0-2.1-5.1-2.0-4.1-4.0-2.1-5.0-2.0-1.0	98	140970	142281
HG03710.verkko_filt_pat.fa:haplotype2-0000488_101614437_102218208_0	HG03710.verkko_filt_pat.fa:haplotype2-0000488_101614437_102218208_0	142827	158637	4	84	0	0	83	15810	157297	141487	0-3-7-9-4-6-8-5-2-4-4-2-5-2-4-4-2-5-2-4-4-2-5-2-1	0.0-3.0-7.0-9.0-4.0-6.0-8.0-5.0-2.0-4.1-4.0-2.1-5.0-2.0-4.1-4.0-2.1-5.1-2.0-4.1-4.0-2.1-5.0-2.0-1.0	98	142729	158539
HG03710.verkko_filt_pat.fa:haplotype2-0000488_101614437_102218208_0	HG03710.verkko_filt_pat.fa:haplotype2-0000488_101614437_102218208_0	158581	161396	6	12	0	0	11	2815	160112	157297	0-3-7-9-4-6-8-5-2-4-4-2-5-2-4-4-2-5-2-4-4-2-5-2-1	0.0-3.0-7.0-9.0-4.0-6.0-8.0-5.0-2.0-4.1-4.0-2.1-5.0-2.0-4.1-4.0-2.1-5.1-2.0-4.1-4.0-2.1-5.0-2.0-1.0	98	158483	161298
HG03710.verkko_filt_pat.fa:haplotype2-0000488_101614437_102218208_0	HG03710.verkko_filt_pat.fa:haplotype2-0000488_101614437_102218208_0	161340	163110	8	8	0	0	7	1770	161882	160112	0-3-7-9-4-6-8-5-2-4-4-2-5-2-4-4-2-5-2-4-4-2-5-2-1	0.0-3.0-7.0-9.0-4.0-6.0-8.0-5.0-2.0-4.1-4.0-2.1-5.0-2.0-4.1-4.0-2.1-5.1-2.0-4.1-4.0-2.1-5.0-2.0-1.0	98	161242	163012
HG03710.verkko_filt_pat.fa:haplotype2-0000488_101614437_102218208_0	HG03710.verkko_filt_pat.fa:haplotype2-0000488_101614437_102218208_0	163054	176158	5	79	0	0	78	13104	174986	161882	0-3-7-9-4-6-8-5-2-4-4-2-5-2-4-4-2-5-2-4-4-2-5-2-1	0.0-3.0-7.0-9.0-4.0-6.0-8.0-5.0-2.0-4.1-4.0-2.1-5.0-2.0-4.1-4.0-2.1-5.1-2.0-4.1-4.0-2.1-5.0-2.0-1.0	98	162956	176060
HG03710.verkko_filt_pat.fa:haplotype2-0000488_101614437_102218208_0	HG03710.verkko_filt_pat.fa:haplotype2-0000488_101614437_102218208_0	176102	210430	2	196	0	0	195	34328	209314	174986	0-3-7-9-4-6-8-5-2-4-4-2-5-2-4-4-2-5-2-4-4-2-5-2-1	0.0-3.0-7.0-9.0-4.0-6.0-8.0-5.0-2.0-4.1-4.0-2.1-5.0-2.0-4.1-4.0-2.1-5.1-2.0-4.1-4.0-2.1-5.0-2.0-1.0	98	176004	210332
HG03710.verkko_filt_pat.fa:haplotype2-0000488_101614437_102218208_0	HG03710.verkko_filt_pat.fa:haplotype2-0000488_101614437_102218208_0	212747	221525	4	84	1	56	20	8778	218092	209314	0-3-7-9-4-6-8-5-2-4-4-2-5-2-4-4-2-5-2-4-4-2-5-2-1	0.0-3.0-7.0-9.0-4.0-6.0-8.0-5.0-2.0-4.1-4.0-2.1-5.0-2.0-4.1-4.0-2.1-5.1-2.0-4.1-4.0-2.1-5.0-2.0-1.0	98	212649	221427
HG03710.verkko_filt_pat.fa:haplotype2-0000488_101614437_102218208_0	HG03710.verkko_filt_pat.fa:haplotype2-0000488_101614437_102218208_0	221833	230312	4	84	0	22	58	8479	226571	218092	0-3-7-9-4-6-8-5-2-4-4-2-5-2-4-4-2-5-2-4-4-2-5-2-1	0.0-3.0-7.0-9.0-4.0-6.0-8.0-5.0-2.0-4.1-4.0-2.1-5.0-2.0-4.1-4.0-2.1-5.1-2.0-4.1-4.0-2.1-5.0-2.0-1.0	98	221735	230214
HG03710.verkko_filt_pat.fa:haplotype2-0000488_101614437_102218208_0	HG03710.verkko_filt_pat.fa:haplotype2-0000488_101614437_102218208_0	232178	260083	2	196	1	195	39	27905	254476	226571	0-3-7-9-4-6-8-5-2-4-4-2-5-2-4-4-2-5-2-4-4-2-5-2-1	0.0-3.0-7.0-9.0-4.0-6.0-8.0-5.0-2.0-4.1-4.0-2.1-5.0-2.0-4.1-4.0-2.1-5.1-2.0-4.1-4.0-2.1-5.0-2.0-1.0	98	232080	259985
HG03710.verkko_filt_pat.fa:haplotype2-0000488_101614437_102218208_0	HG03710.verkko_filt_pat.fa:haplotype2-0000488_101614437_102218208_0	260522	272737	5	79	0	3	77	12215	266691	254476	0-3-7-9-4-6-8-5-2-4-4-2-5-2-4-4-2-5-2-4-4-2-5-2-1	0.0-3.0-7.0-9.0-4.0-6.0-8.0-5.0-2.0-4.1-4.0-2.1-5.0-2.0-4.1-4.0-2.1-5.1-2.0-4.1-4.0-2.1-5.0-2.0-1.0	98	260424	272639
HG03710.verkko_filt_pat.fa:haplotype2-0000488_101614437_102218208_0	HG03710.verkko_filt_pat.fa:haplotype2-0000488_101614437_102218208_0	273344	307459	2	196	0	1	195	34115	300806	266691	0-3-7-9-4-6-8-5-2-4-4-2-5-2-4-4-2-5-2-4-4-2-5-2-1	0.0-3.0-7.0-9.0-4.0-6.0-8.0-5.0-2.0-4.1-4.0-2.1-5.0-2.0-4.1-4.0-2.1-5.1-2.0-4.1-4.0-2.1-5.0-2.0-1.0	98	273246	307361
HG03710.verkko_filt_pat.fa:haplotype2-0000488_101614437_102218208_0	HG03710.verkko_filt_pat.fa:haplotype2-0000488_101614437_102218208_0	309776	318556	4	84	1	56	20	8780	309586	300806	0-3-7-9-4-6-8-5-2-4-4-2-5-2-4-4-2-5-2-4-4-2-5-2-1	0.0-3.0-7.0-9.0-4.0-6.0-8.0-5.0-2.0-4.1-4.0-2.1-5.0-2.0-4.1-4.0-2.1-5.1-2.0-4.1-4.0-2.1-5.0-2.0-1.0	98	309678	318458
HG03710.verkko_filt_pat.fa:haplotype2-0000488_101614437_102218208_0	HG03710.verkko_filt_pat.fa:haplotype2-0000488_101614437_102218208_0	318864	326891	4	84	0	22	56	8027	317613	309586	0-3-7-9-4-6-8-5-2-4-4-2-5-2-4-4-2-5-2-4-4-2-5-2-1	0.0-3.0-7.0-9.0-4.0-6.0-8.0-5.0-2.0-4.1-4.0-2.1-5.0-2.0-4.1-4.0-2.1-5.1-2.0-4.1-4.0-2.1-5.0-2.0-1.0	98	318766	326793
HG03710.verkko_filt_pat.fa:haplotype2-0000488_101614437_102218208_0	HG03710.verkko_filt_pat.fa:haplotype2-0000488_101614437_102218208_0	329208	363314	2	196	1	195	1	34106	351719	317613	0-3-7-9-4-6-8-5-2-4-4-2-5-2-4-4-2-5-2-4-4-2-5-2-1	0.0-3.0-7.0-9.0-4.0-6.0-8.0-5.0-2.0-4.1-4.0-2.1-5.0-2.0-4.1-4.0-2.1-5.1-2.0-4.1-4.0-2.1-5.0-2.0-1.0	98	329110	363216
HG03710.verkko_filt_pat.fa:haplotype2-0000488_101614437_102218208_0	HG03710.verkko_filt_pat.fa:haplotype2-0000488_101614437_102218208_0	364395	376136	5	79	1	75	3	11741	363460	351719	0-3-7-9-4-6-8-5-2-4-4-2-5-2-4-4-2-5-2-4-4-2-5-2-1	0.0-3.0-7.0-9.0-4.0-6.0-8.0-5.0-2.0-4.1-4.0-2.1-5.0-2.0-4.1-4.0-2.1-5.1-2.0-4.1-4.0-2.1-5.0-2.0-1.0	98	364297	376038
HG03710.verkko_filt_pat.fa:haplotype2-0000488_101614437_102218208_0	HG03710.verkko_filt_pat.fa:haplotype2-0000488_101614437_102218208_0	376575	404496	2	196	0	39	195	27921	391381	363460	0-3-7-9-4-6-8-5-2-4-4-2-5-2-4-4-2-5-2-4-4-2-5-2-1	0.0-3.0-7.0-9.0-4.0-6.0-8.0-5.0-2.0-4.1-4.0-2.1-5.0-2.0-4.1-4.0-2.1-5.1-2.0-4.1-4.0-2.1-5.0-2.0-1.0	98	376477	404398
HG03710.verkko_filt_pat.fa:haplotype2-0000488_101614437_102218208_0	HG03710.verkko_filt_pat.fa:haplotype2-0000488_101614437_102218208_0	406362	414839	4	84	1	58	22	8477	399858	391381	0-3-7-9-4-6-8-5-2-4-4-2-5-2-4-4-2-5-2-4-4-2-5-2-1	0.0-3.0-7.0-9.0-4.0-6.0-8.0-5.0-2.0-4.1-4.0-2.1-5.0-2.0-4.1-4.0-2.1-5.1-2.0-4.1-4.0-2.1-5.0-2.0-1.0	98	406264	414741
HG03710.verkko_filt_pat.fa:haplotype2-0000488_101614437_102218208_0	HG03710.verkko_filt_pat.fa:haplotype2-0000488_101614437_102218208_0	415147	424375	4	84	0	20	58	9228	409086	399858	0-3-7-9-4-6-8-5-2-4-4-2-5-2-4-4-2-5-2-4-4-2-5-2-1	0.0-3.0-7.0-9.0-4.0-6.0-8.0-5.0-2.0-4.1-4.0-2.1-5.0-2.0-4.1-4.0-2.1-5.1-2.0-4.1-4.0-2.1-5.0-2.0-1.0	98	415049	424277
HG03710.verkko_filt_pat.fa:haplotype2-0000488_101614437_102218208_0	HG03710.verkko_filt_pat.fa:haplotype2-0000488_101614437_102218208_0	426241	454164	2	196	1	195	39	27923	437009	409086	0-3-7-9-4-6-8-5-2-4-4-2-5-2-4-4-2-5-2-4-4-2-5-2-1	0.0-3.0-7.0-9.0-4.0-6.0-8.0-5.0-2.0-4.1-4.0-2.1-5.0-2.0-4.1-4.0-2.1-5.1-2.0-4.1-4.0-2.1-5.0-2.0-1.0	98	426143	454066
HG03710.verkko_filt_pat.fa:haplotype2-0000488_101614437_102218208_0	HG03710.verkko_filt_pat.fa:haplotype2-0000488_101614437_102218208_0	454603	466344	5	79	0	3	75	11741	448750	437009	0-3-7-9-4-6-8-5-2-4-4-2-5-2-4-4-2-5-2-4-4-2-5-2-1	0.0-3.0-7.0-9.0-4.0-6.0-8.0-5.0-2.0-4.1-4.0-2.1-5.0-2.0-4.1-4.0-2.1-5.1-2.0-4.1-4.0-2.1-5.0-2.0-1.0	98	454505	466246
HG03710.verkko_filt_pat.fa:haplotype2-0000488_101614437_102218208_0	HG03710.verkko_filt_pat.fa:haplotype2-0000488_101614437_102218208_0	467425	501522	2	196	0	1	195	34097	482847	448750	0-3-7-9-4-6-8-5-2-4-4-2-5-2-4-4-2-5-2-4-4-2-5-2-1	0.0-3.0-7.0-9.0-4.0-6.0-8.0-5.0-2.0-4.1-4.0-2.1-5.0-2.0-4.1-4.0-2.1-5.1-2.0-4.1-4.0-2.1-5.0-2.0-1.0	98	467327	501424
HG03710.verkko_filt_pat.fa:haplotype2-0000488_101614437_102218208_0	HG03710.verkko_filt_pat.fa:haplotype2-0000488_101614437_102218208_0	501466	603827	1	612	0	0	606	102361	585208	482847	0-3-7-9-4-6-8-5-2-4-4-2-5-2-4-4-2-5-2-4-4-2-5-2-1	0.0-3.0-7.0-9.0-4.0-6.0-8.0-5.0-2.0-4.1-4.0-2.1-5.0-2.0-4.1-4.0-2.1-5.1-2.0-4.1-4.0-2.1-5.0-2.0-1.0	98	501368	603729
HG03927.verkko_filt_mat.fa:haplotype1-0000009_134765170_135173010_1	HG03927.verkko_filt_mat.fa:haplotype1-0000009_134765170_135173010_1	154	115545	0	672	0	0	671	115391	115391	0	0-3-7-9-4-6-8-5-2-7-9-4-2-5-2-1	0.0-3.0-7.0-9.0-4.0-6.0-8.0-5.0-2.0-7.0-9.0-4.0-2.1-5.1-2.0-1.0	154	0	115391
HG03927.verkko_filt_mat.fa:haplotype1-0000009_134765170_135173010_1	HG03927.verkko_filt_mat.fa:haplotype1-0000009_134765170_135173010_1	115636	138470	3	132	0	0	131	22834	138225	115391	0-3-7-9-4-6-8-5-2-7-9-4-2-5-2-1	0.0-3.0-7.0-9.0-4.0-6.0-8.0-5.0-2.0-7.0-9.0-4.0-2.1-5.1-2.0-1.0	154	115482	138316
HG03927.verkko_filt_mat.fa:haplotype1-0000009_134765170_135173010_1	HG03927.verkko_filt_mat.fa:haplotype1-0000009_134765170_135173010_1	139229	141269	7	12	0	0	11	2040	140265	138225	0-3-7-9-4-6-8-5-2-7-9-4-2-5-2-1	0.0-3.0-7.0-9.0-4.0-6.0-8.0-5.0-2.0-7.0-9.0-4.0-2.1-5.1-2.0-1.0	154	139075	141115
HG03927.verkko_filt_mat.fa:haplotype1-0000009_134765170_135173010_1	HG03927.verkko_filt_mat.fa:haplotype1-0000009_134765170_135173010_1	141213	142525	9	5	0	0	4	1312	141577	140265	0-3-7-9-4-6-8-5-2-7-9-4-2-5-2-1	0.0-3.0-7.0-9.0-4.0-6.0-8.0-5.0-2.0-7.0-9.0-4.0-2.1-5.1-2.0-1.0	154	141059	142371
HG03927.verkko_filt_mat.fa:haplotype1-0000009_134765170_135173010_1	HG03927.verkko_filt_mat.fa:haplotype1-0000009_134765170_135173010_1	143316	158780	4	84	0	1	83	15464	157041	141577	0-3-7-9-4-6-8-5-2-7-9-4-2-5-2-1	0.0-3.0-7.0-9.0-4.0-6.0-8.0-5.0-2.0-7.0-9.0-4.0-2.1-5.1-2.0-1.0	154	143162	158626
HG03927.verkko_filt_mat.fa:haplotype1-0000009_134765170_135173010_1	HG03927.verkko_filt_mat.fa:haplotype1-0000009_134765170_135173010_1	158724	161539	6	12	0	0	11	2815	159856	157041	0-3-7-9-4-6-8-5-2-7-9-4-2-5-2-1	0.0-3.0-7.0-9.0-4.0-6.0-8.0-5.0-2.0-7.0-9.0-4.0-2.1-5.1-2.0-1.0	154	158570	161385
HG03927.verkko_filt_mat.fa:haplotype1-0000009_134765170_135173010_1	HG03927.verkko_filt_mat.fa:haplotype1-0000009_134765170_135173010_1	161483	163253	8	8	0	0	7	1770	161626	159856	0-3-7-9-4-6-8-5-2-7-9-4-2-5-2-1	0.0-3.0-7.0-9.0-4.0-6.0-8.0-5.0-2.0-7.0-9.0-4.0-2.1-5.1-2.0-1.0	154	161329	163099
HG03927.verkko_filt_mat.fa:haplotype1-0000009_134765170_135173010_1	HG03927.verkko_filt_mat.fa:haplotype1-0000009_134765170_135173010_1	163197	175861	5	79	0	0	77	12664	174290	161626	0-3-7-9-4-6-8-5-2-7-9-4-2-5-2-1	0.0-3.0-7.0-9.0-4.0-6.0-8.0-5.0-2.0-7.0-9.0-4.0-2.1-5.1-2.0-1.0	154	163043	175707
HG03927.verkko_filt_mat.fa:haplotype1-0000009_134765170_135173010_1	HG03927.verkko_filt_mat.fa:haplotype1-0000009_134765170_135173010_1	176468	210566	2	196	0	1	195	34098	208388	174290	0-3-7-9-4-6-8-5-2-7-9-4-2-5-2-1	0.0-3.0-7.0-9.0-4.0-6.0-8.0-5.0-2.0-7.0-9.0-4.0-2.1-5.1-2.0-1.0	154	176314	210412
HG03927.verkko_filt_mat.fa:haplotype1-0000009_134765170_135173010_1	HG03927.verkko_filt_mat.fa:haplotype1-0000009_134765170_135173010_1	211643	213683	7	12	0	0	11	2040	210428	208388	0-3-7-9-4-6-8-5-2-7-9-4-2-5-2-1	0.0-3.0-7.0-9.0-4.0-6.0-8.0-5.0-2.0-7.0-9.0-4.0-2.1-5.1-2.0-1.0	154	211489	213529
HG03927.verkko_filt_mat.fa:haplotype1-0000009_134765170_135173010_1	HG03927.verkko_filt_mat.fa:haplotype1-0000009_134765170_135173010_1	213627	214939	9	5	0	0	4	1312	211740	210428	0-3-7-9-4-6-8-5-2-7-9-4-2-5-2-1	0.0-3.0-7.0-9.0-4.0-6.0-8.0-5.0-2.0-7.0-9.0-4.0-2.1-5.1-2.0-1.0	154	213473	214785
HG03927.verkko_filt_mat.fa:haplotype1-0000009_134765170_135173010_1	HG03927.verkko_filt_mat.fa:haplotype1-0000009_134765170_135173010_1	216002	227548	4	84	0	4	58	11546	223286	211740	0-3-7-9-4-6-8-5-2-7-9-4-2-5-2-1	0.0-3.0-7.0-9.0-4.0-6.0-8.0-5.0-2.0-7.0-9.0-4.0-2.1-5.1-2.0-1.0	154	215848	227394
HG03927.verkko_filt_mat.fa:haplotype1-0000009_134765170_135173010_1	HG03927.verkko_filt_mat.fa:haplotype1-0000009_134765170_135173010_1	229414	263519	2	196	1	195	1	34105	257391	223286	0-3-7-9-4-6-8-5-2-7-9-4-2-5-2-1	0.0-3.0-7.0-9.0-4.0-6.0-8.0-5.0-2.0-7.0-9.0-4.0-2.1-5.1-2.0-1.0	154	229260	263365
HG03927.verkko_filt_mat.fa:haplotype1-0000009_134765170_135173010_1	HG03927.verkko_filt_mat.fa:haplotype1-0000009_134765170_135173010_1	264126	276341	5	79	1	77	3	12215	269606	257391	0-3-7-9-4-6-8-5-2-7-9-4-2-5-2-1	0.0-3.0-7.0-9.0-4.0-6.0-8.0-5.0-2.0-7.0-9.0-4.0-2.1-5.1-2.0-1.0	154	263972	276187
HG03927.verkko_filt_mat.fa:haplotype1-0000009_134765170_135173010_1	HG03927.verkko_filt_mat.fa:haplotype1-0000009_134765170_135173010_1	276780	304694	2	196	0	39	195	27914	297520	269606	0-3-7-9-4-6-8-5-2-7-9-4-2-5-2-1	0.0-3.0-7.0-9.0-4.0-6.0-8.0-5.0-2.0-7.0-9.0-4.0-2.1-5.1-2.0-1.0	154	276626	304540
HG03927.verkko_filt_mat.fa:haplotype1-0000009_134765170_135173010_1	HG03927.verkko_filt_mat.fa:haplotype1-0000009_134765170_135173010_1	304638	407824	1	612	0	0	611	103186	400706	297520	0-3-7-9-4-6-8-5-2-7-9-4-2-5-2-1	0.0-3.0-7.0-9.0-4.0-6.0-8.0-5.0-2.0-7.0-9.0-4.0-2.1-5.1-2.0-1.0	154	304484	407670
HG03927.verkko_filt_pat.fa:haplotype2-0000800_29002142_29504057_1	HG03927.verkko_filt_pat.fa:haplotype2-0000800_29002142_29504057_1	154	115531	0	672	0	0	671	115377	115377	0	0-3-7-9-4-6-8-5-2-7-9-4-2-5-2-7-9-4-2-5-2-1	0.0-3.0-7.0-9.0-4.0-6.0-8.0-5.0-2.0-7.0-9.0-4.0-2.1-5.1-2.0-7.0-9.0-4.0-2.1-5.1-2.0-1.0	154	0	115377
HG03927.verkko_filt_pat.fa:haplotype2-0000800_29002142_29504057_1	HG03927.verkko_filt_pat.fa:haplotype2-0000800_29002142_29504057_1	115622	138453	3	132	0	0	131	22831	138208	115377	0-3-7-9-4-6-8-5-2-7-9-4-2-5-2-7-9-4-2-5-2-1	0.0-3.0-7.0-9.0-4.0-6.0-8.0-5.0-2.0-7.0-9.0-4.0-2.1-5.1-2.0-7.0-9.0-4.0-2.1-5.1-2.0-1.0	154	115468	138299
HG03927.verkko_filt_pat.fa:haplotype2-0000800_29002142_29504057_1	HG03927.verkko_filt_pat.fa:haplotype2-0000800_29002142_29504057_1	139212	141252	7	12	0	0	11	2040	140248	138208	0-3-7-9-4-6-8-5-2-7-9-4-2-5-2-7-9-4-2-5-2-1	0.0-3.0-7.0-9.0-4.0-6.0-8.0-5.0-2.0-7.0-9.0-4.0-2.1-5.1-2.0-7.0-9.0-4.0-2.1-5.1-2.0-1.0	154	139058	141098
HG03927.verkko_filt_pat.fa:haplotype2-0000800_29002142_29504057_1	HG03927.verkko_filt_pat.fa:haplotype2-0000800_29002142_29504057_1	141196	142507	9	5	0	0	4	1311	141559	140248	0-3-7-9-4-6-8-5-2-7-9-4-2-5-2-7-9-4-2-5-2-1	0.0-3.0-7.0-9.0-4.0-6.0-8.0-5.0-2.0-7.0-9.0-4.0-2.1-5.1-2.0-7.0-9.0-4.0-2.1-5.1-2.0-1.0	154	141042	142353
HG03927.verkko_filt_pat.fa:haplotype2-0000800_29002142_29504057_1	HG03927.verkko_filt_pat.fa:haplotype2-0000800_29002142_29504057_1	143298	158748	4	84	0	1	83	15450	157009	141559	0-3-7-9-4-6-8-5-2-7-9-4-2-5-2-7-9-4-2-5-2-1	0.0-3.0-7.0-9.0-4.0-6.0-8.0-5.0-2.0-7.0-9.0-4.0-2.1-5.1-2.0-7.0-9.0-4.0-2.1-5.1-2.0-1.0	154	143144	158594
HG03927.verkko_filt_pat.fa:haplotype2-0000800_29002142_29504057_1	HG03927.verkko_filt_pat.fa:haplotype2-0000800_29002142_29504057_1	158692	161507	6	12	0	0	11	2815	159824	157009	0-3-7-9-4-6-8-5-2-7-9-4-2-5-2-7-9-4-2-5-2-1	0.0-3.0-7.0-9.0-4.0-6.0-8.0-5.0-2.0-7.0-9.0-4.0-2.1-5.1-2.0-7.0-9.0-4.0-2.1-5.1-2.0-1.0	154	158538	161353
HG03927.verkko_filt_pat.fa:haplotype2-0000800_29002142_29504057_1	HG03927.verkko_filt_pat.fa:haplotype2-0000800_29002142_29504057_1	161451	163221	8	8	0	0	7	1770	161594	159824	0-3-7-9-4-6-8-5-2-7-9-4-2-5-2-7-9-4-2-5-2-1	0.0-3.0-7.0-9.0-4.0-6.0-8.0-5.0-2.0-7.0-9.0-4.0-2.1-5.1-2.0-7.0-9.0-4.0-2.1-5.1-2.0-1.0	154	161297	163067
HG03927.verkko_filt_pat.fa:haplotype2-0000800_29002142_29504057_1	HG03927.verkko_filt_pat.fa:haplotype2-0000800_29002142_29504057_1	163165	176269	5	79	0	0	78	13104	174698	161594	0-3-7-9-4-6-8-5-2-7-9-4-2-5-2-7-9-4-2-5-2-1	0.0-3.0-7.0-9.0-4.0-6.0-8.0-5.0-2.0-7.0-9.0-4.0-2.1-5.1-2.0-7.0-9.0-4.0-2.1-5.1-2.0-1.0	154	163011	176115
HG03927.verkko_filt_pat.fa:haplotype2-0000800_29002142_29504057_1	HG03927.verkko_filt_pat.fa:haplotype2-0000800_29002142_29504057_1	176213	210532	2	196	0	0	195	34319	209017	174698	0-3-7-9-4-6-8-5-2-7-9-4-2-5-2-7-9-4-2-5-2-1	0.0-3.0-7.0-9.0-4.0-6.0-8.0-5.0-2.0-7.0-9.0-4.0-2.1-5.1-2.0-7.0-9.0-4.0-2.1-5.1-2.0-1.0	154	176059	210378
HG03927.verkko_filt_pat.fa:haplotype2-0000800_29002142_29504057_1	HG03927.verkko_filt_pat.fa:haplotype2-0000800_29002142_29504057_1	211609	213649	7	12	0	0	11	2040	211057	209017	0-3-7-9-4-6-8-5-2-7-9-4-2-5-2-7-9-4-2-5-2-1	0.0-3.0-7.0-9.0-4.0-6.0-8.0-5.0-2.0-7.0-9.0-4.0-2.1-5.1-2.0-7.0-9.0-4.0-2.1-5.1-2.0-1.0	154	211455	213495
HG03927.verkko_filt_pat.fa:haplotype2-0000800_29002142_29504057_1	HG03927.verkko_filt_pat.fa:haplotype2-0000800_29002142_29504057_1	213593	214904	9	5	0	0	4	1311	212368	211057	0-3-7-9-4-6-8-5-2-7-9-4-2-5-2-7-9-4-2-5-2-1	0.0-3.0-7.0-9.0-4.0-6.0-8.0-5.0-2.0-7.0-9.0-4.0-2.1-5.1-2.0-7.0-9.0-4.0-2.1-5.1-2.0-1.0	154	213439	214750
HG03927.verkko_filt_pat.fa:haplotype2-0000800_29002142_29504057_1	HG03927.verkko_filt_pat.fa:haplotype2-0000800_29002142_29504057_1	215967	227511	4	84	0	4	58	11544	223912	212368	0-3-7-9-4-6-8-5-2-7-9-4-2-5-2-7-9-4-2-5-2-1	0.0-3.0-7.0-9.0-4.0-6.0-8.0-5.0-2.0-7.0-9.0-4.0-2.1-5.1-2.0-7.0-9.0-4.0-2.1-5.1-2.0-1.0	154	215813	227357
HG03927.verkko_filt_pat.fa:haplotype2-0000800_29002142_29504057_1	HG03927.verkko_filt_pat.fa:haplotype2-0000800_29002142_29504057_1	229377	263696	2	196	1	195	0	34319	258231	223912	0-3-7-9-4-6-8-5-2-7-9-4-2-5-2-7-9-4-2-5-2-1	0.0-3.0-7.0-9.0-4.0-6.0-8.0-5.0-2.0-7.0-9.0-4.0-2.1-5.1-2.0-7.0-9.0-4.0-2.1-5.1-2.0-1.0	154	229223	263542
HG03927.verkko_filt_pat.fa:haplotype2-0000800_29002142_29504057_1	HG03927.verkko_filt_pat.fa:haplotype2-0000800_29002142_29504057_1	263640	276295	5	79	1	78	3	12655	270886	258231	0-3-7-9-4-6-8-5-2-7-9-4-2-5-2-7-9-4-2-5-2-1	0.0-3.0-7.0-9.0-4.0-6.0-8.0-5.0-2.0-7.0-9.0-4.0-2.1-5.1-2.0-7.0-9.0-4.0-2.1-5.1-2.0-1.0	154	263486	276141
HG03927.verkko_filt_pat.fa:haplotype2-0000800_29002142_29504057_1	HG03927.verkko_filt_pat.fa:haplotype2-0000800_29002142_29504057_1	276734	304649	2	196	0	39	195	27915	298801	270886	0-3-7-9-4-6-8-5-2-7-9-4-2-5-2-7-9-4-2-5-2-1	0.0-3.0-7.0-9.0-4.0-6.0-8.0-5.0-2.0-7.0-9.0-4.0-2.1-5.1-2.0-7.0-9.0-4.0-2.1-5.1-2.0-1.0	154	276580	304495
HG03927.verkko_filt_pat.fa:haplotype2-0000800_29002142_29504057_1	HG03927.verkko_filt_pat.fa:haplotype2-0000800_29002142_29504057_1	305726	307766	7	12	0	0	11	2040	300841	298801	0-3-7-9-4-6-8-5-2-7-9-4-2-5-2-7-9-4-2-5-2-1	0.0-3.0-7.0-9.0-4.0-6.0-8.0-5.0-2.0-7.0-9.0-4.0-2.1-5.1-2.0-7.0-9.0-4.0-2.1-5.1-2.0-1.0	154	305572	307612
HG03927.verkko_filt_pat.fa:haplotype2-0000800_29002142_29504057_1	HG03927.verkko_filt_pat.fa:haplotype2-0000800_29002142_29504057_1	307710	309021	9	5	0	0	4	1311	302152	300841	0-3-7-9-4-6-8-5-2-7-9-4-2-5-2-7-9-4-2-5-2-1	0.0-3.0-7.0-9.0-4.0-6.0-8.0-5.0-2.0-7.0-9.0-4.0-2.1-5.1-2.0-7.0-9.0-4.0-2.1-5.1-2.0-1.0	154	307556	308867
HG03927.verkko_filt_pat.fa:haplotype2-0000800_29002142_29504057_1	HG03927.verkko_filt_pat.fa:haplotype2-0000800_29002142_29504057_1	310084	321628	4	84	0	4	58	11544	313696	302152	0-3-7-9-4-6-8-5-2-7-9-4-2-5-2-7-9-4-2-5-2-1	0.0-3.0-7.0-9.0-4.0-6.0-8.0-5.0-2.0-7.0-9.0-4.0-2.1-5.1-2.0-7.0-9.0-4.0-2.1-5.1-2.0-1.0	154	309930	321474
HG03927.verkko_filt_pat.fa:haplotype2-0000800_29002142_29504057_1	HG03927.verkko_filt_pat.fa:haplotype2-0000800_29002142_29504057_1	323494	357813	2	196	1	195	0	34319	348015	313696	0-3-7-9-4-6-8-5-2-7-9-4-2-5-2-7-9-4-2-5-2-1	0.0-3.0-7.0-9.0-4.0-6.0-8.0-5.0-2.0-7.0-9.0-4.0-2.1-5.1-2.0-7.0-9.0-4.0-2.1-5.1-2.0-1.0	154	323340	357659
HG03927.verkko_filt_pat.fa:haplotype2-0000800_29002142_29504057_1	HG03927.verkko_filt_pat.fa:haplotype2-0000800_29002142_29504057_1	357757	370412	5	79	1	78	3	12655	360670	348015	0-3-7-9-4-6-8-5-2-7-9-4-2-5-2-7-9-4-2-5-2-1	0.0-3.0-7.0-9.0-4.0-6.0-8.0-5.0-2.0-7.0-9.0-4.0-2.1-5.1-2.0-7.0-9.0-4.0-2.1-5.1-2.0-1.0	154	357603	370258
HG03927.verkko_filt_pat.fa:haplotype2-0000800_29002142_29504057_1	HG03927.verkko_filt_pat.fa:haplotype2-0000800_29002142_29504057_1	370851	398760	2	196	0	39	195	27909	388579	360670	0-3-7-9-4-6-8-5-2-7-9-4-2-5-2-7-9-4-2-5-2-1	0.0-3.0-7.0-9.0-4.0-6.0-8.0-5.0-2.0-7.0-9.0-4.0-2.1-5.1-2.0-7.0-9.0-4.0-2.1-5.1-2.0-1.0	154	370697	398606
HG03927.verkko_filt_pat.fa:haplotype2-0000800_29002142_29504057_1	HG03927.verkko_filt_pat.fa:haplotype2-0000800_29002142_29504057_1	398704	501899	1	612	0	0	611	103195	491774	388579	0-3-7-9-4-6-8-5-2-7-9-4-2-5-2-7-9-4-2-5-2-1	0.0-3.0-7.0-9.0-4.0-6.0-8.0-5.0-2.0-7.0-9.0-4.0-2.1-5.1-2.0-7.0-9.0-4.0-2.1-5.1-2.0-1.0	154	398550	501745
HG04228.verkko_filt_mat.fa:haplotype1-0000023_103429213_103930285_0	HG04228.verkko_filt_mat.fa:haplotype1-0000023_103429213_103930285_0	99	115442	0	672	0	0	671	115343	115343	0	0-3-7-9-4-6-8-5-2-7-9-4-2-5-2-4-9-7-2-5-2-1	0.0-3.0-7.0-9.0-4.0-6.0-8.0-5.0-2.0-7.0-9.0-4.0-2.1-5.1-2.0-4.1-9.1-7.1-2.1-5.0-2.0-1.0	99	0	115343
HG04228.verkko_filt_mat.fa:haplotype1-0000023_103429213_103930285_0	HG04228.verkko_filt_mat.fa:haplotype1-0000023_103429213_103930285_0	115533	138370	3	132	0	0	131	22837	138180	115343	0-3-7-9-4-6-8-5-2-7-9-4-2-5-2-4-9-7-2-5-2-1	0.0-3.0-7.0-9.0-4.0-6.0-8.0-5.0-2.0-7.0-9.0-4.0-2.1-5.1-2.0-4.1-9.1-7.1-2.1-5.0-2.0-1.0	99	115434	138271
HG04228.verkko_filt_mat.fa:haplotype1-0000023_103429213_103930285_0	HG04228.verkko_filt_mat.fa:haplotype1-0000023_103429213_103930285_0	139129	141169	7	12	0	0	11	2040	140220	138180	0-3-7-9-4-6-8-5-2-7-9-4-2-5-2-4-9-7-2-5-2-1	0.0-3.0-7.0-9.0-4.0-6.0-8.0-5.0-2.0-7.0-9.0-4.0-2.1-5.1-2.0-4.1-9.1-7.1-2.1-5.0-2.0-1.0	99	139030	141070
HG04228.verkko_filt_mat.fa:haplotype1-0000023_103429213_103930285_0	HG04228.verkko_filt_mat.fa:haplotype1-0000023_103429213_103930285_0	141113	142425	9	5	0	0	4	1312	141532	140220	0-3-7-9-4-6-8-5-2-7-9-4-2-5-2-4-9-7-2-5-2-1	0.0-3.0-7.0-9.0-4.0-6.0-8.0-5.0-2.0-7.0-9.0-4.0-2.1-5.1-2.0-4.1-9.1-7.1-2.1-5.0-2.0-1.0	99	141014	142326
HG04228.verkko_filt_mat.fa:haplotype1-0000023_103429213_103930285_0	HG04228.verkko_filt_mat.fa:haplotype1-0000023_103429213_103930285_0	142873	158668	4	84	0	0	83	15795	157327	141532	0-3-7-9-4-6-8-5-2-7-9-4-2-5-2-4-9-7-2-5-2-1	0.0-3.0-7.0-9.0-4.0-6.0-8.0-5.0-2.0-7.0-9.0-4.0-2.1-5.1-2.0-4.1-9.1-7.1-2.1-5.0-2.0-1.0	99	142774	158569
HG04228.verkko_filt_mat.fa:haplotype1-0000023_103429213_103930285_0	HG04228.verkko_filt_mat.fa:haplotype1-0000023_103429213_103930285_0	158612	161428	6	12	0	0	11	2816	160143	157327	0-3-7-9-4-6-8-5-2-7-9-4-2-5-2-4-9-7-2-5-2-1	0.0-3.0-7.0-9.0-4.0-6.0-8.0-5.0-2.0-7.0-9.0-4.0-2.1-5.1-2.0-4.1-9.1-7.1-2.1-5.0-2.0-1.0	99	158513	161329
HG04228.verkko_filt_mat.fa:haplotype1-0000023_103429213_103930285_0	HG04228.verkko_filt_mat.fa:haplotype1-0000023_103429213_103930285_0	161372	163142	8	8	0	0	7	1770	161913	160143	0-3-7-9-4-6-8-5-2-7-9-4-2-5-2-4-9-7-2-5-2-1	0.0-3.0-7.0-9.0-4.0-6.0-8.0-5.0-2.0-7.0-9.0-4.0-2.1-5.1-2.0-4.1-9.1-7.1-2.1-5.0-2.0-1.0	99	161273	163043
HG04228.verkko_filt_mat.fa:haplotype1-0000023_103429213_103930285_0	HG04228.verkko_filt_mat.fa:haplotype1-0000023_103429213_103930285_0	163086	176188	5	79	0	0	78	13102	175015	161913	0-3-7-9-4-6-8-5-2-7-9-4-2-5-2-4-9-7-2-5-2-1	0.0-3.0-7.0-9.0-4.0-6.0-8.0-5.0-2.0-7.0-9.0-4.0-2.1-5.1-2.0-4.1-9.1-7.1-2.1-5.0-2.0-1.0	99	162987	176089
HG04228.verkko_filt_mat.fa:haplotype1-0000023_103429213_103930285_0	HG04228.verkko_filt_mat.fa:haplotype1-0000023_103429213_103930285_0	176132	210078	2	196	0	0	194	33946	208961	175015	0-3-7-9-4-6-8-5-2-7-9-4-2-5-2-4-9-7-2-5-2-1	0.0-3.0-7.0-9.0-4.0-6.0-8.0-5.0-2.0-7.0-9.0-4.0-2.1-5.1-2.0-4.1-9.1-7.1-2.1-5.0-2.0-1.0	99	176033	209979
HG04228.verkko_filt_mat.fa:haplotype1-0000023_103429213_103930285_0	HG04228.verkko_filt_mat.fa:haplotype1-0000023_103429213_103930285_0	211540	213580	7	12	0	0	11	2040	211001	208961	0-3-7-9-4-6-8-5-2-7-9-4-2-5-2-4-9-7-2-5-2-1	0.0-3.0-7.0-9.0-4.0-6.0-8.0-5.0-2.0-7.0-9.0-4.0-2.1-5.1-2.0-4.1-9.1-7.1-2.1-5.0-2.0-1.0	99	211441	213481
HG04228.verkko_filt_mat.fa:haplotype1-0000023_103429213_103930285_0	HG04228.verkko_filt_mat.fa:haplotype1-0000023_103429213_103930285_0	213524	214836	9	5	0	0	4	1312	212313	211001	0-3-7-9-4-6-8-5-2-7-9-4-2-5-2-4-9-7-2-5-2-1	0.0-3.0-7.0-9.0-4.0-6.0-8.0-5.0-2.0-7.0-9.0-4.0-2.1-5.1-2.0-4.1-9.1-7.1-2.1-5.0-2.0-1.0	99	213425	214737
HG04228.verkko_filt_mat.fa:haplotype1-0000023_103429213_103930285_0	HG04228.verkko_filt_mat.fa:haplotype1-0000023_103429213_103930285_0	215789	227439	4	84	0	2	58	11650	223963	212313	0-3-7-9-4-6-8-5-2-7-9-4-2-5-2-4-9-7-2-5-2-1	0.0-3.0-7.0-9.0-4.0-6.0-8.0-5.0-2.0-7.0-9.0-4.0-2.1-5.1-2.0-4.1-9.1-7.1-2.1-5.0-2.0-1.0	99	215690	227340
HG04228.verkko_filt_mat.fa:haplotype1-0000023_103429213_103930285_0	HG04228.verkko_filt_mat.fa:haplotype1-0000023_103429213_103930285_0	229690	263650	2	196	1	194	0	33960	257923	223963	0-3-7-9-4-6-8-5-2-7-9-4-2-5-2-4-9-7-2-5-2-1	0.0-3.0-7.0-9.0-4.0-6.0-8.0-5.0-2.0-7.0-9.0-4.0-2.1-5.1-2.0-4.1-9.1-7.1-2.1-5.0-2.0-1.0	99	229591	263551
HG04228.verkko_filt_mat.fa:haplotype1-0000023_103429213_103930285_0	HG04228.verkko_filt_mat.fa:haplotype1-0000023_103429213_103930285_0	263594	275722	5	79	1	78	5	12128	270051	257923	0-3-7-9-4-6-8-5-2-7-9-4-2-5-2-4-9-7-2-5-2-1	0.0-3.0-7.0-9.0-4.0-6.0-8.0-5.0-2.0-7.0-9.0-4.0-2.1-5.1-2.0-4.1-9.1-7.1-2.1-5.0-2.0-1.0	99	263495	275623
HG04228.verkko_filt_mat.fa:haplotype1-0000023_103429213_103930285_0	HG04228.verkko_filt_mat.fa:haplotype1-0000023_103429213_103930285_0	276688	303884	2	196	0	39	191	27196	297247	270051	0-3-7-9-4-6-8-5-2-7-9-4-2-5-2-4-9-7-2-5-2-1	0.0-3.0-7.0-9.0-4.0-6.0-8.0-5.0-2.0-7.0-9.0-4.0-2.1-5.1-2.0-4.1-9.1-7.1-2.1-5.0-2.0-1.0	99	276589	303785
HG04228.verkko_filt_mat.fa:haplotype1-0000023_103429213_103930285_0	HG04228.verkko_filt_mat.fa:haplotype1-0000023_103429213_103930285_0	306476	318020	4	84	1	58	4	11544	308791	297247	0-3-7-9-4-6-8-5-2-7-9-4-2-5-2-4-9-7-2-5-2-1	0.0-3.0-7.0-9.0-4.0-6.0-8.0-5.0-2.0-7.0-9.0-4.0-2.1-5.1-2.0-4.1-9.1-7.1-2.1-5.0-2.0-1.0	99	306377	317921
HG04228.verkko_filt_mat.fa:haplotype1-0000023_103429213_103930285_0	HG04228.verkko_filt_mat.fa:haplotype1-0000023_103429213_103930285_0	319087	320398	9	5	1	4	0	1311	310102	308791	0-3-7-9-4-6-8-5-2-7-9-4-2-5-2-4-9-7-2-5-2-1	0.0-3.0-7.0-9.0-4.0-6.0-8.0-5.0-2.0-7.0-9.0-4.0-2.1-5.1-2.0-4.1-9.1-7.1-2.1-5.0-2.0-1.0	99	318988	320299
HG04228.verkko_filt_mat.fa:haplotype1-0000023_103429213_103930285_0	HG04228.verkko_filt_mat.fa:haplotype1-0000023_103429213_103930285_0	320342	322382	7	12	1	11	0	2040	312142	310102	0-3-7-9-4-6-8-5-2-7-9-4-2-5-2-4-9-7-2-5-2-1	0.0-3.0-7.0-9.0-4.0-6.0-8.0-5.0-2.0-7.0-9.0-4.0-2.1-5.1-2.0-4.1-9.1-7.1-2.1-5.0-2.0-1.0	99	320243	322283
HG04228.verkko_filt_mat.fa:haplotype1-0000023_103429213_103930285_0	HG04228.verkko_filt_mat.fa:haplotype1-0000023_103429213_103930285_0	323844	351376	2	196	1	194	39	27532	339674	312142	0-3-7-9-4-6-8-5-2-7-9-4-2-5-2-4-9-7-2-5-2-1	0.0-3.0-7.0-9.0-4.0-6.0-8.0-5.0-2.0-7.0-9.0-4.0-2.1-5.1-2.0-4.1-9.1-7.1-2.1-5.0-2.0-1.0	99	323745	351277
HG04228.verkko_filt_mat.fa:haplotype1-0000023_103429213_103930285_0	HG04228.verkko_filt_mat.fa:haplotype1-0000023_103429213_103930285_0	352342	364030	5	79	0	5	77	11688	351362	339674	0-3-7-9-4-6-8-5-2-7-9-4-2-5-2-4-9-7-2-5-2-1	0.0-3.0-7.0-9.0-4.0-6.0-8.0-5.0-2.0-7.0-9.0-4.0-2.1-5.1-2.0-4.1-9.1-7.1-2.1-5.0-2.0-1.0	99	352243	363931
HG04228.verkko_filt_mat.fa:haplotype1-0000023_103429213_103930285_0	HG04228.verkko_filt_mat.fa:haplotype1-0000023_103429213_103930285_0	364637	398740	2	196	0	1	195	34103	385465	351362	0-3-7-9-4-6-8-5-2-7-9-4-2-5-2-4-9-7-2-5-2-1	0.0-3.0-7.0-9.0-4.0-6.0-8.0-5.0-2.0-7.0-9.0-4.0-2.1-5.1-2.0-4.1-9.1-7.1-2.1-5.0-2.0-1.0	99	364538	398641
HG04228.verkko_filt_mat.fa:haplotype1-0000023_103429213_103930285_0	HG04228.verkko_filt_mat.fa:haplotype1-0000023_103429213_103930285_0	398684	501128	1	612	0	0	606	102444	487909	385465	0-3-7-9-4-6-8-5-2-7-9-4-2-5-2-4-9-7-2-5-2-1	0.0-3.0-7.0-9.0-4.0-6.0-8.0-5.0-2.0-7.0-9.0-4.0-2.1-5.1-2.0-4.1-9.1-7.1-2.1-5.0-2.0-1.0	99	398585	501029
HG04228.verkko_filt_pat.fa:haplotype2-0000600_103806749_104119491_0	HG04228.verkko_filt_pat.fa:haplotype2-0000600_103806749_104119491_0	99	115473	0	672	0	0	671	115374	115374	0	0-3-7-9-4-6-8-5-2-1	0.0-3.0-7.0-9.0-4.0-6.0-8.0-5.0-2.0-1.0	99	0	115374
HG04228.verkko_filt_pat.fa:haplotype2-0000600_103806749_104119491_0	HG04228.verkko_filt_pat.fa:haplotype2-0000600_103806749_104119491_0	115564	138398	3	132	0	0	131	22834	138208	115374	0-3-7-9-4-6-8-5-2-1	0.0-3.0-7.0-9.0-4.0-6.0-8.0-5.0-2.0-1.0	99	115465	138299
HG04228.verkko_filt_pat.fa:haplotype2-0000600_103806749_104119491_0	HG04228.verkko_filt_pat.fa:haplotype2-0000600_103806749_104119491_0	139157	141197	7	12	0	0	11	2040	140248	138208	0-3-7-9-4-6-8-5-2-1	0.0-3.0-7.0-9.0-4.0-6.0-8.0-5.0-2.0-1.0	99	139058	141098
HG04228.verkko_filt_pat.fa:haplotype2-0000600_103806749_104119491_0	HG04228.verkko_filt_pat.fa:haplotype2-0000600_103806749_104119491_0	141141	142453	9	5	0	0	4	1312	141560	140248	0-3-7-9-4-6-8-5-2-1	0.0-3.0-7.0-9.0-4.0-6.0-8.0-5.0-2.0-1.0	99	141042	142354
HG04228.verkko_filt_pat.fa:haplotype2-0000600_103806749_104119491_0	HG04228.verkko_filt_pat.fa:haplotype2-0000600_103806749_104119491_0	142901	158696	4	84	0	0	83	15795	157355	141560	0-3-7-9-4-6-8-5-2-1	0.0-3.0-7.0-9.0-4.0-6.0-8.0-5.0-2.0-1.0	99	142802	158597
HG04228.verkko_filt_pat.fa:haplotype2-0000600_103806749_104119491_0	HG04228.verkko_filt_pat.fa:haplotype2-0000600_103806749_104119491_0	158640	161456	6	12	0	0	11	2816	160171	157355	0-3-7-9-4-6-8-5-2-1	0.0-3.0-7.0-9.0-4.0-6.0-8.0-5.0-2.0-1.0	99	158541	161357
HG04228.verkko_filt_pat.fa:haplotype2-0000600_103806749_104119491_0	HG04228.verkko_filt_pat.fa:haplotype2-0000600_103806749_104119491_0	161400	163170	8	8	0	0	7	1770	161941	160171	0-3-7-9-4-6-8-5-2-1	0.0-3.0-7.0-9.0-4.0-6.0-8.0-5.0-2.0-1.0	99	161301	163071
HG04228.verkko_filt_pat.fa:haplotype2-0000600_103806749_104119491_0	HG04228.verkko_filt_pat.fa:haplotype2-0000600_103806749_104119491_0	163114	176218	5	79	0	0	78	13104	175045	161941	0-3-7-9-4-6-8-5-2-1	0.0-3.0-7.0-9.0-4.0-6.0-8.0-5.0-2.0-1.0	99	163015	176119
HG04228.verkko_filt_pat.fa:haplotype2-0000600_103806749_104119491_0	HG04228.verkko_filt_pat.fa:haplotype2-0000600_103806749_104119491_0	176162	210481	2	196	0	0	195	34319	209364	175045	0-3-7-9-4-6-8-5-2-1	0.0-3.0-7.0-9.0-4.0-6.0-8.0-5.0-2.0-1.0	99	176063	210382
HG04228.verkko_filt_pat.fa:haplotype2-0000600_103806749_104119491_0	HG04228.verkko_filt_pat.fa:haplotype2-0000600_103806749_104119491_0	210425	312798	1	612	0	0	606	102373	311737	209364	0-3-7-9-4-6-8-5-2-1	0.0-3.0-7.0-9.0-4.0-6.0-8.0-5.0-2.0-1.0	99	210326	312699
NA18906#1#JAHEOO010000054.1_2103477_2510435_1	NA18906	154	115520	0	672	0	0	671	115366	115366	0	0-3-7-9-4-6-8-5-2-4-9-7-2-5-2-1	0.0-3.0-7.0-9.0-4.0-6.0-8.0-5.0-2.0-4.1-9.1-7.1-2.1-5.0-2.0-1.0	154	0	115366
NA18906#1#JAHEOO010000054.1_2103477_2510435_1	NA18906	115611	138444	3	132	0	0	131	22833	138199	115366	0-3-7-9-4-6-8-5-2-4-9-7-2-5-2-1	0.0-3.0-7.0-9.0-4.0-6.0-8.0-5.0-2.0-4.1-9.1-7.1-2.1-5.0-2.0-1.0	154	115457	138290
NA18906#1#JAHEOO010000054.1_2103477_2510435_1	NA18906	139203	141243	7	12	0	0	11	2040	140239	138199	0-3-7-9-4-6-8-5-2-4-9-7-2-5-2-1	0.0-3.0-7.0-9.0-4.0-6.0-8.0-5.0-2.0-4.1-9.1-7.1-2.1-5.0-2.0-1.0	154	139049	141089
NA18906#1#JAHEOO010000054.1_2103477_2510435_1	NA18906	141187	142498	9	5	0	0	4	1311	141550	140239	0-3-7-9-4-6-8-5-2-4-9-7-2-5-2-1	0.0-3.0-7.0-9.0-4.0-6.0-8.0-5.0-2.0-4.1-9.1-7.1-2.1-5.0-2.0-1.0	154	141033	142344
NA18906#1#JAHEOO010000054.1_2103477_2510435_1	NA18906	143565	158777	4	84	0	4	83	15212	156762	141550	0-3-7-9-4-6-8-5-2-4-9-7-2-5-2-1	0.0-3.0-7.0-9.0-4.0-6.0-8.0-5.0-2.0-4.1-9.1-7.1-2.1-5.0-2.0-1.0	154	143411	158623
NA18906#1#JAHEOO010000054.1_2103477_2510435_1	NA18906	158721	161536	6	12	0	0	11	2815	159577	156762	0-3-7-9-4-6-8-5-2-4-9-7-2-5-2-1	0.0-3.0-7.0-9.0-4.0-6.0-8.0-5.0-2.0-4.1-9.1-7.1-2.1-5.0-2.0-1.0	154	158567	161382
NA18906#1#JAHEOO010000054.1_2103477_2510435_1	NA18906	161480	163250	8	8	0	0	7	1770	161347	159577	0-3-7-9-4-6-8-5-2-4-9-7-2-5-2-1	0.0-3.0-7.0-9.0-4.0-6.0-8.0-5.0-2.0-4.1-9.1-7.1-2.1-5.0-2.0-1.0	154	161326	163096
NA18906#1#JAHEOO010000054.1_2103477_2510435_1	NA18906	163194	175892	5	79	0	0	77	12698	174045	161347	0-3-7-9-4-6-8-5-2-4-9-7-2-5-2-1	0.0-3.0-7.0-9.0-4.0-6.0-8.0-5.0-2.0-4.1-9.1-7.1-2.1-5.0-2.0-1.0	154	163040	175738
NA18906#1#JAHEOO010000054.1_2103477_2510435_1	NA18906	176499	210620	2	196	0	1	195	34121	208166	174045	0-3-7-9-4-6-8-5-2-4-9-7-2-5-2-1	0.0-3.0-7.0-9.0-4.0-6.0-8.0-5.0-2.0-4.1-9.1-7.1-2.1-5.0-2.0-1.0	154	176345	210466
NA18906#1#JAHEOO010000054.1_2103477_2510435_1	NA18906	212936	224031	4	84	1	56	4	11095	219261	208166	0-3-7-9-4-6-8-5-2-4-9-7-2-5-2-1	0.0-3.0-7.0-9.0-4.0-6.0-8.0-5.0-2.0-4.1-9.1-7.1-2.1-5.0-2.0-1.0	154	212782	223877
NA18906#1#JAHEOO010000054.1_2103477_2510435_1	NA18906	225094	226405	9	5	1	4	0	1311	220572	219261	0-3-7-9-4-6-8-5-2-4-9-7-2-5-2-1	0.0-3.0-7.0-9.0-4.0-6.0-8.0-5.0-2.0-4.1-9.1-7.1-2.1-5.0-2.0-1.0	154	224940	226251
NA18906#1#JAHEOO010000054.1_2103477_2510435_1	NA18906	226349	228389	7	12	1	11	0	2040	222612	220572	0-3-7-9-4-6-8-5-2-4-9-7-2-5-2-1	0.0-3.0-7.0-9.0-4.0-6.0-8.0-5.0-2.0-4.1-9.1-7.1-2.1-5.0-2.0-1.0	154	226195	228235
NA18906#1#JAHEOO010000054.1_2103477_2510435_1	NA18906	229466	257378	2	196	1	195	39	27912	250524	222612	0-3-7-9-4-6-8-5-2-4-9-7-2-5-2-1	0.0-3.0-7.0-9.0-4.0-6.0-8.0-5.0-2.0-4.1-9.1-7.1-2.1-5.0-2.0-1.0	154	229312	257224
NA18906#1#JAHEOO010000054.1_2103477_2510435_1	NA18906	258344	269558	5	79	0	5	75	11214	261738	250524	0-3-7-9-4-6-8-5-2-4-9-7-2-5-2-1	0.0-3.0-7.0-9.0-4.0-6.0-8.0-5.0-2.0-4.1-9.1-7.1-2.1-5.0-2.0-1.0	154	258190	269404
NA18906#1#JAHEOO010000054.1_2103477_2510435_1	NA18906	270639	304735	2	196	0	1	195	34096	295834	261738	0-3-7-9-4-6-8-5-2-4-9-7-2-5-2-1	0.0-3.0-7.0-9.0-4.0-6.0-8.0-5.0-2.0-4.1-9.1-7.1-2.1-5.0-2.0-1.0	154	270485	304581
NA18906#1#JAHEOO010000054.1_2103477_2510435_1	NA18906	304679	406754	1	612	0	0	604	102075	397909	295834	0-3-7-9-4-6-8-5-2-4-9-7-2-5-2-1	0.0-3.0-7.0-9.0-4.0-6.0-8.0-5.0-2.0-4.1-9.1-7.1-2.1-5.0-2.0-1.0	154	304525	406600
NA18906#2#JAHEON010000009.1_93748295_94249275_0	NA18906	98	115437	0	672	0	0	671	115339	115339	0	0-3-7-9-4-6-8-5-2-4-9-7-2-5-2-4-9-7-2-5-2-1	0.0-3.0-7.0-9.0-4.0-6.0-8.0-5.0-2.0-4.1-9.1-7.1-2.1-5.0-2.0-4.1-9.1-7.1-2.1-5.1-2.0-1.0	98	0	115339
NA18906#2#JAHEON010000009.1_93748295_94249275_0	NA18906	115528	138357	3	132	0	0	131	22829	138168	115339	0-3-7-9-4-6-8-5-2-4-9-7-2-5-2-4-9-7-2-5-2-1	0.0-3.0-7.0-9.0-4.0-6.0-8.0-5.0-2.0-4.1-9.1-7.1-2.1-5.0-2.0-4.1-9.1-7.1-2.1-5.1-2.0-1.0	98	115430	138259
NA18906#2#JAHEON010000009.1_93748295_94249275_0	NA18906	139116	141156	7	12	0	0	11	2040	140208	138168	0-3-7-9-4-6-8-5-2-4-9-7-2-5-2-4-9-7-2-5-2-1	0.0-3.0-7.0-9.0-4.0-6.0-8.0-5.0-2.0-4.1-9.1-7.1-2.1-5.0-2.0-4.1-9.1-7.1-2.1-5.1-2.0-1.0	98	139018	141058
NA18906#2#JAHEON010000009.1_93748295_94249275_0	NA18906	141100	142411	9	5	0	0	4	1311	141519	140208	0-3-7-9-4-6-8-5-2-4-9-7-2-5-2-4-9-7-2-5-2-1	0.0-3.0-7.0-9.0-4.0-6.0-8.0-5.0-2.0-4.1-9.1-7.1-2.1-5.0-2.0-4.1-9.1-7.1-2.1-5.1-2.0-1.0	98	141002	142313
NA18906#2#JAHEON010000009.1_93748295_94249275_0	NA18906	142859	158655	4	84	0	0	83	15796	157315	141519	0-3-7-9-4-6-8-5-2-4-9-7-2-5-2-4-9-7-2-5-2-1	0.0-3.0-7.0-9.0-4.0-6.0-8.0-5.0-2.0-4.1-9.1-7.1-2.1-5.0-2.0-4.1-9.1-7.1-2.1-5.1-2.0-1.0	98	142761	158557
NA18906#2#JAHEON010000009.1_93748295_94249275_0	NA18906	158599	161414	6	12	0	0	11	2815	160130	157315	0-3-7-9-4-6-8-5-2-4-9-7-2-5-2-4-9-7-2-5-2-1	0.0-3.0-7.0-9.0-4.0-6.0-8.0-5.0-2.0-4.1-9.1-7.1-2.1-5.0-2.0-4.1-9.1-7.1-2.1-5.1-2.0-1.0	98	158501	161316
NA18906#2#JAHEON010000009.1_93748295_94249275_0	NA18906	161358	163128	8	8	0	0	7	1770	161900	160130	0-3-7-9-4-6-8-5-2-4-9-7-2-5-2-4-9-7-2-5-2-1	0.0-3.0-7.0-9.0-4.0-6.0-8.0-5.0-2.0-4.1-9.1-7.1-2.1-5.0-2.0-4.1-9.1-7.1-2.1-5.1-2.0-1.0	98	161260	163030
NA18906#2#JAHEON010000009.1_93748295_94249275_0	NA18906	163072	175729	5	79	0	0	77	12657	174557	161900	0-3-7-9-4-6-8-5-2-4-9-7-2-5-2-4-9-7-2-5-2-1	0.0-3.0-7.0-9.0-4.0-6.0-8.0-5.0-2.0-4.1-9.1-7.1-2.1-5.0-2.0-4.1-9.1-7.1-2.1-5.1-2.0-1.0	98	162974	175631
NA18906#2#JAHEON010000009.1_93748295_94249275_0	NA18906	176113	210441	2	196	0	0	195	34328	208885	174557	0-3-7-9-4-6-8-5-2-4-9-7-2-5-2-4-9-7-2-5-2-1	0.0-3.0-7.0-9.0-4.0-6.0-8.0-5.0-2.0-4.1-9.1-7.1-2.1-5.0-2.0-4.1-9.1-7.1-2.1-5.1-2.0-1.0	98	176015	210343
NA18906#2#JAHEON010000009.1_93748295_94249275_0	NA18906	212307	223852	4	84	1	58	4	11545	220430	208885	0-3-7-9-4-6-8-5-2-4-9-7-2-5-2-4-9-7-2-5-2-1	0.0-3.0-7.0-9.0-4.0-6.0-8.0-5.0-2.0-4.1-9.1-7.1-2.1-5.0-2.0-4.1-9.1-7.1-2.1-5.1-2.0-1.0	98	212209	223754
NA18906#2#JAHEON010000009.1_93748295_94249275_0	NA18906	224919	226230	9	5	1	4	0	1311	221741	220430	0-3-7-9-4-6-8-5-2-4-9-7-2-5-2-4-9-7-2-5-2-1	0.0-3.0-7.0-9.0-4.0-6.0-8.0-5.0-2.0-4.1-9.1-7.1-2.1-5.0-2.0-4.1-9.1-7.1-2.1-5.1-2.0-1.0	98	224821	226132
NA18906#2#JAHEON010000009.1_93748295_94249275_0	NA18906	226174	228214	7	12	1	11	0	2040	223781	221741	0-3-7-9-4-6-8-5-2-4-9-7-2-5-2-4-9-7-2-5-2-1	0.0-3.0-7.0-9.0-4.0-6.0-8.0-5.0-2.0-4.1-9.1-7.1-2.1-5.0-2.0-4.1-9.1-7.1-2.1-5.1-2.0-1.0	98	226076	228116
NA18906#2#JAHEON010000009.1_93748295_94249275_0	NA18906	229291	257209	2	196	1	195	39	27918	251699	223781	0-3-7-9-4-6-8-5-2-4-9-7-2-5-2-4-9-7-2-5-2-1	0.0-3.0-7.0-9.0-4.0-6.0-8.0-5.0-2.0-4.1-9.1-7.1-2.1-5.0-2.0-4.1-9.1-7.1-2.1-5.1-2.0-1.0	98	229193	257111
NA18906#2#JAHEON010000009.1_93748295_94249275_0	NA18906	257648	269856	5	79	0	3	77	12208	263907	251699	0-3-7-9-4-6-8-5-2-4-9-7-2-5-2-4-9-7-2-5-2-1	0.0-3.0-7.0-9.0-4.0-6.0-8.0-5.0-2.0-4.1-9.1-7.1-2.1-5.0-2.0-4.1-9.1-7.1-2.1-5.1-2.0-1.0	98	257550	269758
NA18906#2#JAHEON010000009.1_93748295_94249275_0	NA18906	270240	304555	2	196	0	0	195	34315	298222	263907	0-3-7-9-4-6-8-5-2-4-9-7-2-5-2-4-9-7-2-5-2-1	0.0-3.0-7.0-9.0-4.0-6.0-8.0-5.0-2.0-4.1-9.1-7.1-2.1-5.0-2.0-4.1-9.1-7.1-2.1-5.1-2.0-1.0	98	270142	304457
NA18906#2#JAHEON010000009.1_93748295_94249275_0	NA18906	306421	317966	4	84	1	58	4	11545	309767	298222	0-3-7-9-4-6-8-5-2-4-9-7-2-5-2-4-9-7-2-5-2-1	0.0-3.0-7.0-9.0-4.0-6.0-8.0-5.0-2.0-4.1-9.1-7.1-2.1-5.0-2.0-4.1-9.1-7.1-2.1-5.1-2.0-1.0	98	306323	317868
NA18906#2#JAHEON010000009.1_93748295_94249275_0	NA18906	319033	320344	9	5	1	4	0	1311	311078	309767	0-3-7-9-4-6-8-5-2-4-9-7-2-5-2-4-9-7-2-5-2-1	0.0-3.0-7.0-9.0-4.0-6.0-8.0-5.0-2.0-4.1-9.1-7.1-2.1-5.0-2.0-4.1-9.1-7.1-2.1-5.1-2.0-1.0	98	318935	320246
NA18906#2#JAHEON010000009.1_93748295_94249275_0	NA18906	320288	322328	7	12	1	11	0	2040	313118	311078	0-3-7-9-4-6-8-5-2-4-9-7-2-5-2-4-9-7-2-5-2-1	0.0-3.0-7.0-9.0-4.0-6.0-8.0-5.0-2.0-4.1-9.1-7.1-2.1-5.0-2.0-4.1-9.1-7.1-2.1-5.1-2.0-1.0	98	320190	322230
NA18906#2#JAHEON010000009.1_93748295_94249275_0	NA18906	323405	357512	2	196	1	195	1	34107	347225	313118	0-3-7-9-4-6-8-5-2-4-9-7-2-5-2-4-9-7-2-5-2-1	0.0-3.0-7.0-9.0-4.0-6.0-8.0-5.0-2.0-4.1-9.1-7.1-2.1-5.0-2.0-4.1-9.1-7.1-2.1-5.1-2.0-1.0	98	323307	357414
NA18906#2#JAHEON010000009.1_93748295_94249275_0	NA18906	358119	370327	5	79	1	77	3	12208	359433	347225	0-3-7-9-4-6-8-5-2-4-9-7-2-5-2-4-9-7-2-5-2-1	0.0-3.0-7.0-9.0-4.0-6.0-8.0-5.0-2.0-4.1-9.1-7.1-2.1-5.0-2.0-4.1-9.1-7.1-2.1-5.1-2.0-1.0	98	358021	370229
NA18906#2#JAHEON010000009.1_93748295_94249275_0	NA18906	370766	398685	2	196	0	39	195	27919	387352	359433	0-3-7-9-4-6-8-5-2-4-9-7-2-5-2-4-9-7-2-5-2-1	0.0-3.0-7.0-9.0-4.0-6.0-8.0-5.0-2.0-4.1-9.1-7.1-2.1-5.0-2.0-4.1-9.1-7.1-2.1-5.1-2.0-1.0	98	370668	398587
NA18906#2#JAHEON010000009.1_93748295_94249275_0	NA18906	398629	501036	1	612	0	0	606	102407	489759	387352	0-3-7-9-4-6-8-5-2-4-9-7-2-5-2-4-9-7-2-5-2-1	0.0-3.0-7.0-9.0-4.0-6.0-8.0-5.0-2.0-4.1-9.1-7.1-2.1-5.0-2.0-4.1-9.1-7.1-2.1-5.1-2.0-1.0	98	398531	500938
NA19240#1#JAHEOM010000047.1_30103390_30511199_1	NA19240	154	115558	0	672	0	0	671	115404	115404	0	0-3-7-9-4-6-8-5-2-4-9-7-2-5-2-1	0.0-3.0-7.0-9.0-4.0-6.0-8.0-5.0-2.0-4.1-9.1-7.1-2.1-5.1-2.0-1.0	154	0	115404
NA19240#1#JAHEOM010000047.1_30103390_30511199_1	NA19240	115649	138484	3	132	0	0	131	22835	138239	115404	0-3-7-9-4-6-8-5-2-4-9-7-2-5-2-1	0.0-3.0-7.0-9.0-4.0-6.0-8.0-5.0-2.0-4.1-9.1-7.1-2.1-5.1-2.0-1.0	154	115495	138330
NA19240#1#JAHEOM010000047.1_30103390_30511199_1	NA19240	139243	141283	7	12	0	0	11	2040	140279	138239	0-3-7-9-4-6-8-5-2-4-9-7-2-5-2-1	0.0-3.0-7.0-9.0-4.0-6.0-8.0-5.0-2.0-4.1-9.1-7.1-2.1-5.1-2.0-1.0	154	139089	141129
NA19240#1#JAHEOM010000047.1_30103390_30511199_1	NA19240	141227	142538	9	5	0	0	4	1311	141590	140279	0-3-7-9-4-6-8-5-2-4-9-7-2-5-2-1	0.0-3.0-7.0-9.0-4.0-6.0-8.0-5.0-2.0-4.1-9.1-7.1-2.1-5.1-2.0-1.0	154	141073	142384
NA19240#1#JAHEOM010000047.1_30103390_30511199_1	NA19240	142986	158785	4	84	0	0	83	15799	157389	141590	0-3-7-9-4-6-8-5-2-4-9-7-2-5-2-1	0.0-3.0-7.0-9.0-4.0-6.0-8.0-5.0-2.0-4.1-9.1-7.1-2.1-5.1-2.0-1.0	154	142832	158631
NA19240#1#JAHEOM010000047.1_30103390_30511199_1	NA19240	158729	161544	6	12	0	0	11	2815	160204	157389	0-3-7-9-4-6-8-5-2-4-9-7-2-5-2-1	0.0-3.0-7.0-9.0-4.0-6.0-8.0-5.0-2.0-4.1-9.1-7.1-2.1-5.1-2.0-1.0	154	158575	161390
NA19240#1#JAHEOM010000047.1_30103390_30511199_1	NA19240	161488	163258	8	8	0	0	7	1770	161974	160204	0-3-7-9-4-6-8-5-2-4-9-7-2-5-2-1	0.0-3.0-7.0-9.0-4.0-6.0-8.0-5.0-2.0-4.1-9.1-7.1-2.1-5.1-2.0-1.0	154	161334	163104
NA19240#1#JAHEOM010000047.1_30103390_30511199_1	NA19240	163202	175393	5	79	0	0	75	12191	174165	161974	0-3-7-9-4-6-8-5-2-4-9-7-2-5-2-1	0.0-3.0-7.0-9.0-4.0-6.0-8.0-5.0-2.0-4.1-9.1-7.1-2.1-5.1-2.0-1.0	154	163048	175239
NA19240#1#JAHEOM010000047.1_30103390_30511199_1	NA19240	176474	210580	2	196	0	1	195	34106	208271	174165	0-3-7-9-4-6-8-5-2-4-9-7-2-5-2-1	0.0-3.0-7.0-9.0-4.0-6.0-8.0-5.0-2.0-4.1-9.1-7.1-2.1-5.1-2.0-1.0	154	176320	210426
NA19240#1#JAHEOM010000047.1_30103390_30511199_1	NA19240	212446	223572	4	84	1	58	6	11126	219397	208271	0-3-7-9-4-6-8-5-2-4-9-7-2-5-2-1	0.0-3.0-7.0-9.0-4.0-6.0-8.0-5.0-2.0-4.1-9.1-7.1-2.1-5.1-2.0-1.0	154	212292	223418
NA19240#1#JAHEOM010000047.1_30103390_30511199_1	NA19240	225059	226370	9	5	1	4	0	1311	220708	219397	0-3-7-9-4-6-8-5-2-4-9-7-2-5-2-1	0.0-3.0-7.0-9.0-4.0-6.0-8.0-5.0-2.0-4.1-9.1-7.1-2.1-5.1-2.0-1.0	154	224905	226216
NA19240#1#JAHEOM010000047.1_30103390_30511199_1	NA19240	226314	228354	7	12	1	11	0	2040	222748	220708	0-3-7-9-4-6-8-5-2-4-9-7-2-5-2-1	0.0-3.0-7.0-9.0-4.0-6.0-8.0-5.0-2.0-4.1-9.1-7.1-2.1-5.1-2.0-1.0	154	226160	228200
NA19240#1#JAHEOM010000047.1_30103390_30511199_1	NA19240	229816	263541	2	196	1	194	1	33725	256473	222748	0-3-7-9-4-6-8-5-2-4-9-7-2-5-2-1	0.0-3.0-7.0-9.0-4.0-6.0-8.0-5.0-2.0-4.1-9.1-7.1-2.1-5.1-2.0-1.0	154	229662	263387
NA19240#1#JAHEOM010000047.1_30103390_30511199_1	NA19240	264622	276519	5	79	1	75	2	11897	268370	256473	0-3-7-9-4-6-8-5-2-4-9-7-2-5-2-1	0.0-3.0-7.0-9.0-4.0-6.0-8.0-5.0-2.0-4.1-9.1-7.1-2.1-5.1-2.0-1.0	154	264468	276365
NA19240#1#JAHEOM010000047.1_30103390_30511199_1	NA19240	276801	304715	2	196	0	39	195	27914	296284	268370	0-3-7-9-4-6-8-5-2-4-9-7-2-5-2-1	0.0-3.0-7.0-9.0-4.0-6.0-8.0-5.0-2.0-4.1-9.1-7.1-2.1-5.1-2.0-1.0	154	276647	304561
NA19240#1#JAHEOM010000047.1_30103390_30511199_1	NA19240	304659	407793	1	612	0	0	611	103134	399418	296284	0-3-7-9-4-6-8-5-2-4-9-7-2-5-2-1	0.0-3.0-7.0-9.0-4.0-6.0-8.0-5.0-2.0-4.1-9.1-7.1-2.1-5.1-2.0-1.0	154	304505	407639
NA19240#2#JAHEOL010000010.1_37445323_37853017_0	NA19240	98	115416	0	672	0	0	671	115318	115318	0	0-3-7-9-4-6-8-5-2-7-9-4-2-5-2-1	0.0-3.0-7.0-9.0-4.0-6.0-8.0-5.0-2.0-7.0-9.0-4.0-2.1-5.1-2.0-1.0	98	0	115318
NA19240#2#JAHEOL010000010.1_37445323_37853017_0	NA19240	115507	138338	3	132	0	0	131	22831	138149	115318	0-3-7-9-4-6-8-5-2-7-9-4-2-5-2-1	0.0-3.0-7.0-9.0-4.0-6.0-8.0-5.0-2.0-7.0-9.0-4.0-2.1-5.1-2.0-1.0	98	115409	138240
NA19240#2#JAHEOL010000010.1_37445323_37853017_0	NA19240	139097	141137	7	12	0	0	11	2040	140189	138149	0-3-7-9-4-6-8-5-2-7-9-4-2-5-2-1	0.0-3.0-7.0-9.0-4.0-6.0-8.0-5.0-2.0-7.0-9.0-4.0-2.1-5.1-2.0-1.0	98	138999	141039
NA19240#2#JAHEOL010000010.1_37445323_37853017_0	NA19240	141081	142392	9	5	0	0	4	1311	141500	140189	0-3-7-9-4-6-8-5-2-7-9-4-2-5-2-1	0.0-3.0-7.0-9.0-4.0-6.0-8.0-5.0-2.0-7.0-9.0-4.0-2.1-5.1-2.0-1.0	98	140983	142294
NA19240#2#JAHEOL010000010.1_37445323_37853017_0	NA19240	143183	158631	4	84	0	1	83	15448	156948	141500	0-3-7-9-4-6-8-5-2-7-9-4-2-5-2-1	0.0-3.0-7.0-9.0-4.0-6.0-8.0-5.0-2.0-7.0-9.0-4.0-2.1-5.1-2.0-1.0	98	143085	158533
NA19240#2#JAHEOL010000010.1_37445323_37853017_0	NA19240	158575	161390	6	12	0	0	11	2815	159763	156948	0-3-7-9-4-6-8-5-2-7-9-4-2-5-2-1	0.0-3.0-7.0-9.0-4.0-6.0-8.0-5.0-2.0-7.0-9.0-4.0-2.1-5.1-2.0-1.0	98	158477	161292
NA19240#2#JAHEOL010000010.1_37445323_37853017_0	NA19240	161334	163104	8	8	0	0	7	1770	161533	159763	0-3-7-9-4-6-8-5-2-7-9-4-2-5-2-1	0.0-3.0-7.0-9.0-4.0-6.0-8.0-5.0-2.0-7.0-9.0-4.0-2.1-5.1-2.0-1.0	98	161236	163006
NA19240#2#JAHEOL010000010.1_37445323_37853017_0	NA19240	163048	175712	5	79	0	0	77	12664	174197	161533	0-3-7-9-4-6-8-5-2-7-9-4-2-5-2-1	0.0-3.0-7.0-9.0-4.0-6.0-8.0-5.0-2.0-7.0-9.0-4.0-2.1-5.1-2.0-1.0	98	162950	175614
NA19240#2#JAHEOL010000010.1_37445323_37853017_0	NA19240	176096	210413	2	196	0	0	195	34317	208514	174197	0-3-7-9-4-6-8-5-2-7-9-4-2-5-2-1	0.0-3.0-7.0-9.0-4.0-6.0-8.0-5.0-2.0-7.0-9.0-4.0-2.1-5.1-2.0-1.0	98	175998	210315
NA19240#2#JAHEOL010000010.1_37445323_37853017_0	NA19240	211490	213530	7	12	0	0	11	2040	210554	208514	0-3-7-9-4-6-8-5-2-7-9-4-2-5-2-1	0.0-3.0-7.0-9.0-4.0-6.0-8.0-5.0-2.0-7.0-9.0-4.0-2.1-5.1-2.0-1.0	98	211392	213432
NA19240#2#JAHEOL010000010.1_37445323_37853017_0	NA19240	213474	214785	9	5	0	0	4	1311	211865	210554	0-3-7-9-4-6-8-5-2-7-9-4-2-5-2-1	0.0-3.0-7.0-9.0-4.0-6.0-8.0-5.0-2.0-7.0-9.0-4.0-2.1-5.1-2.0-1.0	98	213376	214687
NA19240#2#JAHEOL010000010.1_37445323_37853017_0	NA19240	215848	227391	4	84	0	4	58	11543	223408	211865	0-3-7-9-4-6-8-5-2-7-9-4-2-5-2-1	0.0-3.0-7.0-9.0-4.0-6.0-8.0-5.0-2.0-7.0-9.0-4.0-2.1-5.1-2.0-1.0	98	215750	227293
NA19240#2#JAHEOL010000010.1_37445323_37853017_0	NA19240	229257	263357	2	196	1	195	1	34100	257508	223408	0-3-7-9-4-6-8-5-2-7-9-4-2-5-2-1	0.0-3.0-7.0-9.0-4.0-6.0-8.0-5.0-2.0-7.0-9.0-4.0-2.1-5.1-2.0-1.0	98	229159	263259
NA19240#2#JAHEOL010000010.1_37445323_37853017_0	NA19240	263964	276144	5	79	1	77	3	12180	269688	257508	0-3-7-9-4-6-8-5-2-7-9-4-2-5-2-1	0.0-3.0-7.0-9.0-4.0-6.0-8.0-5.0-2.0-7.0-9.0-4.0-2.1-5.1-2.0-1.0	98	263866	276046
NA19240#2#JAHEOL010000010.1_37445323_37853017_0	NA19240	276583	304496	2	196	0	39	195	27913	297601	269688	0-3-7-9-4-6-8-5-2-7-9-4-2-5-2-1	0.0-3.0-7.0-9.0-4.0-6.0-8.0-5.0-2.0-7.0-9.0-4.0-2.1-5.1-2.0-1.0	98	276485	304398
NA19240#2#JAHEOL010000010.1_37445323_37853017_0	NA19240	304440	407622	1	612	0	0	611	103182	400783	297601	0-3-7-9-4-6-8-5-2-7-9-4-2-5-2-1	0.0-3.0-7.0-9.0-4.0-6.0-8.0-5.0-2.0-7.0-9.0-4.0-2.1-5.1-2.0-1.0	98	304342	407524
NA20129#2#JAHEPD010000155.1_90039_569275_0	NA20129	98	115404	0	672	0	0	671	115306	115306	0	0-3-7-9-4-6-8-5-2-7-9-4-2-5-8-6-4-9-7-2-5-2-1	0.0-3.0-7.0-9.0-4.0-6.0-8.0-5.0-2.0-7.0-9.0-4.0-2.1-5.1-8.1-6.1-4.1-9.1-7.1-2.1-5.0-2.0-1.0	98	0	115306
NA20129#2#JAHEPD010000155.1_90039_569275_0	NA20129	115495	138315	3	132	0	0	131	22820	138126	115306	0-3-7-9-4-6-8-5-2-7-9-4-2-5-8-6-4-9-7-2-5-2-1	0.0-3.0-7.0-9.0-4.0-6.0-8.0-5.0-2.0-7.0-9.0-4.0-2.1-5.1-8.1-6.1-4.1-9.1-7.1-2.1-5.0-2.0-1.0	98	115397	138217
NA20129#2#JAHEPD010000155.1_90039_569275_0	NA20129	139074	141114	7	12	0	0	11	2040	140166	138126	0-3-7-9-4-6-8-5-2-7-9-4-2-5-8-6-4-9-7-2-5-2-1	0.0-3.0-7.0-9.0-4.0-6.0-8.0-5.0-2.0-7.0-9.0-4.0-2.1-5.1-8.1-6.1-4.1-9.1-7.1-2.1-5.0-2.0-1.0	98	138976	141016
NA20129#2#JAHEPD010000155.1_90039_569275_0	NA20129	141058	142369	9	5	0	0	4	1311	141477	140166	0-3-7-9-4-6-8-5-2-7-9-4-2-5-8-6-4-9-7-2-5-2-1	0.0-3.0-7.0-9.0-4.0-6.0-8.0-5.0-2.0-7.0-9.0-4.0-2.1-5.1-8.1-6.1-4.1-9.1-7.1-2.1-5.0-2.0-1.0	98	140960	142271
NA20129#2#JAHEPD010000155.1_90039_569275_0	NA20129	142817	158630	4	84	0	0	83	15813	157290	141477	0-3-7-9-4-6-8-5-2-7-9-4-2-5-8-6-4-9-7-2-5-2-1	0.0-3.0-7.0-9.0-4.0-6.0-8.0-5.0-2.0-7.0-9.0-4.0-2.1-5.1-8.1-6.1-4.1-9.1-7.1-2.1-5.0-2.0-1.0	98	142719	158532
NA20129#2#JAHEPD010000155.1_90039_569275_0	NA20129	158574	161389	6	12	0	0	11	2815	160105	157290	0-3-7-9-4-6-8-5-2-7-9-4-2-5-8-6-4-9-7-2-5-2-1	0.0-3.0-7.0-9.0-4.0-6.0-8.0-5.0-2.0-7.0-9.0-4.0-2.1-5.1-8.1-6.1-4.1-9.1-7.1-2.1-5.0-2.0-1.0	98	158476	161291
NA20129#2#JAHEPD010000155.1_90039_569275_0	NA20129	161333	163103	8	8	0	0	7	1770	161875	160105	0-3-7-9-4-6-8-5-2-7-9-4-2-5-8-6-4-9-7-2-5-2-1	0.0-3.0-7.0-9.0-4.0-6.0-8.0-5.0-2.0-7.0-9.0-4.0-2.1-5.1-8.1-6.1-4.1-9.1-7.1-2.1-5.0-2.0-1.0	98	161235	163005
NA20129#2#JAHEPD010000155.1_90039_569275_0	NA20129	163047	176151	5	79	0	0	78	13104	174979	161875	0-3-7-9-4-6-8-5-2-7-9-4-2-5-8-6-4-9-7-2-5-2-1	0.0-3.0-7.0-9.0-4.0-6.0-8.0-5.0-2.0-7.0-9.0-4.0-2.1-5.1-8.1-6.1-4.1-9.1-7.1-2.1-5.0-2.0-1.0	98	162949	176053
NA20129#2#JAHEPD010000155.1_90039_569275_0	NA20129	176095	210421	2	196	0	0	195	34326	209305	174979	0-3-7-9-4-6-8-5-2-7-9-4-2-5-8-6-4-9-7-2-5-2-1	0.0-3.0-7.0-9.0-4.0-6.0-8.0-5.0-2.0-7.0-9.0-4.0-2.1-5.1-8.1-6.1-4.1-9.1-7.1-2.1-5.0-2.0-1.0	98	175997	210323
NA20129#2#JAHEPD010000155.1_90039_569275_0	NA20129	211498	213538	7	12	0	0	11	2040	211345	209305	0-3-7-9-4-6-8-5-2-7-9-4-2-5-8-6-4-9-7-2-5-2-1	0.0-3.0-7.0-9.0-4.0-6.0-8.0-5.0-2.0-7.0-9.0-4.0-2.1-5.1-8.1-6.1-4.1-9.1-7.1-2.1-5.0-2.0-1.0	98	211400	213440
NA20129#2#JAHEPD010000155.1_90039_569275_0	NA20129	213482	214793	9	5	0	0	4	1311	212656	211345	0-3-7-9-4-6-8-5-2-7-9-4-2-5-8-6-4-9-7-2-5-2-1	0.0-3.0-7.0-9.0-4.0-6.0-8.0-5.0-2.0-7.0-9.0-4.0-2.1-5.1-8.1-6.1-4.1-9.1-7.1-2.1-5.0-2.0-1.0	98	213384	214695
NA20129#2#JAHEPD010000155.1_90039_569275_0	NA20129	215856	227404	4	84	0	4	58	11548	224204	212656	0-3-7-9-4-6-8-5-2-7-9-4-2-5-8-6-4-9-7-2-5-2-1	0.0-3.0-7.0-9.0-4.0-6.0-8.0-5.0-2.0-7.0-9.0-4.0-2.1-5.1-8.1-6.1-4.1-9.1-7.1-2.1-5.0-2.0-1.0	98	215758	227306
NA20129#2#JAHEPD010000155.1_90039_569275_0	NA20129	229270	263590	2	196	1	195	0	34320	258524	224204	0-3-7-9-4-6-8-5-2-7-9-4-2-5-8-6-4-9-7-2-5-2-1	0.0-3.0-7.0-9.0-4.0-6.0-8.0-5.0-2.0-7.0-9.0-4.0-2.1-5.1-8.1-6.1-4.1-9.1-7.1-2.1-5.0-2.0-1.0	98	229172	263492
NA20129#2#JAHEPD010000155.1_90039_569275_0	NA20129	263534	276638	5	79	1	78	0	13104	271628	258524	0-3-7-9-4-6-8-5-2-7-9-4-2-5-8-6-4-9-7-2-5-2-1	0.0-3.0-7.0-9.0-4.0-6.0-8.0-5.0-2.0-7.0-9.0-4.0-2.1-5.1-8.1-6.1-4.1-9.1-7.1-2.1-5.0-2.0-1.0	98	263436	276540
NA20129#2#JAHEPD010000155.1_90039_569275_0	NA20129	276826	278352	8	8	1	6	0	1526	273154	271628	0-3-7-9-4-6-8-5-2-7-9-4-2-5-8-6-4-9-7-2-5-2-1	0.0-3.0-7.0-9.0-4.0-6.0-8.0-5.0-2.0-7.0-9.0-4.0-2.1-5.1-8.1-6.1-4.1-9.1-7.1-2.1-5.0-2.0-1.0	98	276728	278254
NA20129#2#JAHEPD010000155.1_90039_569275_0	NA20129	278296	280468	6	12	1	11	1	2172	275326	273154	0-3-7-9-4-6-8-5-2-7-9-4-2-5-8-6-4-9-7-2-5-2-1	0.0-3.0-7.0-9.0-4.0-6.0-8.0-5.0-2.0-7.0-9.0-4.0-2.1-5.1-8.1-6.1-4.1-9.1-7.1-2.1-5.0-2.0-1.0	98	278198	280370
NA20129#2#JAHEPD010000155.1_90039_569275_0	NA20129	281129	296867	4	84	1	82	0	15738	291064	275326	0-3-7-9-4-6-8-5-2-7-9-4-2-5-8-6-4-9-7-2-5-2-1	0.0-3.0-7.0-9.0-4.0-6.0-8.0-5.0-2.0-7.0-9.0-4.0-2.1-5.1-8.1-6.1-4.1-9.1-7.1-2.1-5.0-2.0-1.0	98	281031	296769
NA20129#2#JAHEPD010000155.1_90039_569275_0	NA20129	297315	298626	9	5	1	4	0	1311	292375	291064	0-3-7-9-4-6-8-5-2-7-9-4-2-5-8-6-4-9-7-2-5-2-1	0.0-3.0-7.0-9.0-4.0-6.0-8.0-5.0-2.0-7.0-9.0-4.0-2.1-5.1-8.1-6.1-4.1-9.1-7.1-2.1-5.0-2.0-1.0	98	297217	298528
NA20129#2#JAHEPD010000155.1_90039_569275_0	NA20129	298570	300610	7	12	1	11	0	2040	294415	292375	0-3-7-9-4-6-8-5-2-7-9-4-2-5-8-6-4-9-7-2-5-2-1	0.0-3.0-7.0-9.0-4.0-6.0-8.0-5.0-2.0-7.0-9.0-4.0-2.1-5.1-8.1-6.1-4.1-9.1-7.1-2.1-5.0-2.0-1.0	98	298472	300512
NA20129#2#JAHEPD010000155.1_90039_569275_0	NA20129	301687	329426	2	196	1	195	40	27739	322154	294415	0-3-7-9-4-6-8-5-2-7-9-4-2-5-8-6-4-9-7-2-5-2-1	0.0-3.0-7.0-9.0-4.0-6.0-8.0-5.0-2.0-7.0-9.0-4.0-2.1-5.1-8.1-6.1-4.1-9.1-7.1-2.1-5.0-2.0-1.0	98	301589	329328
NA20129#2#JAHEPD010000155.1_90039_569275_0	NA20129	330046	342226	5	79	0	3	77	12180	334334	322154	0-3-7-9-4-6-8-5-2-7-9-4-2-5-8-6-4-9-7-2-5-2-1	0.0-3.0-7.0-9.0-4.0-6.0-8.0-5.0-2.0-7.0-9.0-4.0-2.1-5.1-8.1-6.1-4.1-9.1-7.1-2.1-5.0-2.0-1.0	98	329948	342128
NA20129#2#JAHEPD010000155.1_90039_569275_0	NA20129	342833	376935	2	196	0	1	195	34102	368436	334334	0-3-7-9-4-6-8-5-2-7-9-4-2-5-8-6-4-9-7-2-5-2-1	0.0-3.0-7.0-9.0-4.0-6.0-8.0-5.0-2.0-7.0-9.0-4.0-2.1-5.1-8.1-6.1-4.1-9.1-7.1-2.1-5.0-2.0-1.0	98	342735	376837
NA20129#2#JAHEPD010000155.1_90039_569275_0	NA20129	376879	479292	1	612	0	0	606	102413	470849	368436	0-3-7-9-4-6-8-5-2-7-9-4-2-5-8-6-4-9-7-2-5-2-1	0.0-3.0-7.0-9.0-4.0-6.0-8.0-5.0-2.0-7.0-9.0-4.0-2.1-5.1-8.1-6.1-4.1-9.1-7.1-2.1-5.0-2.0-1.0	98	376781	479194
chr1_chm13_103304997_103901127_0	chr1_chm13_103304997_103901127_0	99	115472	0	672	0	0	671	115373	115373	0	0-3-7-9-4-6-8-5-2-4-9-7-2-5-2-4-9-7-2-5-2-4-9-7-2-5-2-1	0.0-3.0-7.0-9.0-4.0-6.0-8.0-5.0-2.0-4.1-9.1-7.1-2.1-5.1-2.0-4.1-9.1-7.1-2.1-5.0-2.0-4.1-9.1-7.1-2.1-5.0-2.0-1.0	99	0	115373
chr1_chm13_103304997_103901127_0	chr1_chm13_103304997_103901127_0	115563	138400	3	132	0	0	131	22837	138210	115373	0-3-7-9-4-6-8-5-2-4-9-7-2-5-2-4-9-7-2-5-2-4-9-7-2-5-2-1	0.0-3.0-7.0-9.0-4.0-6.0-8.0-5.0-2.0-4.1-9.1-7.1-2.1-5.1-2.0-4.1-9.1-7.1-2.1-5.0-2.0-4.1-9.1-7.1-2.1-5.0-2.0-1.0	99	115464	138301
chr1_chm13_103304997_103901127_0	chr1_chm13_103304997_103901127_0	139159	141199	7	12	0	0	11	2040	140250	138210	0-3-7-9-4-6-8-5-2-4-9-7-2-5-2-4-9-7-2-5-2-4-9-7-2-5-2-1	0.0-3.0-7.0-9.0-4.0-6.0-8.0-5.0-2.0-4.1-9.1-7.1-2.1-5.1-2.0-4.1-9.1-7.1-2.1-5.0-2.0-4.1-9.1-7.1-2.1-5.0-2.0-1.0	99	139060	141100
chr1_chm13_103304997_103901127_0	chr1_chm13_103304997_103901127_0	141143	142455	9	5	0	0	4	1312	141562	140250	0-3-7-9-4-6-8-5-2-4-9-7-2-5-2-4-9-7-2-5-2-4-9-7-2-5-2-1	0.0-3.0-7.0-9.0-4.0-6.0-8.0-5.0-2.0-4.1-9.1-7.1-2.1-5.1-2.0-4.1-9.1-7.1-2.1-5.0-2.0-4.1-9.1-7.1-2.1-5.0-2.0-1.0	99	141044	142356
chr1_chm13_103304997_103901127_0	chr1_chm13_103304997_103901127_0	143249	158700	4	84	0	1	83	15451	157013	141562	0-3-7-9-4-6-8-5-2-4-9-7-2-5-2-4-9-7-2-5-2-4-9-7-2-5-2-1	0.0-3.0-7.0-9.0-4.0-6.0-8.0-5.0-2.0-4.1-9.1-7.1-2.1-5.1-2.0-4.1-9.1-7.1-2.1-5.0-2.0-4.1-9.1-7.1-2.1-5.0-2.0-1.0	99	143150	158601
chr1_chm13_103304997_103901127_0	chr1_chm13_103304997_103901127_0	158644	161460	6	12	0	0	11	2816	159829	157013	0-3-7-9-4-6-8-5-2-4-9-7-2-5-2-4-9-7-2-5-2-4-9-7-2-5-2-1	0.0-3.0-7.0-9.0-4.0-6.0-8.0-5.0-2.0-4.1-9.1-7.1-2.1-5.1-2.0-4.1-9.1-7.1-2.1-5.0-2.0-4.1-9.1-7.1-2.1-5.0-2.0-1.0	99	158545	161361
chr1_chm13_103304997_103901127_0	chr1_chm13_103304997_103901127_0	161404	163174	8	8	0	0	7	1770	161599	159829	0-3-7-9-4-6-8-5-2-4-9-7-2-5-2-4-9-7-2-5-2-4-9-7-2-5-2-1	0.0-3.0-7.0-9.0-4.0-6.0-8.0-5.0-2.0-4.1-9.1-7.1-2.1-5.1-2.0-4.1-9.1-7.1-2.1-5.0-2.0-4.1-9.1-7.1-2.1-5.0-2.0-1.0	99	161305	163075
chr1_chm13_103304997_103901127_0	chr1_chm13_103304997_103901127_0	163118	176222	5	79	0	0	78	13104	174703	161599	0-3-7-9-4-6-8-5-2-4-9-7-2-5-2-4-9-7-2-5-2-4-9-7-2-5-2-1	0.0-3.0-7.0-9.0-4.0-6.0-8.0-5.0-2.0-4.1-9.1-7.1-2.1-5.1-2.0-4.1-9.1-7.1-2.1-5.0-2.0-4.1-9.1-7.1-2.1-5.0-2.0-1.0	99	163019	176123
chr1_chm13_103304997_103901127_0	chr1_chm13_103304997_103901127_0	176166	210101	2	196	0	0	194	33935	208638	174703	0-3-7-9-4-6-8-5-2-4-9-7-2-5-2-4-9-7-2-5-2-4-9-7-2-5-2-1	0.0-3.0-7.0-9.0-4.0-6.0-8.0-5.0-2.0-4.1-9.1-7.1-2.1-5.1-2.0-4.1-9.1-7.1-2.1-5.0-2.0-4.1-9.1-7.1-2.1-5.0-2.0-1.0	99	176067	210002
chr1_chm13_103304997_103901127_0	chr1_chm13_103304997_103901127_0	212352	224166	4	84	1	58	1	11814	220452	208638	0-3-7-9-4-6-8-5-2-4-9-7-2-5-2-4-9-7-2-5-2-4-9-7-2-5-2-1	0.0-3.0-7.0-9.0-4.0-6.0-8.0-5.0-2.0-4.1-9.1-7.1-2.1-5.1-2.0-4.1-9.1-7.1-2.1-5.0-2.0-4.1-9.1-7.1-2.1-5.0-2.0-1.0	99	212253	224067
chr1_chm13_103304997_103901127_0	chr1_chm13_103304997_103901127_0	224960	226272	9	5	1	4	0	1312	221764	220452	0-3-7-9-4-6-8-5-2-4-9-7-2-5-2-4-9-7-2-5-2-4-9-7-2-5-2-1	0.0-3.0-7.0-9.0-4.0-6.0-8.0-5.0-2.0-4.1-9.1-7.1-2.1-5.1-2.0-4.1-9.1-7.1-2.1-5.0-2.0-4.1-9.1-7.1-2.1-5.0-2.0-1.0	99	224861	226173
chr1_chm13_103304997_103901127_0	chr1_chm13_103304997_103901127_0	226216	228256	7	12	1	11	0	2040	223804	221764	0-3-7-9-4-6-8-5-2-4-9-7-2-5-2-4-9-7-2-5-2-4-9-7-2-5-2-1	0.0-3.0-7.0-9.0-4.0-6.0-8.0-5.0-2.0-4.1-9.1-7.1-2.1-5.1-2.0-4.1-9.1-7.1-2.1-5.0-2.0-4.1-9.1-7.1-2.1-5.0-2.0-1.0	99	226117	228157
chr1_chm13_103304997_103901127_0	chr1_chm13_103304997_103901127_0	229718	263674	2	196	1	194	0	33956	257760	223804	0-3-7-9-4-6-8-5-2-4-9-7-2-5-2-4-9-7-2-5-2-4-9-7-2-5-2-1	0.0-3.0-7.0-9.0-4.0-6.0-8.0-5.0-2.0-4.1-9.1-7.1-2.1-5.1-2.0-4.1-9.1-7.1-2.1-5.0-2.0-4.1-9.1-7.1-2.1-5.0-2.0-1.0	99	229619	263575
chr1_chm13_103304997_103901127_0	chr1_chm13_103304997_103901127_0	263618	275746	5	79	1	78	5	12128	269888	257760	0-3-7-9-4-6-8-5-2-4-9-7-2-5-2-4-9-7-2-5-2-4-9-7-2-5-2-1	0.0-3.0-7.0-9.0-4.0-6.0-8.0-5.0-2.0-4.1-9.1-7.1-2.1-5.1-2.0-4.1-9.1-7.1-2.1-5.0-2.0-4.1-9.1-7.1-2.1-5.0-2.0-1.0	99	263519	275647
chr1_chm13_103304997_103901127_0	chr1_chm13_103304997_103901127_0	276712	303901	2	196	0	39	191	27189	297077	269888	0-3-7-9-4-6-8-5-2-4-9-7-2-5-2-4-9-7-2-5-2-4-9-7-2-5-2-1	0.0-3.0-7.0-9.0-4.0-6.0-8.0-5.0-2.0-4.1-9.1-7.1-2.1-5.1-2.0-4.1-9.1-7.1-2.1-5.0-2.0-4.1-9.1-7.1-2.1-5.0-2.0-1.0	99	276613	303802
chr1_chm13_103304997_103901127_0	chr1_chm13_103304997_103901127_0	306493	317620	4	84	1	58	6	11127	308204	297077	0-3-7-9-4-6-8-5-2-4-9-7-2-5-2-4-9-7-2-5-2-4-9-7-2-5-2-1	0.0-3.0-7.0-9.0-4.0-6.0-8.0-5.0-2.0-4.1-9.1-7.1-2.1-5.1-2.0-4.1-9.1-7.1-2.1-5.0-2.0-4.1-9.1-7.1-2.1-5.0-2.0-1.0	99	306394	317521
chr1_chm13_103304997_103901127_0	chr1_chm13_103304997_103901127_0	319107	320418	9	5	1	4	0	1311	309515	308204	0-3-7-9-4-6-8-5-2-4-9-7-2-5-2-4-9-7-2-5-2-4-9-7-2-5-2-1	0.0-3.0-7.0-9.0-4.0-6.0-8.0-5.0-2.0-4.1-9.1-7.1-2.1-5.1-2.0-4.1-9.1-7.1-2.1-5.0-2.0-4.1-9.1-7.1-2.1-5.0-2.0-1.0	99	319008	320319
chr1_chm13_103304997_103901127_0	chr1_chm13_103304997_103901127_0	320362	322402	7	12	1	11	0	2040	311555	309515	0-3-7-9-4-6-8-5-2-4-9-7-2-5-2-4-9-7-2-5-2-4-9-7-2-5-2-1	0.0-3.0-7.0-9.0-4.0-6.0-8.0-5.0-2.0-4.1-9.1-7.1-2.1-5.1-2.0-4.1-9.1-7.1-2.1-5.0-2.0-4.1-9.1-7.1-2.1-5.0-2.0-1.0	99	320263	322303
chr1_chm13_103304997_103901127_0	chr1_chm13_103304997_103901127_0	323864	351396	2	196	1	194	39	27532	339087	311555	0-3-7-9-4-6-8-5-2-4-9-7-2-5-2-4-9-7-2-5-2-4-9-7-2-5-2-1	0.0-3.0-7.0-9.0-4.0-6.0-8.0-5.0-2.0-4.1-9.1-7.1-2.1-5.1-2.0-4.1-9.1-7.1-2.1-5.0-2.0-4.1-9.1-7.1-2.1-5.0-2.0-1.0	99	323765	351297
chr1_chm13_103304997_103901127_0	chr1_chm13_103304997_103901127_0	352843	364050	5	79	0	8	77	11207	350294	339087	0-3-7-9-4-6-8-5-2-4-9-7-2-5-2-4-9-7-2-5-2-4-9-7-2-5-2-1	0.0-3.0-7.0-9.0-4.0-6.0-8.0-5.0-2.0-4.1-9.1-7.1-2.1-5.1-2.0-4.1-9.1-7.1-2.1-5.0-2.0-4.1-9.1-7.1-2.1-5.0-2.0-1.0	99	352744	363951
chr1_chm13_103304997_103901127_0	chr1_chm13_103304997_103901127_0	364657	398034	2	196	0	1	191	33377	383671	350294	0-3-7-9-4-6-8-5-2-4-9-7-2-5-2-4-9-7-2-5-2-4-9-7-2-5-2-1	0.0-3.0-7.0-9.0-4.0-6.0-8.0-5.0-2.0-4.1-9.1-7.1-2.1-5.1-2.0-4.1-9.1-7.1-2.1-5.0-2.0-4.1-9.1-7.1-2.1-5.0-2.0-1.0	99	364558	397935
chr1_chm13_103304997_103901127_0	chr1_chm13_103304997_103901127_0	400626	412170	4	84	1	58	4	11544	395215	383671	0-3-7-9-4-6-8-5-2-4-9-7-2-5-2-4-9-7-2-5-2-4-9-7-2-5-2-1	0.0-3.0-7.0-9.0-4.0-6.0-8.0-5.0-2.0-4.1-9.1-7.1-2.1-5.1-2.0-4.1-9.1-7.1-2.1-5.0-2.0-4.1-9.1-7.1-2.1-5.0-2.0-1.0	99	400527	412071
chr1_chm13_103304997_103901127_0	chr1_chm13_103304997_103901127_0	413239	414550	9	5	1	4	0	1311	396526	395215	0-3-7-9-4-6-8-5-2-4-9-7-2-5-2-4-9-7-2-5-2-4-9-7-2-5-2-1	0.0-3.0-7.0-9.0-4.0-6.0-8.0-5.0-2.0-4.1-9.1-7.1-2.1-5.1-2.0-4.1-9.1-7.1-2.1-5.0-2.0-4.1-9.1-7.1-2.1-5.0-2.0-1.0	99	413140	414451
chr1_chm13_103304997_103901127_0	chr1_chm13_103304997_103901127_0	414494	416534	7	12	1	11	0	2040	398566	396526	0-3-7-9-4-6-8-5-2-4-9-7-2-5-2-4-9-7-2-5-2-4-9-7-2-5-2-1	0.0-3.0-7.0-9.0-4.0-6.0-8.0-5.0-2.0-4.1-9.1-7.1-2.1-5.1-2.0-4.1-9.1-7.1-2.1-5.0-2.0-4.1-9.1-7.1-2.1-5.0-2.0-1.0	99	414395	416435
chr1_chm13_103304997_103901127_0	chr1_chm13_103304997_103901127_0	417996	445526	2	196	1	194	39	27530	426096	398566	0-3-7-9-4-6-8-5-2-4-9-7-2-5-2-4-9-7-2-5-2-4-9-7-2-5-2-1	0.0-3.0-7.0-9.0-4.0-6.0-8.0-5.0-2.0-4.1-9.1-7.1-2.1-5.1-2.0-4.1-9.1-7.1-2.1-5.0-2.0-4.1-9.1-7.1-2.1-5.0-2.0-1.0	99	417897	445427
chr1_chm13_103304997_103901127_0	chr1_chm13_103304997_103901127_0	446973	458180	5	79	0	8	77	11207	437303	426096	0-3-7-9-4-6-8-5-2-4-9-7-2-5-2-4-9-7-2-5-2-4-9-7-2-5-2-1	0.0-3.0-7.0-9.0-4.0-6.0-8.0-5.0-2.0-4.1-9.1-7.1-2.1-5.1-2.0-4.1-9.1-7.1-2.1-5.0-2.0-4.1-9.1-7.1-2.1-5.0-2.0-1.0	99	446874	458081
chr1_chm13_103304997_103901127_0	chr1_chm13_103304997_103901127_0	458787	492896	2	196	0	1	195	34109	471412	437303	0-3-7-9-4-6-8-5-2-4-9-7-2-5-2-4-9-7-2-5-2-4-9-7-2-5-2-1	0.0-3.0-7.0-9.0-4.0-6.0-8.0-5.0-2.0-4.1-9.1-7.1-2.1-5.1-2.0-4.1-9.1-7.1-2.1-5.0-2.0-4.1-9.1-7.1-2.1-5.0-2.0-1.0	99	458688	492797
chr1_chm13_103304997_103901127_0	chr1_chm13_103304997_103901127_0	492840	596058	1	612	0	0	611	103218	574630	471412	0-3-7-9-4-6-8-5-2-4-9-7-2-5-2-4-9-7-2-5-2-4-9-7-2-5-2-1	0.0-3.0-7.0-9.0-4.0-6.0-8.0-5.0-2.0-4.1-9.1-7.1-2.1-5.1-2.0-4.1-9.1-7.1-2.1-5.0-2.0-4.1-9.1-7.1-2.1-5.0-2.0-1.0	99	492741	595959
chr1_hg19_103998686_104406594_0	chr1_hg19_103998686_104406594_0	99	115462	0	672	0	0	671	115363	115363	0	0-3-7-9-4-6-8-5-2-4-9-7-2-5-2-1	0.0-3.0-7.0-9.0-4.0-6.0-8.0-5.0-2.0-4.1-9.1-7.1-2.1-5.0-2.0-1.0	99	0	115363
chr1_hg19_103998686_104406594_0	chr1_hg19_103998686_104406594_0	115553	138389	3	132	0	0	131	22836	138199	115363	0-3-7-9-4-6-8-5-2-4-9-7-2-5-2-1	0.0-3.0-7.0-9.0-4.0-6.0-8.0-5.0-2.0-4.1-9.1-7.1-2.1-5.0-2.0-1.0	99	115454	138290
chr1_hg19_103998686_104406594_0	chr1_hg19_103998686_104406594_0	139148	141188	7	12	0	0	11	2040	140239	138199	0-3-7-9-4-6-8-5-2-4-9-7-2-5-2-1	0.0-3.0-7.0-9.0-4.0-6.0-8.0-5.0-2.0-4.1-9.1-7.1-2.1-5.0-2.0-1.0	99	139049	141089
chr1_hg19_103998686_104406594_0	chr1_hg19_103998686_104406594_0	141132	142444	9	5	0	0	4	1312	141551	140239	0-3-7-9-4-6-8-5-2-4-9-7-2-5-2-1	0.0-3.0-7.0-9.0-4.0-6.0-8.0-5.0-2.0-4.1-9.1-7.1-2.1-5.0-2.0-1.0	99	141033	142345
chr1_hg19_103998686_104406594_0	chr1_hg19_103998686_104406594_0	142892	158687	4	84	0	0	83	15795	157346	141551	0-3-7-9-4-6-8-5-2-4-9-7-2-5-2-1	0.0-3.0-7.0-9.0-4.0-6.0-8.0-5.0-2.0-4.1-9.1-7.1-2.1-5.0-2.0-1.0	99	142793	158588
chr1_hg19_103998686_104406594_0	chr1_hg19_103998686_104406594_0	158631	161447	6	12	0	0	11	2816	160162	157346	0-3-7-9-4-6-8-5-2-4-9-7-2-5-2-1	0.0-3.0-7.0-9.0-4.0-6.0-8.0-5.0-2.0-4.1-9.1-7.1-2.1-5.0-2.0-1.0	99	158532	161348
chr1_hg19_103998686_104406594_0	chr1_hg19_103998686_104406594_0	161391	163161	8	8	0	0	7	1770	161932	160162	0-3-7-9-4-6-8-5-2-4-9-7-2-5-2-1	0.0-3.0-7.0-9.0-4.0-6.0-8.0-5.0-2.0-4.1-9.1-7.1-2.1-5.0-2.0-1.0	99	161292	163062
chr1_hg19_103998686_104406594_0	chr1_hg19_103998686_104406594_0	163105	176288	5	79	0	0	78	13183	175115	161932	0-3-7-9-4-6-8-5-2-4-9-7-2-5-2-1	0.0-3.0-7.0-9.0-4.0-6.0-8.0-5.0-2.0-4.1-9.1-7.1-2.1-5.0-2.0-1.0	99	163006	176189
chr1_hg19_103998686_104406594_0	chr1_hg19_103998686_104406594_0	176232	210167	2	196	0	0	194	33935	209050	175115	0-3-7-9-4-6-8-5-2-4-9-7-2-5-2-1	0.0-3.0-7.0-9.0-4.0-6.0-8.0-5.0-2.0-4.1-9.1-7.1-2.1-5.0-2.0-1.0	99	176133	210068
chr1_hg19_103998686_104406594_0	chr1_hg19_103998686_104406594_0	212418	223963	4	84	1	58	4	11545	220595	209050	0-3-7-9-4-6-8-5-2-4-9-7-2-5-2-1	0.0-3.0-7.0-9.0-4.0-6.0-8.0-5.0-2.0-4.1-9.1-7.1-2.1-5.0-2.0-1.0	99	212319	223864
chr1_hg19_103998686_104406594_0	chr1_hg19_103998686_104406594_0	225028	226339	9	5	1	4	0	1311	221906	220595	0-3-7-9-4-6-8-5-2-4-9-7-2-5-2-1	0.0-3.0-7.0-9.0-4.0-6.0-8.0-5.0-2.0-4.1-9.1-7.1-2.1-5.0-2.0-1.0	99	224929	226240
chr1_hg19_103998686_104406594_0	chr1_hg19_103998686_104406594_0	226283	228323	7	12	1	11	0	2040	223946	221906	0-3-7-9-4-6-8-5-2-4-9-7-2-5-2-1	0.0-3.0-7.0-9.0-4.0-6.0-8.0-5.0-2.0-4.1-9.1-7.1-2.1-5.0-2.0-1.0	99	226184	228224
chr1_hg19_103998686_104406594_0	chr1_hg19_103998686_104406594_0	229785	257319	2	196	1	194	39	27534	251480	223946	0-3-7-9-4-6-8-5-2-4-9-7-2-5-2-1	0.0-3.0-7.0-9.0-4.0-6.0-8.0-5.0-2.0-4.1-9.1-7.1-2.1-5.0-2.0-1.0	99	229686	257220
chr1_hg19_103998686_104406594_0	chr1_hg19_103998686_104406594_0	258285	270413	5	79	0	5	78	12128	263608	251480	0-3-7-9-4-6-8-5-2-4-9-7-2-5-2-1	0.0-3.0-7.0-9.0-4.0-6.0-8.0-5.0-2.0-4.1-9.1-7.1-2.1-5.0-2.0-1.0	99	258186	270314
chr1_hg19_103998686_104406594_0	chr1_hg19_103998686_104406594_0	270357	304690	2	196	0	0	195	34333	297941	263608	0-3-7-9-4-6-8-5-2-4-9-7-2-5-2-1	0.0-3.0-7.0-9.0-4.0-6.0-8.0-5.0-2.0-4.1-9.1-7.1-2.1-5.0-2.0-1.0	99	270258	304591
chr1_hg19_103998686_104406594_0	chr1_hg19_103998686_104406594_0	304634	407836	1	612	0	0	611	103202	401143	297941	0-3-7-9-4-6-8-5-2-4-9-7-2-5-2-1	0.0-3.0-7.0-9.0-4.0-6.0-8.0-5.0-2.0-4.1-9.1-7.1-2.1-5.0-2.0-1.0	99	304535	407737
chr1_hg38_103456064_103863972_0	chr1_hg38_103456064_103863972_0	99	115462	0	672	0	0	671	115363	115363	0	0-3-7-9-4-6-8-5-2-4-9-7-2-5-2-1	0.0-3.0-7.0-9.0-4.0-6.0-8.0-5.0-2.0-4.1-9.1-7.1-2.1-5.0-2.0-1.0	99	0	115363
chr1_hg38_103456064_103863972_0	chr1_hg38_103456064_103863972_0	115553	138389	3	132	0	0	131	22836	138199	115363	0-3-7-9-4-6-8-5-2-4-9-7-2-5-2-1	0.0-3.0-7.0-9.0-4.0-6.0-8.0-5.0-2.0-4.1-9.1-7.1-2.1-5.0-2.0-1.0	99	115454	138290
chr1_hg38_103456064_103863972_0	chr1_hg38_103456064_103863972_0	139148	141188	7	12	0	0	11	2040	140239	138199	0-3-7-9-4-6-8-5-2-4-9-7-2-5-2-1	0.0-3.0-7.0-9.0-4.0-6.0-8.0-5.0-2.0-4.1-9.1-7.1-2.1-5.0-2.0-1.0	99	139049	141089
chr1_hg38_103456064_103863972_0	chr1_hg38_103456064_103863972_0	141132	142444	9	5	0	0	4	1312	141551	140239	0-3-7-9-4-6-8-5-2-4-9-7-2-5-2-1	0.0-3.0-7.0-9.0-4.0-6.0-8.0-5.0-2.0-4.1-9.1-7.1-2.1-5.0-2.0-1.0	99	141033	142345
chr1_hg38_103456064_103863972_0	chr1_hg38_103456064_103863972_0	142892	158687	4	84	0	0	83	15795	157346	141551	0-3-7-9-4-6-8-5-2-4-9-7-2-5-2-1	0.0-3.0-7.0-9.0-4.0-6.0-8.0-5.0-2.0-4.1-9.1-7.1-2.1-5.0-2.0-1.0	99	142793	158588
chr1_hg38_103456064_103863972_0	chr1_hg38_103456064_103863972_0	158631	161447	6	12	0	0	11	2816	160162	157346	0-3-7-9-4-6-8-5-2-4-9-7-2-5-2-1	0.0-3.0-7.0-9.0-4.0-6.0-8.0-5.0-2.0-4.1-9.1-7.1-2.1-5.0-2.0-1.0	99	158532	161348
chr1_hg38_103456064_103863972_0	chr1_hg38_103456064_103863972_0	161391	163161	8	8	0	0	7	1770	161932	160162	0-3-7-9-4-6-8-5-2-4-9-7-2-5-2-1	0.0-3.0-7.0-9.0-4.0-6.0-8.0-5.0-2.0-4.1-9.1-7.1-2.1-5.0-2.0-1.0	99	161292	163062
chr1_hg38_103456064_103863972_0	chr1_hg38_103456064_103863972_0	163105	176288	5	79	0	0	78	13183	175115	161932	0-3-7-9-4-6-8-5-2-4-9-7-2-5-2-1	0.0-3.0-7.0-9.0-4.0-6.0-8.0-5.0-2.0-4.1-9.1-7.1-2.1-5.0-2.0-1.0	99	163006	176189
chr1_hg38_103456064_103863972_0	chr1_hg38_103456064_103863972_0	176232	210167	2	196	0	0	194	33935	209050	175115	0-3-7-9-4-6-8-5-2-4-9-7-2-5-2-1	0.0-3.0-7.0-9.0-4.0-6.0-8.0-5.0-2.0-4.1-9.1-7.1-2.1-5.0-2.0-1.0	99	176133	210068
chr1_hg38_103456064_103863972_0	chr1_hg38_103456064_103863972_0	212418	223963	4	84	1	58	4	11545	220595	209050	0-3-7-9-4-6-8-5-2-4-9-7-2-5-2-1	0.0-3.0-7.0-9.0-4.0-6.0-8.0-5.0-2.0-4.1-9.1-7.1-2.1-5.0-2.0-1.0	99	212319	223864
chr1_hg38_103456064_103863972_0	chr1_hg38_103456064_103863972_0	225028	226339	9	5	1	4	0	1311	221906	220595	0-3-7-9-4-6-8-5-2-4-9-7-2-5-2-1	0.0-3.0-7.0-9.0-4.0-6.0-8.0-5.0-2.0-4.1-9.1-7.1-2.1-5.0-2.0-1.0	99	224929	226240
chr1_hg38_103456064_103863972_0	chr1_hg38_103456064_103863972_0	226283	228323	7	12	1	11	0	2040	223946	221906	0-3-7-9-4-6-8-5-2-4-9-7-2-5-2-1	0.0-3.0-7.0-9.0-4.0-6.0-8.0-5.0-2.0-4.1-9.1-7.1-2.1-5.0-2.0-1.0	99	226184	228224
chr1_hg38_103456064_103863972_0	chr1_hg38_103456064_103863972_0	229785	257319	2	196	1	194	39	27534	251480	223946	0-3-7-9-4-6-8-5-2-4-9-7-2-5-2-1	0.0-3.0-7.0-9.0-4.0-6.0-8.0-5.0-2.0-4.1-9.1-7.1-2.1-5.0-2.0-1.0	99	229686	257220
chr1_hg38_103456064_103863972_0	chr1_hg38_103456064_103863972_0	258285	270413	5	79	0	5	78	12128	263608	251480	0-3-7-9-4-6-8-5-2-4-9-7-2-5-2-1	0.0-3.0-7.0-9.0-4.0-6.0-8.0-5.0-2.0-4.1-9.1-7.1-2.1-5.0-2.0-1.0	99	258186	270314
chr1_hg38_103456064_103863972_0	chr1_hg38_103456064_103863972_0	270357	304690	2	196	0	0	195	34333	297941	263608	0-3-7-9-4-6-8-5-2-4-9-7-2-5-2-1	0.0-3.0-7.0-9.0-4.0-6.0-8.0-5.0-2.0-4.1-9.1-7.1-2.1-5.0-2.0-1.0	99	270258	304591
chr1_hg38_103456064_103863972_0	chr1_hg38_103456064_103863972_0	304634	407836	1	612	0	0	611	103202	401143	297941	0-3-7-9-4-6-8-5-2-4-9-7-2-5-2-1	0.0-3.0-7.0-9.0-4.0-6.0-8.0-5.0-2.0-4.1-9.1-7.1-2.1-5.0-2.0-1.0	99	304535	407737
