contig	sample_id	bstart	bend	bID	bdunno	bOrientation	entryix	exitix	seg_len	rel_end	rel_start	hap_struc	hap_struc_d	hap_block_start	rel_start2	rel_end2
AV_HG00673#haplotype1#0000019:16627360-17129375	AV_HG00673	100	115475	0	671	0	0	670	115375	115375	0	0-3-7-4-8-5-6-2-4-7-2-5-6-2-4-7-2-5-6-2-1	0.0-3.0-7.0-4.0-8.0-5.0-6.0-2.0-4.1-7.1-2.1-5.0-6.0-2.0-4.1-7.1-2.1-5.0-6.0-2.0-1.0	100	0	115375
AV_HG00673#haplotype1#0000019:16627360-17129375	AV_HG00673	115566	138404	3	132	0	0	131	22838	138213	115375	0-3-7-4-8-5-6-2-4-7-2-5-6-2-4-7-2-5-6-2-1	0.0-3.0-7.0-4.0-8.0-5.0-6.0-2.0-4.1-7.1-2.1-5.0-6.0-2.0-4.1-7.1-2.1-5.0-6.0-2.0-1.0	100	115466	138304
AV_HG00673#haplotype1#0000019:16627360-17129375	AV_HG00673	139163	142459	7	17	0	0	16	3296	141509	138213	0-3-7-4-8-5-6-2-4-7-2-5-6-2-4-7-2-5-6-2-1	0.0-3.0-7.0-4.0-8.0-5.0-6.0-2.0-4.1-7.1-2.1-5.0-6.0-2.0-4.1-7.1-2.1-5.0-6.0-2.0-1.0	100	139063	142359
AV_HG00673#haplotype1#0000019:16627360-17129375	AV_HG00673	142907	161460	4	96	0	0	95	18553	160062	141509	0-3-7-4-8-5-6-2-4-7-2-5-6-2-4-7-2-5-6-2-1	0.0-3.0-7.0-4.0-8.0-5.0-6.0-2.0-4.1-7.1-2.1-5.0-6.0-2.0-4.1-7.1-2.1-5.0-6.0-2.0-1.0	100	142807	161360
AV_HG00673#haplotype1#0000019:16627360-17129375	AV_HG00673	161404	163174	8	8	0	0	7	1770	161832	160062	0-3-7-4-8-5-6-2-4-7-2-5-6-2-4-7-2-5-6-2-1	0.0-3.0-7.0-4.0-8.0-5.0-6.0-2.0-4.1-7.1-2.1-5.0-6.0-2.0-4.1-7.1-2.1-5.0-6.0-2.0-1.0	100	161304	163074
AV_HG00673#haplotype1#0000019:16627360-17129375	AV_HG00673	163118	176222	5	78	0	0	77	13104	174936	161832	0-3-7-4-8-5-6-2-4-7-2-5-6-2-4-7-2-5-6-2-1	0.0-3.0-7.0-4.0-8.0-5.0-6.0-2.0-4.1-7.1-2.1-5.0-6.0-2.0-4.1-7.1-2.1-5.0-6.0-2.0-1.0	100	163018	176122
AV_HG00673#haplotype1#0000019:16627360-17129375	AV_HG00673	176166	178910	6	24	0	0	21	2744	177680	174936	0-3-7-4-8-5-6-2-4-7-2-5-6-2-4-7-2-5-6-2-1	0.0-3.0-7.0-4.0-8.0-5.0-6.0-2.0-4.1-7.1-2.1-5.0-6.0-2.0-4.1-7.1-2.1-5.0-6.0-2.0-1.0	100	176066	178810
AV_HG00673#haplotype1#0000019:16627360-17129375	AV_HG00673	179268	210104	2	172	0	0	170	30836	208516	177680	0-3-7-4-8-5-6-2-4-7-2-5-6-2-4-7-2-5-6-2-1	0.0-3.0-7.0-4.0-8.0-5.0-6.0-2.0-4.1-7.1-2.1-5.0-6.0-2.0-4.1-7.1-2.1-5.0-6.0-2.0-1.0	100	179168	210004
AV_HG00673#haplotype1#0000019:16627360-17129375	AV_HG00673	212355	223900	4	96	1	58	4	11545	220061	208516	0-3-7-4-8-5-6-2-4-7-2-5-6-2-4-7-2-5-6-2-1	0.0-3.0-7.0-4.0-8.0-5.0-6.0-2.0-4.1-7.1-2.1-5.0-6.0-2.0-4.1-7.1-2.1-5.0-6.0-2.0-1.0	100	212255	223800
AV_HG00673#haplotype1#0000019:16627360-17129375	AV_HG00673	224967	228262	7	17	1	16	0	3295	223356	220061	0-3-7-4-8-5-6-2-4-7-2-5-6-2-4-7-2-5-6-2-1	0.0-3.0-7.0-4.0-8.0-5.0-6.0-2.0-4.1-7.1-2.1-5.0-6.0-2.0-4.1-7.1-2.1-5.0-6.0-2.0-1.0	100	224867	228162
AV_HG00673#haplotype1#0000019:16627360-17129375	AV_HG00673	229724	257258	2	172	1	170	15	27534	250890	223356	0-3-7-4-8-5-6-2-4-7-2-5-6-2-4-7-2-5-6-2-1	0.0-3.0-7.0-4.0-8.0-5.0-6.0-2.0-4.1-7.1-2.1-5.0-6.0-2.0-4.1-7.1-2.1-5.0-6.0-2.0-1.0	100	229624	257158
AV_HG00673#haplotype1#0000019:16627360-17129375	AV_HG00673	258224	270352	5	78	0	5	77	12128	263018	250890	0-3-7-4-8-5-6-2-4-7-2-5-6-2-4-7-2-5-6-2-1	0.0-3.0-7.0-4.0-8.0-5.0-6.0-2.0-4.1-7.1-2.1-5.0-6.0-2.0-4.1-7.1-2.1-5.0-6.0-2.0-1.0	100	258124	270252
AV_HG00673#haplotype1#0000019:16627360-17129375	AV_HG00673	270296	273040	6	24	0	0	21	2744	265762	263018	0-3-7-4-8-5-6-2-4-7-2-5-6-2-4-7-2-5-6-2-1	0.0-3.0-7.0-4.0-8.0-5.0-6.0-2.0-4.1-7.1-2.1-5.0-6.0-2.0-4.1-7.1-2.1-5.0-6.0-2.0-1.0	100	270196	272940
AV_HG00673#haplotype1#0000019:16627360-17129375	AV_HG00673	273418	303916	2	172	0	0	167	30498	296260	265762	0-3-7-4-8-5-6-2-4-7-2-5-6-2-4-7-2-5-6-2-1	0.0-3.0-7.0-4.0-8.0-5.0-6.0-2.0-4.1-7.1-2.1-5.0-6.0-2.0-4.1-7.1-2.1-5.0-6.0-2.0-1.0	100	273318	303816
AV_HG00673#haplotype1#0000019:16627360-17129375	AV_HG00673	306508	318054	4	96	1	58	4	11546	307806	296260	0-3-7-4-8-5-6-2-4-7-2-5-6-2-4-7-2-5-6-2-1	0.0-3.0-7.0-4.0-8.0-5.0-6.0-2.0-4.1-7.1-2.1-5.0-6.0-2.0-4.1-7.1-2.1-5.0-6.0-2.0-1.0	100	306408	317954
AV_HG00673#haplotype1#0000019:16627360-17129375	AV_HG00673	319121	322416	7	17	1	16	0	3295	311101	307806	0-3-7-4-8-5-6-2-4-7-2-5-6-2-4-7-2-5-6-2-1	0.0-3.0-7.0-4.0-8.0-5.0-6.0-2.0-4.1-7.1-2.1-5.0-6.0-2.0-4.1-7.1-2.1-5.0-6.0-2.0-1.0	100	319021	322316
AV_HG00673#haplotype1#0000019:16627360-17129375	AV_HG00673	323878	351404	2	172	1	170	15	27526	338627	311101	0-3-7-4-8-5-6-2-4-7-2-5-6-2-4-7-2-5-6-2-1	0.0-3.0-7.0-4.0-8.0-5.0-6.0-2.0-4.1-7.1-2.1-5.0-6.0-2.0-4.1-7.1-2.1-5.0-6.0-2.0-1.0	100	323778	351304
AV_HG00673#haplotype1#0000019:16627360-17129375	AV_HG00673	352370	364498	5	78	0	5	77	12128	350755	338627	0-3-7-4-8-5-6-2-4-7-2-5-6-2-4-7-2-5-6-2-1	0.0-3.0-7.0-4.0-8.0-5.0-6.0-2.0-4.1-7.1-2.1-5.0-6.0-2.0-4.1-7.1-2.1-5.0-6.0-2.0-1.0	100	352270	364398
AV_HG00673#haplotype1#0000019:16627360-17129375	AV_HG00673	364442	367186	6	24	0	0	21	2744	353499	350755	0-3-7-4-8-5-6-2-4-7-2-5-6-2-4-7-2-5-6-2-1	0.0-3.0-7.0-4.0-8.0-5.0-6.0-2.0-4.1-7.1-2.1-5.0-6.0-2.0-4.1-7.1-2.1-5.0-6.0-2.0-1.0	100	364342	367086
AV_HG00673#haplotype1#0000019:16627360-17129375	AV_HG00673	367563	398781	2	172	0	0	171	31218	384717	353499	0-3-7-4-8-5-6-2-4-7-2-5-6-2-4-7-2-5-6-2-1	0.0-3.0-7.0-4.0-8.0-5.0-6.0-2.0-4.1-7.1-2.1-5.0-6.0-2.0-4.1-7.1-2.1-5.0-6.0-2.0-1.0	100	367463	398681
AV_HG00673#haplotype1#0000019:16627360-17129375	AV_HG00673	398725	501943	1	612	0	0	611	103218	487935	384717	0-3-7-4-8-5-6-2-4-7-2-5-6-2-4-7-2-5-6-2-1	0.0-3.0-7.0-4.0-8.0-5.0-6.0-2.0-4.1-7.1-2.1-5.0-6.0-2.0-4.1-7.1-2.1-5.0-6.0-2.0-1.0	100	398625	501843
AV_HG00673#haplotype2#0001165:24014011-24421797	AV_HG00673	99	115506	0	671	0	0	670	115407	115407	0	0-3-7-4-8-5-6-2-7-4-2-6-5-2-1	0.0-3.0-7.0-4.0-8.0-5.0-6.0-2.0-7.0-4.0-2.1-6.1-5.1-2.0-1.0	99	0	115407
AV_HG00673#haplotype2#0001165:24014011-24421797	AV_HG00673	115597	138429	3	132	0	0	131	22832	138239	115407	0-3-7-4-8-5-6-2-7-4-2-6-5-2-1	0.0-3.0-7.0-4.0-8.0-5.0-6.0-2.0-7.0-4.0-2.1-6.1-5.1-2.0-1.0	99	115498	138330
AV_HG00673#haplotype2#0001165:24014011-24421797	AV_HG00673	139188	142104	7	17	0	0	14	2916	141155	138239	0-3-7-4-8-5-6-2-7-4-2-6-5-2-1	0.0-3.0-7.0-4.0-8.0-5.0-6.0-2.0-7.0-4.0-2.1-6.1-5.1-2.0-1.0	99	139089	142005
AV_HG00673#haplotype2#0001165:24014011-24421797	AV_HG00673	143274	161481	4	96	0	1	95	18207	159362	141155	0-3-7-4-8-5-6-2-7-4-2-6-5-2-1	0.0-3.0-7.0-4.0-8.0-5.0-6.0-2.0-7.0-4.0-2.1-6.1-5.1-2.0-1.0	99	143175	161382
AV_HG00673#haplotype2#0001165:24014011-24421797	AV_HG00673	161425	163195	8	8	0	0	7	1770	161132	159362	0-3-7-4-8-5-6-2-7-4-2-6-5-2-1	0.0-3.0-7.0-4.0-8.0-5.0-6.0-2.0-7.0-4.0-2.1-6.1-5.1-2.0-1.0	99	161326	163096
AV_HG00673#haplotype2#0001165:24014011-24421797	AV_HG00673	163139	176243	5	78	0	0	77	13104	174236	161132	0-3-7-4-8-5-6-2-7-4-2-6-5-2-1	0.0-3.0-7.0-4.0-8.0-5.0-6.0-2.0-7.0-4.0-2.1-6.1-5.1-2.0-1.0	99	163040	176144
AV_HG00673#haplotype2#0001165:24014011-24421797	AV_HG00673	176187	178931	6	24	0	0	21	2744	176980	174236	0-3-7-4-8-5-6-2-7-4-2-6-5-2-1	0.0-3.0-7.0-4.0-8.0-5.0-6.0-2.0-7.0-4.0-2.1-6.1-5.1-2.0-1.0	99	176088	178832
AV_HG00673#haplotype2#0001165:24014011-24421797	AV_HG00673	179290	210503	2	172	0	0	171	31213	208193	176980	0-3-7-4-8-5-6-2-7-4-2-6-5-2-1	0.0-3.0-7.0-4.0-8.0-5.0-6.0-2.0-7.0-4.0-2.1-6.1-5.1-2.0-1.0	99	179191	210404
AV_HG00673#haplotype2#0001165:24014011-24421797	AV_HG00673	211580	214496	7	17	0	0	14	2916	211109	208193	0-3-7-4-8-5-6-2-7-4-2-6-5-2-1	0.0-3.0-7.0-4.0-8.0-5.0-6.0-2.0-7.0-4.0-2.1-6.1-5.1-2.0-1.0	99	211481	214397
AV_HG00673#haplotype2#0001165:24014011-24421797	AV_HG00673	215938	227482	4	96	0	4	58	11544	222653	211109	0-3-7-4-8-5-6-2-7-4-2-6-5-2-1	0.0-3.0-7.0-4.0-8.0-5.0-6.0-2.0-7.0-4.0-2.1-6.1-5.1-2.0-1.0	99	215839	227383
AV_HG00673#haplotype2#0001165:24014011-24421797	AV_HG00673	229348	260563	2	172	1	171	0	31215	253868	222653	0-3-7-4-8-5-6-2-7-4-2-6-5-2-1	0.0-3.0-7.0-4.0-8.0-5.0-6.0-2.0-7.0-4.0-2.1-6.1-5.1-2.0-1.0	99	229249	260464
AV_HG00673#haplotype2#0001165:24014011-24421797	AV_HG00673	260922	263666	6	24	1	21	0	2744	256612	253868	0-3-7-4-8-5-6-2-7-4-2-6-5-2-1	0.0-3.0-7.0-4.0-8.0-5.0-6.0-2.0-7.0-4.0-2.1-6.1-5.1-2.0-1.0	99	260823	263567
AV_HG00673#haplotype2#0001165:24014011-24421797	AV_HG00673	263610	276265	5	78	1	77	3	12655	269267	256612	0-3-7-4-8-5-6-2-7-4-2-6-5-2-1	0.0-3.0-7.0-4.0-8.0-5.0-6.0-2.0-7.0-4.0-2.1-6.1-5.1-2.0-1.0	99	263511	276166
AV_HG00673#haplotype2#0001165:24014011-24421797	AV_HG00673	276704	304609	2	172	0	15	171	27905	297172	269267	0-3-7-4-8-5-6-2-7-4-2-6-5-2-1	0.0-3.0-7.0-4.0-8.0-5.0-6.0-2.0-7.0-4.0-2.1-6.1-5.1-2.0-1.0	99	276605	304510
AV_HG00673#haplotype2#0001165:24014011-24421797	AV_HG00673	304553	407714	1	612	0	0	611	103161	400333	297172	0-3-7-4-8-5-6-2-7-4-2-6-5-2-1	0.0-3.0-7.0-4.0-8.0-5.0-6.0-2.0-7.0-4.0-2.1-6.1-5.1-2.0-1.0	99	304454	407615
AV_HG01106#haplotype1#0000048:16666181-17262214	AV_HG01106	100	115440	0	671	0	0	670	115340	115340	0	0-3-7-4-8-5-6-2-4-7-2-6-5-2-4-7-2-5-6-2-4-7-2-5-6-2-1	0.0-3.0-7.0-4.0-8.0-5.0-6.0-2.0-4.1-7.1-2.1-6.1-5.1-2.0-4.1-7.1-2.1-5.0-6.0-2.0-4.1-7.1-2.1-5.0-6.0-2.0-1.0	100	0	115340
AV_HG01106#haplotype1#0000048:16666181-17262214	AV_HG01106	115531	138368	3	132	0	0	131	22837	138177	115340	0-3-7-4-8-5-6-2-4-7-2-6-5-2-4-7-2-5-6-2-4-7-2-5-6-2-1	0.0-3.0-7.0-4.0-8.0-5.0-6.0-2.0-4.1-7.1-2.1-6.1-5.1-2.0-4.1-7.1-2.1-5.0-6.0-2.0-4.1-7.1-2.1-5.0-6.0-2.0-1.0	100	115431	138268
AV_HG01106#haplotype1#0000048:16666181-17262214	AV_HG01106	139127	142423	7	17	0	0	16	3296	141473	138177	0-3-7-4-8-5-6-2-4-7-2-6-5-2-4-7-2-5-6-2-4-7-2-5-6-2-1	0.0-3.0-7.0-4.0-8.0-5.0-6.0-2.0-4.1-7.1-2.1-6.1-5.1-2.0-4.1-7.1-2.1-5.0-6.0-2.0-4.1-7.1-2.1-5.0-6.0-2.0-1.0	100	139027	142323
AV_HG01106#haplotype1#0000048:16666181-17262214	AV_HG01106	143217	161429	4	96	0	1	95	18212	159685	141473	0-3-7-4-8-5-6-2-4-7-2-6-5-2-4-7-2-5-6-2-4-7-2-5-6-2-1	0.0-3.0-7.0-4.0-8.0-5.0-6.0-2.0-4.1-7.1-2.1-6.1-5.1-2.0-4.1-7.1-2.1-5.0-6.0-2.0-4.1-7.1-2.1-5.0-6.0-2.0-1.0	100	143117	161329
AV_HG01106#haplotype1#0000048:16666181-17262214	AV_HG01106	161373	163143	8	8	0	0	7	1770	161455	159685	0-3-7-4-8-5-6-2-4-7-2-6-5-2-4-7-2-5-6-2-4-7-2-5-6-2-1	0.0-3.0-7.0-4.0-8.0-5.0-6.0-2.0-4.1-7.1-2.1-6.1-5.1-2.0-4.1-7.1-2.1-5.0-6.0-2.0-4.1-7.1-2.1-5.0-6.0-2.0-1.0	100	161273	163043
AV_HG01106#haplotype1#0000048:16666181-17262214	AV_HG01106	163087	176191	5	78	0	0	77	13104	174559	161455	0-3-7-4-8-5-6-2-4-7-2-6-5-2-4-7-2-5-6-2-4-7-2-5-6-2-1	0.0-3.0-7.0-4.0-8.0-5.0-6.0-2.0-4.1-7.1-2.1-6.1-5.1-2.0-4.1-7.1-2.1-5.0-6.0-2.0-4.1-7.1-2.1-5.0-6.0-2.0-1.0	100	162987	176091
AV_HG01106#haplotype1#0000048:16666181-17262214	AV_HG01106	176135	178879	6	24	0	0	21	2744	177303	174559	0-3-7-4-8-5-6-2-4-7-2-6-5-2-4-7-2-5-6-2-4-7-2-5-6-2-1	0.0-3.0-7.0-4.0-8.0-5.0-6.0-2.0-4.1-7.1-2.1-6.1-5.1-2.0-4.1-7.1-2.1-5.0-6.0-2.0-4.1-7.1-2.1-5.0-6.0-2.0-1.0	100	176035	178779
AV_HG01106#haplotype1#0000048:16666181-17262214	AV_HG01106	179237	210069	2	172	0	0	170	30832	208135	177303	0-3-7-4-8-5-6-2-4-7-2-6-5-2-4-7-2-5-6-2-4-7-2-5-6-2-1	0.0-3.0-7.0-4.0-8.0-5.0-6.0-2.0-4.1-7.1-2.1-6.1-5.1-2.0-4.1-7.1-2.1-5.0-6.0-2.0-4.1-7.1-2.1-5.0-6.0-2.0-1.0	100	179137	209969
AV_HG01106#haplotype1#0000048:16666181-17262214	AV_HG01106	212320	224133	4	96	1	58	1	11813	219948	208135	0-3-7-4-8-5-6-2-4-7-2-6-5-2-4-7-2-5-6-2-4-7-2-5-6-2-1	0.0-3.0-7.0-4.0-8.0-5.0-6.0-2.0-4.1-7.1-2.1-6.1-5.1-2.0-4.1-7.1-2.1-5.0-6.0-2.0-4.1-7.1-2.1-5.0-6.0-2.0-1.0	100	212220	224033
AV_HG01106#haplotype1#0000048:16666181-17262214	AV_HG01106	224927	228223	7	17	1	16	0	3296	223244	219948	0-3-7-4-8-5-6-2-4-7-2-6-5-2-4-7-2-5-6-2-4-7-2-5-6-2-1	0.0-3.0-7.0-4.0-8.0-5.0-6.0-2.0-4.1-7.1-2.1-6.1-5.1-2.0-4.1-7.1-2.1-5.0-6.0-2.0-4.1-7.1-2.1-5.0-6.0-2.0-1.0	100	224827	228123
AV_HG01106#haplotype1#0000048:16666181-17262214	AV_HG01106	229685	260521	2	172	1	170	0	30836	254080	223244	0-3-7-4-8-5-6-2-4-7-2-6-5-2-4-7-2-5-6-2-4-7-2-5-6-2-1	0.0-3.0-7.0-4.0-8.0-5.0-6.0-2.0-4.1-7.1-2.1-6.1-5.1-2.0-4.1-7.1-2.1-5.0-6.0-2.0-4.1-7.1-2.1-5.0-6.0-2.0-1.0	100	229585	260421
AV_HG01106#haplotype1#0000048:16666181-17262214	AV_HG01106	260879	263623	6	24	1	21	0	2744	256824	254080	0-3-7-4-8-5-6-2-4-7-2-6-5-2-4-7-2-5-6-2-4-7-2-5-6-2-1	0.0-3.0-7.0-4.0-8.0-5.0-6.0-2.0-4.1-7.1-2.1-6.1-5.1-2.0-4.1-7.1-2.1-5.0-6.0-2.0-4.1-7.1-2.1-5.0-6.0-2.0-1.0	100	260779	263523
AV_HG01106#haplotype1#0000048:16666181-17262214	AV_HG01106	263567	275695	5	78	1	77	5	12128	268952	256824	0-3-7-4-8-5-6-2-4-7-2-6-5-2-4-7-2-5-6-2-4-7-2-5-6-2-1	0.0-3.0-7.0-4.0-8.0-5.0-6.0-2.0-4.1-7.1-2.1-6.1-5.1-2.0-4.1-7.1-2.1-5.0-6.0-2.0-4.1-7.1-2.1-5.0-6.0-2.0-1.0	100	263467	275595
AV_HG01106#haplotype1#0000048:16666181-17262214	AV_HG01106	276661	303850	2	172	0	15	167	27189	296141	268952	0-3-7-4-8-5-6-2-4-7-2-6-5-2-4-7-2-5-6-2-4-7-2-5-6-2-1	0.0-3.0-7.0-4.0-8.0-5.0-6.0-2.0-4.1-7.1-2.1-6.1-5.1-2.0-4.1-7.1-2.1-5.0-6.0-2.0-4.1-7.1-2.1-5.0-6.0-2.0-1.0	100	276561	303750
AV_HG01106#haplotype1#0000048:16666181-17262214	AV_HG01106	306442	317989	4	96	1	58	4	11547	307688	296141	0-3-7-4-8-5-6-2-4-7-2-6-5-2-4-7-2-5-6-2-4-7-2-5-6-2-1	0.0-3.0-7.0-4.0-8.0-5.0-6.0-2.0-4.1-7.1-2.1-6.1-5.1-2.0-4.1-7.1-2.1-5.0-6.0-2.0-4.1-7.1-2.1-5.0-6.0-2.0-1.0	100	306342	317889
AV_HG01106#haplotype1#0000048:16666181-17262214	AV_HG01106	319056	322351	7	17	1	16	0	3295	310983	307688	0-3-7-4-8-5-6-2-4-7-2-6-5-2-4-7-2-5-6-2-4-7-2-5-6-2-1	0.0-3.0-7.0-4.0-8.0-5.0-6.0-2.0-4.1-7.1-2.1-6.1-5.1-2.0-4.1-7.1-2.1-5.0-6.0-2.0-4.1-7.1-2.1-5.0-6.0-2.0-1.0	100	318956	322251
AV_HG01106#haplotype1#0000048:16666181-17262214	AV_HG01106	323813	351337	2	172	1	170	15	27524	338507	310983	0-3-7-4-8-5-6-2-4-7-2-6-5-2-4-7-2-5-6-2-4-7-2-5-6-2-1	0.0-3.0-7.0-4.0-8.0-5.0-6.0-2.0-4.1-7.1-2.1-6.1-5.1-2.0-4.1-7.1-2.1-5.0-6.0-2.0-4.1-7.1-2.1-5.0-6.0-2.0-1.0	100	323713	351237
AV_HG01106#haplotype1#0000048:16666181-17262214	AV_HG01106	352784	363991	5	78	0	8	76	11207	349714	338507	0-3-7-4-8-5-6-2-4-7-2-6-5-2-4-7-2-5-6-2-4-7-2-5-6-2-1	0.0-3.0-7.0-4.0-8.0-5.0-6.0-2.0-4.1-7.1-2.1-6.1-5.1-2.0-4.1-7.1-2.1-5.0-6.0-2.0-4.1-7.1-2.1-5.0-6.0-2.0-1.0	100	352684	363891
AV_HG01106#haplotype1#0000048:16666181-17262214	AV_HG01106	364598	367125	6	24	0	1	21	2527	352241	349714	0-3-7-4-8-5-6-2-4-7-2-6-5-2-4-7-2-5-6-2-4-7-2-5-6-2-1	0.0-3.0-7.0-4.0-8.0-5.0-6.0-2.0-4.1-7.1-2.1-6.1-5.1-2.0-4.1-7.1-2.1-5.0-6.0-2.0-4.1-7.1-2.1-5.0-6.0-2.0-1.0	100	364498	367025
AV_HG01106#haplotype1#0000048:16666181-17262214	AV_HG01106	367483	397972	2	172	0	0	167	30489	382730	352241	0-3-7-4-8-5-6-2-4-7-2-6-5-2-4-7-2-5-6-2-4-7-2-5-6-2-1	0.0-3.0-7.0-4.0-8.0-5.0-6.0-2.0-4.1-7.1-2.1-6.1-5.1-2.0-4.1-7.1-2.1-5.0-6.0-2.0-4.1-7.1-2.1-5.0-6.0-2.0-1.0	100	367383	397872
AV_HG01106#haplotype1#0000048:16666181-17262214	AV_HG01106	400564	412110	4	96	1	58	4	11546	394276	382730	0-3-7-4-8-5-6-2-4-7-2-6-5-2-4-7-2-5-6-2-4-7-2-5-6-2-1	0.0-3.0-7.0-4.0-8.0-5.0-6.0-2.0-4.1-7.1-2.1-6.1-5.1-2.0-4.1-7.1-2.1-5.0-6.0-2.0-4.1-7.1-2.1-5.0-6.0-2.0-1.0	100	400464	412010
AV_HG01106#haplotype1#0000048:16666181-17262214	AV_HG01106	413179	416474	7	17	1	16	0	3295	397571	394276	0-3-7-4-8-5-6-2-4-7-2-6-5-2-4-7-2-5-6-2-4-7-2-5-6-2-1	0.0-3.0-7.0-4.0-8.0-5.0-6.0-2.0-4.1-7.1-2.1-6.1-5.1-2.0-4.1-7.1-2.1-5.0-6.0-2.0-4.1-7.1-2.1-5.0-6.0-2.0-1.0	100	413079	416374
AV_HG01106#haplotype1#0000048:16666181-17262214	AV_HG01106	417936	445462	2	172	1	170	15	27526	425097	397571	0-3-7-4-8-5-6-2-4-7-2-6-5-2-4-7-2-5-6-2-4-7-2-5-6-2-1	0.0-3.0-7.0-4.0-8.0-5.0-6.0-2.0-4.1-7.1-2.1-6.1-5.1-2.0-4.1-7.1-2.1-5.0-6.0-2.0-4.1-7.1-2.1-5.0-6.0-2.0-1.0	100	417836	445362
AV_HG01106#haplotype1#0000048:16666181-17262214	AV_HG01106	446909	458116	5	78	0	8	76	11207	436304	425097	0-3-7-4-8-5-6-2-4-7-2-6-5-2-4-7-2-5-6-2-4-7-2-5-6-2-1	0.0-3.0-7.0-4.0-8.0-5.0-6.0-2.0-4.1-7.1-2.1-6.1-5.1-2.0-4.1-7.1-2.1-5.0-6.0-2.0-4.1-7.1-2.1-5.0-6.0-2.0-1.0	100	446809	458016
AV_HG01106#haplotype1#0000048:16666181-17262214	AV_HG01106	458723	461250	6	24	0	1	21	2527	438831	436304	0-3-7-4-8-5-6-2-4-7-2-6-5-2-4-7-2-5-6-2-4-7-2-5-6-2-1	0.0-3.0-7.0-4.0-8.0-5.0-6.0-2.0-4.1-7.1-2.1-6.1-5.1-2.0-4.1-7.1-2.1-5.0-6.0-2.0-4.1-7.1-2.1-5.0-6.0-2.0-1.0	100	458623	461150
AV_HG01106#haplotype1#0000048:16666181-17262214	AV_HG01106	461608	492828	2	172	0	0	171	31220	470051	438831	0-3-7-4-8-5-6-2-4-7-2-6-5-2-4-7-2-5-6-2-4-7-2-5-6-2-1	0.0-3.0-7.0-4.0-8.0-5.0-6.0-2.0-4.1-7.1-2.1-6.1-5.1-2.0-4.1-7.1-2.1-5.0-6.0-2.0-4.1-7.1-2.1-5.0-6.0-2.0-1.0	100	461508	492728
AV_HG01106#haplotype1#0000048:16666181-17262214	AV_HG01106	492772	595763	1	612	0	0	610	102991	573042	470051	0-3-7-4-8-5-6-2-4-7-2-6-5-2-4-7-2-5-6-2-4-7-2-5-6-2-1	0.0-3.0-7.0-4.0-8.0-5.0-6.0-2.0-4.1-7.1-2.1-6.1-5.1-2.0-4.1-7.1-2.1-5.0-6.0-2.0-4.1-7.1-2.1-5.0-6.0-2.0-1.0	100	492672	595663
AV_HG01106#haplotype2#0000932:16673968-17175925	AV_HG01106	100	115459	0	671	0	0	670	115359	115359	0	0-3-7-4-8-5-6-2-7-4-2-6-5-2-4-7-2-5-6-2-1	0.0-3.0-7.0-4.0-8.0-5.0-6.0-2.0-7.0-4.0-2.1-6.1-5.1-2.0-4.1-7.1-2.1-5.0-6.0-2.0-1.0	100	0	115359
AV_HG01106#haplotype2#0000932:16673968-17175925	AV_HG01106	115550	138384	3	132	0	0	131	22834	138193	115359	0-3-7-4-8-5-6-2-7-4-2-6-5-2-4-7-2-5-6-2-1	0.0-3.0-7.0-4.0-8.0-5.0-6.0-2.0-7.0-4.0-2.1-6.1-5.1-2.0-4.1-7.1-2.1-5.0-6.0-2.0-1.0	100	115450	138284
AV_HG01106#haplotype2#0000932:16673968-17175925	AV_HG01106	139143	142439	7	17	0	0	16	3296	141489	138193	0-3-7-4-8-5-6-2-7-4-2-6-5-2-4-7-2-5-6-2-1	0.0-3.0-7.0-4.0-8.0-5.0-6.0-2.0-7.0-4.0-2.1-6.1-5.1-2.0-4.1-7.1-2.1-5.0-6.0-2.0-1.0	100	139043	142339
AV_HG01106#haplotype2#0000932:16673968-17175925	AV_HG01106	142887	161442	4	96	0	0	95	18555	160044	141489	0-3-7-4-8-5-6-2-7-4-2-6-5-2-4-7-2-5-6-2-1	0.0-3.0-7.0-4.0-8.0-5.0-6.0-2.0-7.0-4.0-2.1-6.1-5.1-2.0-4.1-7.1-2.1-5.0-6.0-2.0-1.0	100	142787	161342
AV_HG01106#haplotype2#0000932:16673968-17175925	AV_HG01106	161386	163156	8	8	0	0	7	1770	161814	160044	0-3-7-4-8-5-6-2-7-4-2-6-5-2-4-7-2-5-6-2-1	0.0-3.0-7.0-4.0-8.0-5.0-6.0-2.0-7.0-4.0-2.1-6.1-5.1-2.0-4.1-7.1-2.1-5.0-6.0-2.0-1.0	100	161286	163056
AV_HG01106#haplotype2#0000932:16673968-17175925	AV_HG01106	163100	176204	5	78	0	0	77	13104	174918	161814	0-3-7-4-8-5-6-2-7-4-2-6-5-2-4-7-2-5-6-2-1	0.0-3.0-7.0-4.0-8.0-5.0-6.0-2.0-7.0-4.0-2.1-6.1-5.1-2.0-4.1-7.1-2.1-5.0-6.0-2.0-1.0	100	163000	176104
AV_HG01106#haplotype2#0000932:16673968-17175925	AV_HG01106	176148	178892	6	24	0	0	21	2744	177662	174918	0-3-7-4-8-5-6-2-7-4-2-6-5-2-4-7-2-5-6-2-1	0.0-3.0-7.0-4.0-8.0-5.0-6.0-2.0-7.0-4.0-2.1-6.1-5.1-2.0-4.1-7.1-2.1-5.0-6.0-2.0-1.0	100	176048	178792
AV_HG01106#haplotype2#0000932:16673968-17175925	AV_HG01106	179251	210091	2	172	0	0	170	30840	208502	177662	0-3-7-4-8-5-6-2-7-4-2-6-5-2-4-7-2-5-6-2-1	0.0-3.0-7.0-4.0-8.0-5.0-6.0-2.0-7.0-4.0-2.1-6.1-5.1-2.0-4.1-7.1-2.1-5.0-6.0-2.0-1.0	100	179151	209991
AV_HG01106#haplotype2#0000932:16673968-17175925	AV_HG01106	211553	214848	7	17	0	0	16	3295	211797	208502	0-3-7-4-8-5-6-2-7-4-2-6-5-2-4-7-2-5-6-2-1	0.0-3.0-7.0-4.0-8.0-5.0-6.0-2.0-7.0-4.0-2.1-6.1-5.1-2.0-4.1-7.1-2.1-5.0-6.0-2.0-1.0	100	211453	214748
AV_HG01106#haplotype2#0000932:16673968-17175925	AV_HG01106	215913	227460	4	96	0	4	58	11547	223344	211797	0-3-7-4-8-5-6-2-7-4-2-6-5-2-4-7-2-5-6-2-1	0.0-3.0-7.0-4.0-8.0-5.0-6.0-2.0-7.0-4.0-2.1-6.1-5.1-2.0-4.1-7.1-2.1-5.0-6.0-2.0-1.0	100	215813	227360
AV_HG01106#haplotype2#0000932:16673968-17175925	AV_HG01106	229711	260550	2	172	1	170	0	30839	254183	223344	0-3-7-4-8-5-6-2-7-4-2-6-5-2-4-7-2-5-6-2-1	0.0-3.0-7.0-4.0-8.0-5.0-6.0-2.0-7.0-4.0-2.1-6.1-5.1-2.0-4.1-7.1-2.1-5.0-6.0-2.0-1.0	100	229611	260450
AV_HG01106#haplotype2#0000932:16673968-17175925	AV_HG01106	260908	263652	6	24	1	21	0	2744	256927	254183	0-3-7-4-8-5-6-2-7-4-2-6-5-2-4-7-2-5-6-2-1	0.0-3.0-7.0-4.0-8.0-5.0-6.0-2.0-7.0-4.0-2.1-6.1-5.1-2.0-4.1-7.1-2.1-5.0-6.0-2.0-1.0	100	260808	263552
AV_HG01106#haplotype2#0000932:16673968-17175925	AV_HG01106	263596	275724	5	78	1	77	5	12128	269055	256927	0-3-7-4-8-5-6-2-7-4-2-6-5-2-4-7-2-5-6-2-1	0.0-3.0-7.0-4.0-8.0-5.0-6.0-2.0-7.0-4.0-2.1-6.1-5.1-2.0-4.1-7.1-2.1-5.0-6.0-2.0-1.0	100	263496	275624
AV_HG01106#haplotype2#0000932:16673968-17175925	AV_HG01106	276690	303873	2	172	0	15	167	27183	296238	269055	0-3-7-4-8-5-6-2-7-4-2-6-5-2-4-7-2-5-6-2-1	0.0-3.0-7.0-4.0-8.0-5.0-6.0-2.0-7.0-4.0-2.1-6.1-5.1-2.0-4.1-7.1-2.1-5.0-6.0-2.0-1.0	100	276590	303773
AV_HG01106#haplotype2#0000932:16673968-17175925	AV_HG01106	306465	318011	4	96	1	58	4	11546	307784	296238	0-3-7-4-8-5-6-2-7-4-2-6-5-2-4-7-2-5-6-2-1	0.0-3.0-7.0-4.0-8.0-5.0-6.0-2.0-7.0-4.0-2.1-6.1-5.1-2.0-4.1-7.1-2.1-5.0-6.0-2.0-1.0	100	306365	317911
AV_HG01106#haplotype2#0000932:16673968-17175925	AV_HG01106	319076	322371	7	17	1	16	0	3295	311079	307784	0-3-7-4-8-5-6-2-7-4-2-6-5-2-4-7-2-5-6-2-1	0.0-3.0-7.0-4.0-8.0-5.0-6.0-2.0-7.0-4.0-2.1-6.1-5.1-2.0-4.1-7.1-2.1-5.0-6.0-2.0-1.0	100	318976	322271
AV_HG01106#haplotype2#0000932:16673968-17175925	AV_HG01106	323833	351356	2	172	1	170	15	27523	338602	311079	0-3-7-4-8-5-6-2-7-4-2-6-5-2-4-7-2-5-6-2-1	0.0-3.0-7.0-4.0-8.0-5.0-6.0-2.0-7.0-4.0-2.1-6.1-5.1-2.0-4.1-7.1-2.1-5.0-6.0-2.0-1.0	100	323733	351256
AV_HG01106#haplotype2#0000932:16673968-17175925	AV_HG01106	352322	364010	5	78	0	5	76	11688	350290	338602	0-3-7-4-8-5-6-2-7-4-2-6-5-2-4-7-2-5-6-2-1	0.0-3.0-7.0-4.0-8.0-5.0-6.0-2.0-7.0-4.0-2.1-6.1-5.1-2.0-4.1-7.1-2.1-5.0-6.0-2.0-1.0	100	352222	363910
AV_HG01106#haplotype2#0000932:16673968-17175925	AV_HG01106	364617	367144	6	24	0	1	21	2527	352817	350290	0-3-7-4-8-5-6-2-7-4-2-6-5-2-4-7-2-5-6-2-1	0.0-3.0-7.0-4.0-8.0-5.0-6.0-2.0-7.0-4.0-2.1-6.1-5.1-2.0-4.1-7.1-2.1-5.0-6.0-2.0-1.0	100	364517	367044
AV_HG01106#haplotype2#0000932:16673968-17175925	AV_HG01106	367502	398716	2	172	0	0	171	31214	384031	352817	0-3-7-4-8-5-6-2-7-4-2-6-5-2-4-7-2-5-6-2-1	0.0-3.0-7.0-4.0-8.0-5.0-6.0-2.0-7.0-4.0-2.1-6.1-5.1-2.0-4.1-7.1-2.1-5.0-6.0-2.0-1.0	100	367402	398616
AV_HG01106#haplotype2#0000932:16673968-17175925	AV_HG01106	398660	501885	1	612	0	0	611	103225	487256	384031	0-3-7-4-8-5-6-2-7-4-2-6-5-2-4-7-2-5-6-2-1	0.0-3.0-7.0-4.0-8.0-5.0-6.0-2.0-7.0-4.0-2.1-6.1-5.1-2.0-4.1-7.1-2.1-5.0-6.0-2.0-1.0	100	398560	501785
AV_HG01175#haplotype1#0000070:46006269-46414083	AV_HG01175	100	115427	0	671	0	0	670	115327	115327	0	0-3-7-4-8-5-6-2-4-7-2-5-6-2-1	0.0-3.0-7.0-4.0-8.0-5.0-6.0-2.0-4.1-7.1-2.1-5.0-6.0-2.0-1.0	100	0	115327
AV_HG01175#haplotype1#0000070:46006269-46414083	AV_HG01175	115518	138355	3	132	0	0	131	22837	138164	115327	0-3-7-4-8-5-6-2-4-7-2-5-6-2-1	0.0-3.0-7.0-4.0-8.0-5.0-6.0-2.0-4.1-7.1-2.1-5.0-6.0-2.0-1.0	100	115418	138255
AV_HG01175#haplotype1#0000070:46006269-46414083	AV_HG01175	139114	142410	7	17	0	0	16	3296	141460	138164	0-3-7-4-8-5-6-2-4-7-2-5-6-2-1	0.0-3.0-7.0-4.0-8.0-5.0-6.0-2.0-4.1-7.1-2.1-5.0-6.0-2.0-1.0	100	139014	142310
AV_HG01175#haplotype1#0000070:46006269-46414083	AV_HG01175	142858	161414	4	96	0	0	95	18556	160016	141460	0-3-7-4-8-5-6-2-4-7-2-5-6-2-1	0.0-3.0-7.0-4.0-8.0-5.0-6.0-2.0-4.1-7.1-2.1-5.0-6.0-2.0-1.0	100	142758	161314
AV_HG01175#haplotype1#0000070:46006269-46414083	AV_HG01175	161358	163128	8	8	0	0	7	1770	161786	160016	0-3-7-4-8-5-6-2-4-7-2-5-6-2-1	0.0-3.0-7.0-4.0-8.0-5.0-6.0-2.0-4.1-7.1-2.1-5.0-6.0-2.0-1.0	100	161258	163028
AV_HG01175#haplotype1#0000070:46006269-46414083	AV_HG01175	163072	176176	5	78	0	0	77	13104	174890	161786	0-3-7-4-8-5-6-2-4-7-2-5-6-2-1	0.0-3.0-7.0-4.0-8.0-5.0-6.0-2.0-4.1-7.1-2.1-5.0-6.0-2.0-1.0	100	162972	176076
AV_HG01175#haplotype1#0000070:46006269-46414083	AV_HG01175	176120	178864	6	24	0	0	21	2744	177634	174890	0-3-7-4-8-5-6-2-4-7-2-5-6-2-1	0.0-3.0-7.0-4.0-8.0-5.0-6.0-2.0-4.1-7.1-2.1-5.0-6.0-2.0-1.0	100	176020	178764
AV_HG01175#haplotype1#0000070:46006269-46414083	AV_HG01175	179222	210055	2	172	0	0	170	30833	208467	177634	0-3-7-4-8-5-6-2-4-7-2-5-6-2-1	0.0-3.0-7.0-4.0-8.0-5.0-6.0-2.0-4.1-7.1-2.1-5.0-6.0-2.0-1.0	100	179122	209955
AV_HG01175#haplotype1#0000070:46006269-46414083	AV_HG01175	212306	223853	4	96	1	58	4	11547	220014	208467	0-3-7-4-8-5-6-2-4-7-2-5-6-2-1	0.0-3.0-7.0-4.0-8.0-5.0-6.0-2.0-4.1-7.1-2.1-5.0-6.0-2.0-1.0	100	212206	223753
AV_HG01175#haplotype1#0000070:46006269-46414083	AV_HG01175	224918	228213	7	17	1	16	0	3295	223309	220014	0-3-7-4-8-5-6-2-4-7-2-5-6-2-1	0.0-3.0-7.0-4.0-8.0-5.0-6.0-2.0-4.1-7.1-2.1-5.0-6.0-2.0-1.0	100	224818	228113
AV_HG01175#haplotype1#0000070:46006269-46414083	AV_HG01175	229675	257203	2	172	1	170	15	27528	250837	223309	0-3-7-4-8-5-6-2-4-7-2-5-6-2-1	0.0-3.0-7.0-4.0-8.0-5.0-6.0-2.0-4.1-7.1-2.1-5.0-6.0-2.0-1.0	100	229575	257103
AV_HG01175#haplotype1#0000070:46006269-46414083	AV_HG01175	258169	269857	5	78	0	5	76	11688	262525	250837	0-3-7-4-8-5-6-2-4-7-2-5-6-2-1	0.0-3.0-7.0-4.0-8.0-5.0-6.0-2.0-4.1-7.1-2.1-5.0-6.0-2.0-1.0	100	258069	269757
AV_HG01175#haplotype1#0000070:46006269-46414083	AV_HG01175	270464	272991	6	24	0	1	21	2527	265052	262525	0-3-7-4-8-5-6-2-4-7-2-5-6-2-1	0.0-3.0-7.0-4.0-8.0-5.0-6.0-2.0-4.1-7.1-2.1-5.0-6.0-2.0-1.0	100	270364	272891
AV_HG01175#haplotype1#0000070:46006269-46414083	AV_HG01175	273350	304568	2	172	0	0	171	31218	296270	265052	0-3-7-4-8-5-6-2-4-7-2-5-6-2-1	0.0-3.0-7.0-4.0-8.0-5.0-6.0-2.0-4.1-7.1-2.1-5.0-6.0-2.0-1.0	100	273250	304468
AV_HG01175#haplotype1#0000070:46006269-46414083	AV_HG01175	304512	407469	1	612	0	0	609	102957	399227	296270	0-3-7-4-8-5-6-2-4-7-2-5-6-2-1	0.0-3.0-7.0-4.0-8.0-5.0-6.0-2.0-4.1-7.1-2.1-5.0-6.0-2.0-1.0	100	304412	407369
AV_HG01361#haplotype1#0000023:101593539-102001341	AV_HG01361	99	115493	0	671	0	0	670	115394	115394	0	0-3-7-4-8-5-6-2-4-7-2-6-5-2-1	0.0-3.0-7.0-4.0-8.0-5.0-6.0-2.0-4.1-7.1-2.1-6.1-5.1-2.0-1.0	99	0	115394
AV_HG01361#haplotype1#0000023:101593539-102001341	AV_HG01361	115584	138415	3	132	0	0	131	22831	138225	115394	0-3-7-4-8-5-6-2-4-7-2-6-5-2-1	0.0-3.0-7.0-4.0-8.0-5.0-6.0-2.0-4.1-7.1-2.1-6.1-5.1-2.0-1.0	99	115485	138316
AV_HG01361#haplotype1#0000023:101593539-102001341	AV_HG01361	139174	142469	7	17	0	0	16	3295	141520	138225	0-3-7-4-8-5-6-2-4-7-2-6-5-2-1	0.0-3.0-7.0-4.0-8.0-5.0-6.0-2.0-4.1-7.1-2.1-6.1-5.1-2.0-1.0	99	139075	142370
AV_HG01361#haplotype1#0000023:101593539-102001341	AV_HG01361	143260	161471	4	96	0	1	95	18211	159731	141520	0-3-7-4-8-5-6-2-4-7-2-6-5-2-1	0.0-3.0-7.0-4.0-8.0-5.0-6.0-2.0-4.1-7.1-2.1-6.1-5.1-2.0-1.0	99	143161	161372
AV_HG01361#haplotype1#0000023:101593539-102001341	AV_HG01361	161415	163185	8	8	0	0	7	1770	161501	159731	0-3-7-4-8-5-6-2-4-7-2-6-5-2-1	0.0-3.0-7.0-4.0-8.0-5.0-6.0-2.0-4.1-7.1-2.1-6.1-5.1-2.0-1.0	99	161316	163086
AV_HG01361#haplotype1#0000023:101593539-102001341	AV_HG01361	163129	176233	5	78	0	0	77	13104	174605	161501	0-3-7-4-8-5-6-2-4-7-2-6-5-2-1	0.0-3.0-7.0-4.0-8.0-5.0-6.0-2.0-4.1-7.1-2.1-6.1-5.1-2.0-1.0	99	163030	176134
AV_HG01361#haplotype1#0000023:101593539-102001341	AV_HG01361	176177	178921	6	24	0	0	21	2744	177349	174605	0-3-7-4-8-5-6-2-4-7-2-6-5-2-1	0.0-3.0-7.0-4.0-8.0-5.0-6.0-2.0-4.1-7.1-2.1-6.1-5.1-2.0-1.0	99	176078	178822
AV_HG01361#haplotype1#0000023:101593539-102001341	AV_HG01361	179280	210497	2	172	0	0	171	31217	208566	177349	0-3-7-4-8-5-6-2-4-7-2-6-5-2-1	0.0-3.0-7.0-4.0-8.0-5.0-6.0-2.0-4.1-7.1-2.1-6.1-5.1-2.0-1.0	99	179181	210398
AV_HG01361#haplotype1#0000023:101593539-102001341	AV_HG01361	212363	223908	4	96	1	58	4	11545	220111	208566	0-3-7-4-8-5-6-2-4-7-2-6-5-2-1	0.0-3.0-7.0-4.0-8.0-5.0-6.0-2.0-4.1-7.1-2.1-6.1-5.1-2.0-1.0	99	212264	223809
AV_HG01361#haplotype1#0000023:101593539-102001341	AV_HG01361	224971	228266	7	17	1	16	0	3295	223406	220111	0-3-7-4-8-5-6-2-4-7-2-6-5-2-1	0.0-3.0-7.0-4.0-8.0-5.0-6.0-2.0-4.1-7.1-2.1-6.1-5.1-2.0-1.0	99	224872	228167
AV_HG01361#haplotype1#0000023:101593539-102001341	AV_HG01361	229343	260556	2	172	1	171	0	31213	254619	223406	0-3-7-4-8-5-6-2-4-7-2-6-5-2-1	0.0-3.0-7.0-4.0-8.0-5.0-6.0-2.0-4.1-7.1-2.1-6.1-5.1-2.0-1.0	99	229244	260457
AV_HG01361#haplotype1#0000023:101593539-102001341	AV_HG01361	260915	263442	6	24	1	21	1	2527	257146	254619	0-3-7-4-8-5-6-2-4-7-2-6-5-2-1	0.0-3.0-7.0-4.0-8.0-5.0-6.0-2.0-4.1-7.1-2.1-6.1-5.1-2.0-1.0	99	260816	263343
AV_HG01361#haplotype1#0000023:101593539-102001341	AV_HG01361	264049	276264	5	78	1	76	3	12215	269361	257146	0-3-7-4-8-5-6-2-4-7-2-6-5-2-1	0.0-3.0-7.0-4.0-8.0-5.0-6.0-2.0-4.1-7.1-2.1-6.1-5.1-2.0-1.0	99	263950	276165
AV_HG01361#haplotype1#0000023:101593539-102001341	AV_HG01361	276703	304604	2	172	0	15	171	27901	297262	269361	0-3-7-4-8-5-6-2-4-7-2-6-5-2-1	0.0-3.0-7.0-4.0-8.0-5.0-6.0-2.0-4.1-7.1-2.1-6.1-5.1-2.0-1.0	99	276604	304505
AV_HG01361#haplotype1#0000023:101593539-102001341	AV_HG01361	304548	407730	1	612	0	0	611	103182	400444	297262	0-3-7-4-8-5-6-2-4-7-2-6-5-2-1	0.0-3.0-7.0-4.0-8.0-5.0-6.0-2.0-4.1-7.1-2.1-6.1-5.1-2.0-1.0	99	304449	407631
AV_HG01361#haplotype2#0001322:101872897-102186552	AV_HG01361	99	115465	0	671	0	0	670	115366	115366	0	0-3-7-4-8-5-6-2-1	0.0-3.0-7.0-4.0-8.0-5.0-6.0-2.0-1.0	99	0	115366
AV_HG01361#haplotype2#0001322:101872897-102186552	AV_HG01361	115556	138387	3	132	0	0	131	22831	138197	115366	0-3-7-4-8-5-6-2-1	0.0-3.0-7.0-4.0-8.0-5.0-6.0-2.0-1.0	99	115457	138288
AV_HG01361#haplotype2#0001322:101872897-102186552	AV_HG01361	139146	142441	7	17	0	0	16	3295	141492	138197	0-3-7-4-8-5-6-2-1	0.0-3.0-7.0-4.0-8.0-5.0-6.0-2.0-1.0	99	139047	142342
AV_HG01361#haplotype2#0001322:101872897-102186552	AV_HG01361	143232	161448	4	96	0	1	95	18216	159708	141492	0-3-7-4-8-5-6-2-1	0.0-3.0-7.0-4.0-8.0-5.0-6.0-2.0-1.0	99	143133	161349
AV_HG01361#haplotype2#0001322:101872897-102186552	AV_HG01361	161392	163162	8	8	0	0	7	1770	161478	159708	0-3-7-4-8-5-6-2-1	0.0-3.0-7.0-4.0-8.0-5.0-6.0-2.0-1.0	99	161293	163063
AV_HG01361#haplotype2#0001322:101872897-102186552	AV_HG01361	163106	176210	5	78	0	0	77	13104	174582	161478	0-3-7-4-8-5-6-2-1	0.0-3.0-7.0-4.0-8.0-5.0-6.0-2.0-1.0	99	163007	176111
AV_HG01361#haplotype2#0001322:101872897-102186552	AV_HG01361	176154	178898	6	24	0	0	21	2744	177326	174582	0-3-7-4-8-5-6-2-1	0.0-3.0-7.0-4.0-8.0-5.0-6.0-2.0-1.0	99	176055	178799
AV_HG01361#haplotype2#0001322:101872897-102186552	AV_HG01361	179257	210480	2	172	0	0	171	31223	208549	177326	0-3-7-4-8-5-6-2-1	0.0-3.0-7.0-4.0-8.0-5.0-6.0-2.0-1.0	99	179158	210381
AV_HG01361#haplotype2#0001322:101872897-102186552	AV_HG01361	210424	313583	1	612	0	0	611	103159	311708	208549	0-3-7-4-8-5-6-2-1	0.0-3.0-7.0-4.0-8.0-5.0-6.0-2.0-1.0	99	210325	313484
AV_HG02148#haplotype2#0002863:16304803-16712699	AV_HG02148	100	115500	0	671	0	0	670	115400	115400	0	0-3-7-4-8-5-6-2-4-7-2-5-6-2-1	0.0-3.0-7.0-4.0-8.0-5.0-6.0-2.0-4.1-7.1-2.1-5.0-6.0-2.0-1.0	100	0	115400
AV_HG02148#haplotype2#0002863:16304803-16712699	AV_HG02148	115591	138425	3	132	0	0	131	22834	138234	115400	0-3-7-4-8-5-6-2-4-7-2-5-6-2-1	0.0-3.0-7.0-4.0-8.0-5.0-6.0-2.0-4.1-7.1-2.1-5.0-6.0-2.0-1.0	100	115491	138325
AV_HG02148#haplotype2#0002863:16304803-16712699	AV_HG02148	139184	142480	7	17	0	0	16	3296	141530	138234	0-3-7-4-8-5-6-2-4-7-2-5-6-2-1	0.0-3.0-7.0-4.0-8.0-5.0-6.0-2.0-4.1-7.1-2.1-5.0-6.0-2.0-1.0	100	139084	142380
AV_HG02148#haplotype2#0002863:16304803-16712699	AV_HG02148	142928	161484	4	96	0	0	95	18556	160086	141530	0-3-7-4-8-5-6-2-4-7-2-5-6-2-1	0.0-3.0-7.0-4.0-8.0-5.0-6.0-2.0-4.1-7.1-2.1-5.0-6.0-2.0-1.0	100	142828	161384
AV_HG02148#haplotype2#0002863:16304803-16712699	AV_HG02148	161428	163198	8	8	0	0	7	1770	161856	160086	0-3-7-4-8-5-6-2-4-7-2-5-6-2-1	0.0-3.0-7.0-4.0-8.0-5.0-6.0-2.0-4.1-7.1-2.1-5.0-6.0-2.0-1.0	100	161328	163098
AV_HG02148#haplotype2#0002863:16304803-16712699	AV_HG02148	163142	176246	5	78	0	0	77	13104	174960	161856	0-3-7-4-8-5-6-2-4-7-2-5-6-2-1	0.0-3.0-7.0-4.0-8.0-5.0-6.0-2.0-4.1-7.1-2.1-5.0-6.0-2.0-1.0	100	163042	176146
AV_HG02148#haplotype2#0002863:16304803-16712699	AV_HG02148	176190	178934	6	24	0	0	21	2744	177704	174960	0-3-7-4-8-5-6-2-4-7-2-5-6-2-1	0.0-3.0-7.0-4.0-8.0-5.0-6.0-2.0-4.1-7.1-2.1-5.0-6.0-2.0-1.0	100	176090	178834
AV_HG02148#haplotype2#0002863:16304803-16712699	AV_HG02148	179293	210131	2	172	0	0	170	30838	208542	177704	0-3-7-4-8-5-6-2-4-7-2-5-6-2-1	0.0-3.0-7.0-4.0-8.0-5.0-6.0-2.0-4.1-7.1-2.1-5.0-6.0-2.0-1.0	100	179193	210031
AV_HG02148#haplotype2#0002863:16304803-16712699	AV_HG02148	212382	223928	4	96	1	58	4	11546	220088	208542	0-3-7-4-8-5-6-2-4-7-2-5-6-2-1	0.0-3.0-7.0-4.0-8.0-5.0-6.0-2.0-4.1-7.1-2.1-5.0-6.0-2.0-1.0	100	212282	223828
AV_HG02148#haplotype2#0002863:16304803-16712699	AV_HG02148	224993	228288	7	17	1	16	0	3295	223383	220088	0-3-7-4-8-5-6-2-4-7-2-5-6-2-1	0.0-3.0-7.0-4.0-8.0-5.0-6.0-2.0-4.1-7.1-2.1-5.0-6.0-2.0-1.0	100	224893	228188
AV_HG02148#haplotype2#0002863:16304803-16712699	AV_HG02148	229750	257275	2	172	1	170	15	27525	250908	223383	0-3-7-4-8-5-6-2-4-7-2-5-6-2-1	0.0-3.0-7.0-4.0-8.0-5.0-6.0-2.0-4.1-7.1-2.1-5.0-6.0-2.0-1.0	100	229650	257175
AV_HG02148#haplotype2#0002863:16304803-16712699	AV_HG02148	258241	269929	5	78	0	5	76	11688	262596	250908	0-3-7-4-8-5-6-2-4-7-2-5-6-2-1	0.0-3.0-7.0-4.0-8.0-5.0-6.0-2.0-4.1-7.1-2.1-5.0-6.0-2.0-1.0	100	258141	269829
AV_HG02148#haplotype2#0002863:16304803-16712699	AV_HG02148	270536	273063	6	24	0	1	21	2527	265123	262596	0-3-7-4-8-5-6-2-4-7-2-5-6-2-1	0.0-3.0-7.0-4.0-8.0-5.0-6.0-2.0-4.1-7.1-2.1-5.0-6.0-2.0-1.0	100	270436	272963
AV_HG02148#haplotype2#0002863:16304803-16712699	AV_HG02148	273421	304635	2	172	0	0	171	31214	296337	265123	0-3-7-4-8-5-6-2-4-7-2-5-6-2-1	0.0-3.0-7.0-4.0-8.0-5.0-6.0-2.0-4.1-7.1-2.1-5.0-6.0-2.0-1.0	100	273321	304535
AV_HG02148#haplotype2#0002863:16304803-16712699	AV_HG02148	304579	407626	1	612	0	0	610	103047	399384	296337	0-3-7-4-8-5-6-2-4-7-2-5-6-2-1	0.0-3.0-7.0-4.0-8.0-5.0-6.0-2.0-4.1-7.1-2.1-5.0-6.0-2.0-1.0	100	304479	407526
AV_HG02257#haplotype2#0001152:102843493-103251377	AV_HG02257	99	115461	0	671	0	0	670	115362	115362	0	0-3-7-4-8-5-6-2-4-7-2-5-6-2-1	0.0-3.0-7.0-4.0-8.0-5.0-6.0-2.0-4.1-7.1-2.1-5.0-6.0-2.0-1.0	99	0	115362
AV_HG02257#haplotype2#0001152:102843493-103251377	AV_HG02257	115552	138383	3	132	0	0	131	22831	138193	115362	0-3-7-4-8-5-6-2-4-7-2-5-6-2-1	0.0-3.0-7.0-4.0-8.0-5.0-6.0-2.0-4.1-7.1-2.1-5.0-6.0-2.0-1.0	99	115453	138284
AV_HG02257#haplotype2#0001152:102843493-103251377	AV_HG02257	139142	142437	7	17	0	0	16	3295	141488	138193	0-3-7-4-8-5-6-2-4-7-2-5-6-2-1	0.0-3.0-7.0-4.0-8.0-5.0-6.0-2.0-4.1-7.1-2.1-5.0-6.0-2.0-1.0	99	139043	142338
AV_HG02257#haplotype2#0001152:102843493-103251377	AV_HG02257	143500	161452	4	96	0	4	95	17952	159440	141488	0-3-7-4-8-5-6-2-4-7-2-5-6-2-1	0.0-3.0-7.0-4.0-8.0-5.0-6.0-2.0-4.1-7.1-2.1-5.0-6.0-2.0-1.0	99	143401	161353
AV_HG02257#haplotype2#0001152:102843493-103251377	AV_HG02257	161396	163166	8	8	0	0	7	1770	161210	159440	0-3-7-4-8-5-6-2-4-7-2-5-6-2-1	0.0-3.0-7.0-4.0-8.0-5.0-6.0-2.0-4.1-7.1-2.1-5.0-6.0-2.0-1.0	99	161297	163067
AV_HG02257#haplotype2#0001152:102843493-103251377	AV_HG02257	163110	176248	5	78	0	0	77	13138	174348	161210	0-3-7-4-8-5-6-2-4-7-2-5-6-2-1	0.0-3.0-7.0-4.0-8.0-5.0-6.0-2.0-4.1-7.1-2.1-5.0-6.0-2.0-1.0	99	163011	176149
AV_HG02257#haplotype2#0001152:102843493-103251377	AV_HG02257	176192	178936	6	24	0	0	21	2744	177092	174348	0-3-7-4-8-5-6-2-4-7-2-5-6-2-1	0.0-3.0-7.0-4.0-8.0-5.0-6.0-2.0-4.1-7.1-2.1-5.0-6.0-2.0-1.0	99	176093	178837
AV_HG02257#haplotype2#0001152:102843493-103251377	AV_HG02257	179314	210527	2	172	0	0	171	31213	208305	177092	0-3-7-4-8-5-6-2-4-7-2-5-6-2-1	0.0-3.0-7.0-4.0-8.0-5.0-6.0-2.0-4.1-7.1-2.1-5.0-6.0-2.0-1.0	99	179215	210428
AV_HG02257#haplotype2#0001152:102843493-103251377	AV_HG02257	212843	223937	4	96	1	56	4	11094	219399	208305	0-3-7-4-8-5-6-2-4-7-2-5-6-2-1	0.0-3.0-7.0-4.0-8.0-5.0-6.0-2.0-4.1-7.1-2.1-5.0-6.0-2.0-1.0	99	212744	223838
AV_HG02257#haplotype2#0001152:102843493-103251377	AV_HG02257	225000	228295	7	17	1	16	0	3295	222694	219399	0-3-7-4-8-5-6-2-4-7-2-5-6-2-1	0.0-3.0-7.0-4.0-8.0-5.0-6.0-2.0-4.1-7.1-2.1-5.0-6.0-2.0-1.0	99	224901	228196
AV_HG02257#haplotype2#0001152:102843493-103251377	AV_HG02257	229372	257280	2	172	1	171	15	27908	250602	222694	0-3-7-4-8-5-6-2-4-7-2-5-6-2-1	0.0-3.0-7.0-4.0-8.0-5.0-6.0-2.0-4.1-7.1-2.1-5.0-6.0-2.0-1.0	99	229273	257181
AV_HG02257#haplotype2#0001152:102843493-103251377	AV_HG02257	258246	269460	5	78	0	5	74	11214	261816	250602	0-3-7-4-8-5-6-2-4-7-2-5-6-2-1	0.0-3.0-7.0-4.0-8.0-5.0-6.0-2.0-4.1-7.1-2.1-5.0-6.0-2.0-1.0	99	258147	269361
AV_HG02257#haplotype2#0001152:102843493-103251377	AV_HG02257	270541	273068	6	24	0	1	21	2527	264343	261816	0-3-7-4-8-5-6-2-4-7-2-5-6-2-1	0.0-3.0-7.0-4.0-8.0-5.0-6.0-2.0-4.1-7.1-2.1-5.0-6.0-2.0-1.0	99	270442	272969
AV_HG02257#haplotype2#0001152:102843493-103251377	AV_HG02257	273426	304640	2	172	0	0	171	31214	295557	264343	0-3-7-4-8-5-6-2-4-7-2-5-6-2-1	0.0-3.0-7.0-4.0-8.0-5.0-6.0-2.0-4.1-7.1-2.1-5.0-6.0-2.0-1.0	99	273327	304541
AV_HG02257#haplotype2#0001152:102843493-103251377	AV_HG02257	304584	407614	1	612	0	0	610	103030	398587	295557	0-3-7-4-8-5-6-2-4-7-2-5-6-2-1	0.0-3.0-7.0-4.0-8.0-5.0-6.0-2.0-4.1-7.1-2.1-5.0-6.0-2.0-1.0	99	304485	407515
HG00438#1#JAHBCB010000015.1_33474867_33954171_0	HG00438	98	115453	0	671	0	0	670	115355	115355	0	0-3-7-4-8-5-6-2-4-7-2-6-5-8-4-7-2-6-5-2-1	0.0-3.0-7.0-4.0-8.0-5.0-6.0-2.0-4.1-7.1-2.1-6.1-5.1-8.1-4.1-7.1-2.1-6.1-5.1-2.0-1.0	98	0	115355
HG00438#1#JAHBCB010000015.1_33474867_33954171_0	HG00438	115544	138378	3	132	0	0	131	22834	138189	115355	0-3-7-4-8-5-6-2-4-7-2-6-5-8-4-7-2-6-5-2-1	0.0-3.0-7.0-4.0-8.0-5.0-6.0-2.0-4.1-7.1-2.1-6.1-5.1-8.1-4.1-7.1-2.1-6.1-5.1-2.0-1.0	98	115446	138280
HG00438#1#JAHBCB010000015.1_33474867_33954171_0	HG00438	139137	142433	7	17	0	0	16	3296	141485	138189	0-3-7-4-8-5-6-2-4-7-2-6-5-8-4-7-2-6-5-2-1	0.0-3.0-7.0-4.0-8.0-5.0-6.0-2.0-4.1-7.1-2.1-6.1-5.1-8.1-4.1-7.1-2.1-6.1-5.1-2.0-1.0	98	139039	142335
HG00438#1#JAHBCB010000015.1_33474867_33954171_0	HG00438	142881	161446	4	96	0	0	95	18565	160050	141485	0-3-7-4-8-5-6-2-4-7-2-6-5-8-4-7-2-6-5-2-1	0.0-3.0-7.0-4.0-8.0-5.0-6.0-2.0-4.1-7.1-2.1-6.1-5.1-8.1-4.1-7.1-2.1-6.1-5.1-2.0-1.0	98	142783	161348
HG00438#1#JAHBCB010000015.1_33474867_33954171_0	HG00438	161390	163160	8	8	0	0	7	1770	161820	160050	0-3-7-4-8-5-6-2-4-7-2-6-5-8-4-7-2-6-5-2-1	0.0-3.0-7.0-4.0-8.0-5.0-6.0-2.0-4.1-7.1-2.1-6.1-5.1-8.1-4.1-7.1-2.1-6.1-5.1-2.0-1.0	98	161292	163062
HG00438#1#JAHBCB010000015.1_33474867_33954171_0	HG00438	163104	175768	5	78	0	0	76	12664	174484	161820	0-3-7-4-8-5-6-2-4-7-2-6-5-8-4-7-2-6-5-2-1	0.0-3.0-7.0-4.0-8.0-5.0-6.0-2.0-4.1-7.1-2.1-6.1-5.1-8.1-4.1-7.1-2.1-6.1-5.1-2.0-1.0	98	163006	175670
HG00438#1#JAHBCB010000015.1_33474867_33954171_0	HG00438	176375	178902	6	24	0	1	21	2527	177011	174484	0-3-7-4-8-5-6-2-4-7-2-6-5-8-4-7-2-6-5-2-1	0.0-3.0-7.0-4.0-8.0-5.0-6.0-2.0-4.1-7.1-2.1-6.1-5.1-8.1-4.1-7.1-2.1-6.1-5.1-2.0-1.0	98	176277	178804
HG00438#1#JAHBCB010000015.1_33474867_33954171_0	HG00438	179260	210474	2	172	0	0	171	31214	208225	177011	0-3-7-4-8-5-6-2-4-7-2-6-5-8-4-7-2-6-5-2-1	0.0-3.0-7.0-4.0-8.0-5.0-6.0-2.0-4.1-7.1-2.1-6.1-5.1-8.1-4.1-7.1-2.1-6.1-5.1-2.0-1.0	98	179162	210376
HG00438#1#JAHBCB010000015.1_33474867_33954171_0	HG00438	212340	223886	4	96	1	58	4	11546	219771	208225	0-3-7-4-8-5-6-2-4-7-2-6-5-8-4-7-2-6-5-2-1	0.0-3.0-7.0-4.0-8.0-5.0-6.0-2.0-4.1-7.1-2.1-6.1-5.1-8.1-4.1-7.1-2.1-6.1-5.1-2.0-1.0	98	212242	223788
HG00438#1#JAHBCB010000015.1_33474867_33954171_0	HG00438	224949	228245	7	17	1	16	0	3296	223067	219771	0-3-7-4-8-5-6-2-4-7-2-6-5-8-4-7-2-6-5-2-1	0.0-3.0-7.0-4.0-8.0-5.0-6.0-2.0-4.1-7.1-2.1-6.1-5.1-8.1-4.1-7.1-2.1-6.1-5.1-2.0-1.0	98	224851	228147
HG00438#1#JAHBCB010000015.1_33474867_33954171_0	HG00438	229322	260534	2	172	1	171	0	31212	254279	223067	0-3-7-4-8-5-6-2-4-7-2-6-5-8-4-7-2-6-5-2-1	0.0-3.0-7.0-4.0-8.0-5.0-6.0-2.0-4.1-7.1-2.1-6.1-5.1-8.1-4.1-7.1-2.1-6.1-5.1-2.0-1.0	98	229224	260436
HG00438#1#JAHBCB010000015.1_33474867_33954171_0	HG00438	260892	263419	6	24	1	21	1	2527	256806	254279	0-3-7-4-8-5-6-2-4-7-2-6-5-8-4-7-2-6-5-2-1	0.0-3.0-7.0-4.0-8.0-5.0-6.0-2.0-4.1-7.1-2.1-6.1-5.1-8.1-4.1-7.1-2.1-6.1-5.1-2.0-1.0	98	260794	263321
HG00438#1#JAHBCB010000015.1_33474867_33954171_0	HG00438	264026	276690	5	78	1	76	0	12664	269470	256806	0-3-7-4-8-5-6-2-4-7-2-6-5-8-4-7-2-6-5-2-1	0.0-3.0-7.0-4.0-8.0-5.0-6.0-2.0-4.1-7.1-2.1-6.1-5.1-8.1-4.1-7.1-2.1-6.1-5.1-2.0-1.0	98	263928	276592
HG00438#1#JAHBCB010000015.1_33474867_33954171_0	HG00438	276634	278404	8	8	1	7	0	1770	271240	269470	0-3-7-4-8-5-6-2-4-7-2-6-5-8-4-7-2-6-5-2-1	0.0-3.0-7.0-4.0-8.0-5.0-6.0-2.0-4.1-7.1-2.1-6.1-5.1-8.1-4.1-7.1-2.1-6.1-5.1-2.0-1.0	98	276536	278306
HG00438#1#JAHBCB010000015.1_33474867_33954171_0	HG00438	278348	296913	4	96	1	95	0	18565	289805	271240	0-3-7-4-8-5-6-2-4-7-2-6-5-8-4-7-2-6-5-2-1	0.0-3.0-7.0-4.0-8.0-5.0-6.0-2.0-4.1-7.1-2.1-6.1-5.1-8.1-4.1-7.1-2.1-6.1-5.1-2.0-1.0	98	278250	296815
HG00438#1#JAHBCB010000015.1_33474867_33954171_0	HG00438	297361	300657	7	17	1	16	0	3296	293101	289805	0-3-7-4-8-5-6-2-4-7-2-6-5-8-4-7-2-6-5-2-1	0.0-3.0-7.0-4.0-8.0-5.0-6.0-2.0-4.1-7.1-2.1-6.1-5.1-8.1-4.1-7.1-2.1-6.1-5.1-2.0-1.0	98	297263	300559
HG00438#1#JAHBCB010000015.1_33474867_33954171_0	HG00438	301734	332954	2	172	1	171	0	31220	324321	293101	0-3-7-4-8-5-6-2-4-7-2-6-5-8-4-7-2-6-5-2-1	0.0-3.0-7.0-4.0-8.0-5.0-6.0-2.0-4.1-7.1-2.1-6.1-5.1-8.1-4.1-7.1-2.1-6.1-5.1-2.0-1.0	98	301636	332856
HG00438#1#JAHBCB010000015.1_33474867_33954171_0	HG00438	333315	335842	6	24	1	21	1	2527	326848	324321	0-3-7-4-8-5-6-2-4-7-2-6-5-8-4-7-2-6-5-2-1	0.0-3.0-7.0-4.0-8.0-5.0-6.0-2.0-4.1-7.1-2.1-6.1-5.1-8.1-4.1-7.1-2.1-6.1-5.1-2.0-1.0	98	333217	335744
HG00438#1#JAHBCB010000015.1_33474867_33954171_0	HG00438	336449	348664	5	78	1	76	3	12215	339063	326848	0-3-7-4-8-5-6-2-4-7-2-6-5-8-4-7-2-6-5-2-1	0.0-3.0-7.0-4.0-8.0-5.0-6.0-2.0-4.1-7.1-2.1-6.1-5.1-8.1-4.1-7.1-2.1-6.1-5.1-2.0-1.0	98	336351	348566
HG00438#1#JAHBCB010000015.1_33474867_33954171_0	HG00438	349103	377019	2	172	0	15	171	27916	366979	339063	0-3-7-4-8-5-6-2-4-7-2-6-5-8-4-7-2-6-5-2-1	0.0-3.0-7.0-4.0-8.0-5.0-6.0-2.0-4.1-7.1-2.1-6.1-5.1-8.1-4.1-7.1-2.1-6.1-5.1-2.0-1.0	98	349005	376921
HG00438#1#JAHBCB010000015.1_33474867_33954171_0	HG00438	376963	479360	1	612	0	0	606	102397	469376	366979	0-3-7-4-8-5-6-2-4-7-2-6-5-8-4-7-2-6-5-2-1	0.0-3.0-7.0-4.0-8.0-5.0-6.0-2.0-4.1-7.1-2.1-6.1-5.1-8.1-4.1-7.1-2.1-6.1-5.1-2.0-1.0	98	376865	479262
HG00438#2#JAHBCA010000012.1_51513023_51826723_0	HG00438	99	115448	0	671	0	0	670	115349	115349	0	0-3-7-4-8-5-6-2-1	0.0-3.0-7.0-4.0-8.0-5.0-6.0-2.0-1.0	99	0	115349
HG00438#2#JAHBCA010000012.1_51513023_51826723_0	HG00438	115539	138376	3	132	0	0	131	22837	138186	115349	0-3-7-4-8-5-6-2-1	0.0-3.0-7.0-4.0-8.0-5.0-6.0-2.0-1.0	99	115440	138277
HG00438#2#JAHBCA010000012.1_51513023_51826723_0	HG00438	139135	142431	7	17	0	0	16	3296	141482	138186	0-3-7-4-8-5-6-2-1	0.0-3.0-7.0-4.0-8.0-5.0-6.0-2.0-1.0	99	139036	142332
HG00438#2#JAHBCA010000012.1_51513023_51826723_0	HG00438	142879	161435	4	96	0	0	95	18556	160038	141482	0-3-7-4-8-5-6-2-1	0.0-3.0-7.0-4.0-8.0-5.0-6.0-2.0-1.0	99	142780	161336
HG00438#2#JAHBCA010000012.1_51513023_51826723_0	HG00438	161379	163149	8	8	0	0	7	1770	161808	160038	0-3-7-4-8-5-6-2-1	0.0-3.0-7.0-4.0-8.0-5.0-6.0-2.0-1.0	99	161280	163050
HG00438#2#JAHBCA010000012.1_51513023_51826723_0	HG00438	163093	175757	5	78	0	0	76	12664	174472	161808	0-3-7-4-8-5-6-2-1	0.0-3.0-7.0-4.0-8.0-5.0-6.0-2.0-1.0	99	162994	175658
HG00438#2#JAHBCA010000012.1_51513023_51826723_0	HG00438	176364	178891	6	24	0	1	21	2527	176999	174472	0-3-7-4-8-5-6-2-1	0.0-3.0-7.0-4.0-8.0-5.0-6.0-2.0-1.0	99	176265	178792
HG00438#2#JAHBCA010000012.1_51513023_51826723_0	HG00438	179250	210472	2	172	0	0	171	31222	208221	176999	0-3-7-4-8-5-6-2-1	0.0-3.0-7.0-4.0-8.0-5.0-6.0-2.0-1.0	99	179151	210373
HG00438#2#JAHBCA010000012.1_51513023_51826723_0	HG00438	210416	313628	1	612	0	0	611	103212	311433	208221	0-3-7-4-8-5-6-2-1	0.0-3.0-7.0-4.0-8.0-5.0-6.0-2.0-1.0	99	210317	313529
HG005#1#JAHEPO010000002.1_51519219_51926067_0	HG005	98	115446	0	671	0	0	670	115348	115348	0	0-3-7-4-8-5-6-2-7-4-2-6-5-2-1	0.0-3.0-7.0-4.0-8.0-5.0-6.0-2.0-7.0-4.0-2.1-6.1-5.1-2.0-1.0	98	0	115348
HG005#1#JAHEPO010000002.1_51519219_51926067_0	HG005	115537	138371	3	132	0	0	131	22834	138182	115348	0-3-7-4-8-5-6-2-7-4-2-6-5-2-1	0.0-3.0-7.0-4.0-8.0-5.0-6.0-2.0-7.0-4.0-2.1-6.1-5.1-2.0-1.0	98	115439	138273
HG005#1#JAHEPO010000002.1_51519219_51926067_0	HG005	139130	142426	7	17	0	0	16	3296	141478	138182	0-3-7-4-8-5-6-2-7-4-2-6-5-2-1	0.0-3.0-7.0-4.0-8.0-5.0-6.0-2.0-7.0-4.0-2.1-6.1-5.1-2.0-1.0	98	139032	142328
HG005#1#JAHEPO010000002.1_51519219_51926067_0	HG005	142874	161443	4	96	0	0	95	18569	160047	141478	0-3-7-4-8-5-6-2-7-4-2-6-5-2-1	0.0-3.0-7.0-4.0-8.0-5.0-6.0-2.0-7.0-4.0-2.1-6.1-5.1-2.0-1.0	98	142776	161345
HG005#1#JAHEPO010000002.1_51519219_51926067_0	HG005	161387	163157	8	8	0	0	7	1770	161817	160047	0-3-7-4-8-5-6-2-7-4-2-6-5-2-1	0.0-3.0-7.0-4.0-8.0-5.0-6.0-2.0-7.0-4.0-2.1-6.1-5.1-2.0-1.0	98	161289	163059
HG005#1#JAHEPO010000002.1_51519219_51926067_0	HG005	163101	175765	5	78	0	0	76	12664	174481	161817	0-3-7-4-8-5-6-2-7-4-2-6-5-2-1	0.0-3.0-7.0-4.0-8.0-5.0-6.0-2.0-7.0-4.0-2.1-6.1-5.1-2.0-1.0	98	163003	175667
HG005#1#JAHEPO010000002.1_51519219_51926067_0	HG005	176372	178899	6	24	0	1	21	2527	177008	174481	0-3-7-4-8-5-6-2-7-4-2-6-5-2-1	0.0-3.0-7.0-4.0-8.0-5.0-6.0-2.0-7.0-4.0-2.1-6.1-5.1-2.0-1.0	98	176274	178801
HG005#1#JAHEPO010000002.1_51519219_51926067_0	HG005	179258	210474	2	172	0	0	171	31216	208224	177008	0-3-7-4-8-5-6-2-7-4-2-6-5-2-1	0.0-3.0-7.0-4.0-8.0-5.0-6.0-2.0-7.0-4.0-2.1-6.1-5.1-2.0-1.0	98	179160	210376
HG005#1#JAHEPO010000002.1_51519219_51926067_0	HG005	211551	214847	7	17	0	0	16	3296	211520	208224	0-3-7-4-8-5-6-2-7-4-2-6-5-2-1	0.0-3.0-7.0-4.0-8.0-5.0-6.0-2.0-7.0-4.0-2.1-6.1-5.1-2.0-1.0	98	211453	214749
HG005#1#JAHEPO010000002.1_51519219_51926067_0	HG005	215295	227451	4	96	0	0	58	12156	223676	211520	0-3-7-4-8-5-6-2-7-4-2-6-5-2-1	0.0-3.0-7.0-4.0-8.0-5.0-6.0-2.0-7.0-4.0-2.1-6.1-5.1-2.0-1.0	98	215197	227353
HG005#1#JAHEPO010000002.1_51519219_51926067_0	HG005	229317	260537	2	172	1	171	0	31220	254896	223676	0-3-7-4-8-5-6-2-7-4-2-6-5-2-1	0.0-3.0-7.0-4.0-8.0-5.0-6.0-2.0-7.0-4.0-2.1-6.1-5.1-2.0-1.0	98	229219	260439
HG005#1#JAHEPO010000002.1_51519219_51926067_0	HG005	260481	263424	6	24	1	23	1	2943	257839	254896	0-3-7-4-8-5-6-2-7-4-2-6-5-2-1	0.0-3.0-7.0-4.0-8.0-5.0-6.0-2.0-7.0-4.0-2.1-6.1-5.1-2.0-1.0	98	260383	263326
HG005#1#JAHEPO010000002.1_51519219_51926067_0	HG005	264031	276246	5	78	1	76	3	12215	270054	257839	0-3-7-4-8-5-6-2-7-4-2-6-5-2-1	0.0-3.0-7.0-4.0-8.0-5.0-6.0-2.0-7.0-4.0-2.1-6.1-5.1-2.0-1.0	98	263933	276148
HG005#1#JAHEPO010000002.1_51519219_51926067_0	HG005	276685	304598	2	172	0	15	171	27913	297967	270054	0-3-7-4-8-5-6-2-7-4-2-6-5-2-1	0.0-3.0-7.0-4.0-8.0-5.0-6.0-2.0-7.0-4.0-2.1-6.1-5.1-2.0-1.0	98	276587	304500
HG005#1#JAHEPO010000002.1_51519219_51926067_0	HG005	304542	406904	1	612	0	0	606	102362	400329	297967	0-3-7-4-8-5-6-2-7-4-2-6-5-2-1	0.0-3.0-7.0-4.0-8.0-5.0-6.0-2.0-7.0-4.0-2.1-6.1-5.1-2.0-1.0	98	304444	406806
HG005#2#JAHEPN010000023.1_51542210_51950070_0	HG005	99	115463	0	671	0	0	670	115364	115364	0	0-3-7-4-8-5-6-2-4-7-2-5-6-2-1	0.0-3.0-7.0-4.0-8.0-5.0-6.0-2.0-4.1-7.1-2.1-5.0-6.0-2.0-1.0	99	0	115364
HG005#2#JAHEPN010000023.1_51542210_51950070_0	HG005	115554	138391	3	132	0	0	131	22837	138201	115364	0-3-7-4-8-5-6-2-4-7-2-5-6-2-1	0.0-3.0-7.0-4.0-8.0-5.0-6.0-2.0-4.1-7.1-2.1-5.0-6.0-2.0-1.0	99	115455	138292
HG005#2#JAHEPN010000023.1_51542210_51950070_0	HG005	139150	142446	7	17	0	0	16	3296	141497	138201	0-3-7-4-8-5-6-2-4-7-2-5-6-2-1	0.0-3.0-7.0-4.0-8.0-5.0-6.0-2.0-4.1-7.1-2.1-5.0-6.0-2.0-1.0	99	139051	142347
HG005#2#JAHEPN010000023.1_51542210_51950070_0	HG005	142894	161446	4	96	0	0	95	18552	160049	141497	0-3-7-4-8-5-6-2-4-7-2-5-6-2-1	0.0-3.0-7.0-4.0-8.0-5.0-6.0-2.0-4.1-7.1-2.1-5.0-6.0-2.0-1.0	99	142795	161347
HG005#2#JAHEPN010000023.1_51542210_51950070_0	HG005	161390	163160	8	8	0	0	7	1770	161819	160049	0-3-7-4-8-5-6-2-4-7-2-5-6-2-1	0.0-3.0-7.0-4.0-8.0-5.0-6.0-2.0-4.1-7.1-2.1-5.0-6.0-2.0-1.0	99	161291	163061
HG005#2#JAHEPN010000023.1_51542210_51950070_0	HG005	163104	176193	5	78	0	0	77	13089	174908	161819	0-3-7-4-8-5-6-2-4-7-2-5-6-2-1	0.0-3.0-7.0-4.0-8.0-5.0-6.0-2.0-4.1-7.1-2.1-5.0-6.0-2.0-1.0	99	163005	176094
HG005#2#JAHEPN010000023.1_51542210_51950070_0	HG005	176137	178881	6	24	0	0	21	2744	177652	174908	0-3-7-4-8-5-6-2-4-7-2-5-6-2-1	0.0-3.0-7.0-4.0-8.0-5.0-6.0-2.0-4.1-7.1-2.1-5.0-6.0-2.0-1.0	99	176038	178782
HG005#2#JAHEPN010000023.1_51542210_51950070_0	HG005	179258	209752	2	172	0	0	167	30494	208146	177652	0-3-7-4-8-5-6-2-4-7-2-5-6-2-1	0.0-3.0-7.0-4.0-8.0-5.0-6.0-2.0-4.1-7.1-2.1-5.0-6.0-2.0-1.0	99	179159	209653
HG005#2#JAHEPN010000023.1_51542210_51950070_0	HG005	212344	223885	4	96	1	58	4	11541	219687	208146	0-3-7-4-8-5-6-2-4-7-2-5-6-2-1	0.0-3.0-7.0-4.0-8.0-5.0-6.0-2.0-4.1-7.1-2.1-5.0-6.0-2.0-1.0	99	212245	223786
HG005#2#JAHEPN010000023.1_51542210_51950070_0	HG005	224952	228247	7	17	1	16	0	3295	222982	219687	0-3-7-4-8-5-6-2-4-7-2-5-6-2-1	0.0-3.0-7.0-4.0-8.0-5.0-6.0-2.0-4.1-7.1-2.1-5.0-6.0-2.0-1.0	99	224853	228148
HG005#2#JAHEPN010000023.1_51542210_51950070_0	HG005	229709	257243	2	172	1	170	15	27534	250516	222982	0-3-7-4-8-5-6-2-4-7-2-5-6-2-1	0.0-3.0-7.0-4.0-8.0-5.0-6.0-2.0-4.1-7.1-2.1-5.0-6.0-2.0-1.0	99	229610	257144
HG005#2#JAHEPN010000023.1_51542210_51950070_0	HG005	258209	270337	5	78	0	5	77	12128	262644	250516	0-3-7-4-8-5-6-2-4-7-2-5-6-2-1	0.0-3.0-7.0-4.0-8.0-5.0-6.0-2.0-4.1-7.1-2.1-5.0-6.0-2.0-1.0	99	258110	270238
HG005#2#JAHEPN010000023.1_51542210_51950070_0	HG005	270281	273025	6	24	0	0	21	2744	265388	262644	0-3-7-4-8-5-6-2-4-7-2-5-6-2-1	0.0-3.0-7.0-4.0-8.0-5.0-6.0-2.0-4.1-7.1-2.1-5.0-6.0-2.0-1.0	99	270182	272926
HG005#2#JAHEPN010000023.1_51542210_51950070_0	HG005	273402	304622	2	172	0	0	171	31220	296608	265388	0-3-7-4-8-5-6-2-4-7-2-5-6-2-1	0.0-3.0-7.0-4.0-8.0-5.0-6.0-2.0-4.1-7.1-2.1-5.0-6.0-2.0-1.0	99	273303	304523
HG005#2#JAHEPN010000023.1_51542210_51950070_0	HG005	304566	407788	1	612	0	0	611	103222	399830	296608	0-3-7-4-8-5-6-2-4-7-2-5-6-2-1	0.0-3.0-7.0-4.0-8.0-5.0-6.0-2.0-4.1-7.1-2.1-5.0-6.0-2.0-1.0	99	304467	407689
HG00621#1#JAHBCD010000034.1_2122997_2624098_1	HG00621	155	115516	0	671	0	0	670	115361	115361	0	0-3-7-4-8-5-6-2-4-7-2-6-5-2-4-7-2-6-5-2-1	0.0-3.0-7.0-4.0-8.0-5.0-6.0-2.0-4.1-7.1-2.1-6.1-5.1-2.0-4.1-7.1-2.1-6.1-5.1-2.0-1.0	155	0	115361
HG00621#1#JAHBCD010000034.1_2122997_2624098_1	HG00621	115607	138444	3	132	0	0	131	22837	138198	115361	0-3-7-4-8-5-6-2-4-7-2-6-5-2-4-7-2-6-5-2-1	0.0-3.0-7.0-4.0-8.0-5.0-6.0-2.0-4.1-7.1-2.1-6.1-5.1-2.0-4.1-7.1-2.1-6.1-5.1-2.0-1.0	155	115452	138289
HG00621#1#JAHBCD010000034.1_2122997_2624098_1	HG00621	139203	142499	7	17	0	0	16	3296	141494	138198	0-3-7-4-8-5-6-2-4-7-2-6-5-2-4-7-2-6-5-2-1	0.0-3.0-7.0-4.0-8.0-5.0-6.0-2.0-4.1-7.1-2.1-6.1-5.1-2.0-4.1-7.1-2.1-6.1-5.1-2.0-1.0	155	139048	142344
HG00621#1#JAHBCD010000034.1_2122997_2624098_1	HG00621	142947	161503	4	96	0	0	95	18556	160050	141494	0-3-7-4-8-5-6-2-4-7-2-6-5-2-4-7-2-6-5-2-1	0.0-3.0-7.0-4.0-8.0-5.0-6.0-2.0-4.1-7.1-2.1-6.1-5.1-2.0-4.1-7.1-2.1-6.1-5.1-2.0-1.0	155	142792	161348
HG00621#1#JAHBCD010000034.1_2122997_2624098_1	HG00621	161447	163217	8	8	0	0	7	1770	161820	160050	0-3-7-4-8-5-6-2-4-7-2-6-5-2-4-7-2-6-5-2-1	0.0-3.0-7.0-4.0-8.0-5.0-6.0-2.0-4.1-7.1-2.1-6.1-5.1-2.0-4.1-7.1-2.1-6.1-5.1-2.0-1.0	155	161292	163062
HG00621#1#JAHBCD010000034.1_2122997_2624098_1	HG00621	163161	175825	5	78	0	0	76	12664	174484	161820	0-3-7-4-8-5-6-2-4-7-2-6-5-2-4-7-2-6-5-2-1	0.0-3.0-7.0-4.0-8.0-5.0-6.0-2.0-4.1-7.1-2.1-6.1-5.1-2.0-4.1-7.1-2.1-6.1-5.1-2.0-1.0	155	163006	175670
HG00621#1#JAHBCD010000034.1_2122997_2624098_1	HG00621	176209	178953	6	24	0	0	21	2744	177228	174484	0-3-7-4-8-5-6-2-4-7-2-6-5-2-4-7-2-6-5-2-1	0.0-3.0-7.0-4.0-8.0-5.0-6.0-2.0-4.1-7.1-2.1-6.1-5.1-2.0-4.1-7.1-2.1-6.1-5.1-2.0-1.0	155	176054	178798
HG00621#1#JAHBCD010000034.1_2122997_2624098_1	HG00621	179311	210152	2	172	0	0	170	30841	208069	177228	0-3-7-4-8-5-6-2-4-7-2-6-5-2-4-7-2-6-5-2-1	0.0-3.0-7.0-4.0-8.0-5.0-6.0-2.0-4.1-7.1-2.1-6.1-5.1-2.0-4.1-7.1-2.1-6.1-5.1-2.0-1.0	155	179156	209997
HG00621#1#JAHBCD010000034.1_2122997_2624098_1	HG00621	212403	223947	4	96	1	58	4	11544	219613	208069	0-3-7-4-8-5-6-2-4-7-2-6-5-2-4-7-2-6-5-2-1	0.0-3.0-7.0-4.0-8.0-5.0-6.0-2.0-4.1-7.1-2.1-6.1-5.1-2.0-4.1-7.1-2.1-6.1-5.1-2.0-1.0	155	212248	223792
HG00621#1#JAHBCD010000034.1_2122997_2624098_1	HG00621	225012	228307	7	17	1	16	0	3295	222908	219613	0-3-7-4-8-5-6-2-4-7-2-6-5-2-4-7-2-6-5-2-1	0.0-3.0-7.0-4.0-8.0-5.0-6.0-2.0-4.1-7.1-2.1-6.1-5.1-2.0-4.1-7.1-2.1-6.1-5.1-2.0-1.0	155	224857	228152
HG00621#1#JAHBCD010000034.1_2122997_2624098_1	HG00621	229769	260609	2	172	1	170	0	30840	253748	222908	0-3-7-4-8-5-6-2-4-7-2-6-5-2-4-7-2-6-5-2-1	0.0-3.0-7.0-4.0-8.0-5.0-6.0-2.0-4.1-7.1-2.1-6.1-5.1-2.0-4.1-7.1-2.1-6.1-5.1-2.0-1.0	155	229614	260454
HG00621#1#JAHBCD010000034.1_2122997_2624098_1	HG00621	260985	263729	6	24	1	21	0	2744	256492	253748	0-3-7-4-8-5-6-2-4-7-2-6-5-2-4-7-2-6-5-2-1	0.0-3.0-7.0-4.0-8.0-5.0-6.0-2.0-4.1-7.1-2.1-6.1-5.1-2.0-4.1-7.1-2.1-6.1-5.1-2.0-1.0	155	260830	263574
HG00621#1#JAHBCD010000034.1_2122997_2624098_1	HG00621	263673	275801	5	78	1	77	5	12128	268620	256492	0-3-7-4-8-5-6-2-4-7-2-6-5-2-4-7-2-6-5-2-1	0.0-3.0-7.0-4.0-8.0-5.0-6.0-2.0-4.1-7.1-2.1-6.1-5.1-2.0-4.1-7.1-2.1-6.1-5.1-2.0-1.0	155	263518	275646
HG00621#1#JAHBCD010000034.1_2122997_2624098_1	HG00621	276767	303957	2	172	0	15	167	27190	295810	268620	0-3-7-4-8-5-6-2-4-7-2-6-5-2-4-7-2-6-5-2-1	0.0-3.0-7.0-4.0-8.0-5.0-6.0-2.0-4.1-7.1-2.1-6.1-5.1-2.0-4.1-7.1-2.1-6.1-5.1-2.0-1.0	155	276612	303802
HG00621#1#JAHBCD010000034.1_2122997_2624098_1	HG00621	306549	318099	4	96	1	58	4	11550	307360	295810	0-3-7-4-8-5-6-2-4-7-2-6-5-2-4-7-2-6-5-2-1	0.0-3.0-7.0-4.0-8.0-5.0-6.0-2.0-4.1-7.1-2.1-6.1-5.1-2.0-4.1-7.1-2.1-6.1-5.1-2.0-1.0	155	306394	317944
HG00621#1#JAHBCD010000034.1_2122997_2624098_1	HG00621	319166	322461	7	17	1	16	0	3295	310655	307360	0-3-7-4-8-5-6-2-4-7-2-6-5-2-4-7-2-6-5-2-1	0.0-3.0-7.0-4.0-8.0-5.0-6.0-2.0-4.1-7.1-2.1-6.1-5.1-2.0-4.1-7.1-2.1-6.1-5.1-2.0-1.0	155	319011	322306
HG00621#1#JAHBCD010000034.1_2122997_2624098_1	HG00621	323923	354763	2	172	1	170	0	30840	341495	310655	0-3-7-4-8-5-6-2-4-7-2-6-5-2-4-7-2-6-5-2-1	0.0-3.0-7.0-4.0-8.0-5.0-6.0-2.0-4.1-7.1-2.1-6.1-5.1-2.0-4.1-7.1-2.1-6.1-5.1-2.0-1.0	155	323768	354608
HG00621#1#JAHBCD010000034.1_2122997_2624098_1	HG00621	355139	357883	6	24	1	21	0	2744	344239	341495	0-3-7-4-8-5-6-2-4-7-2-6-5-2-4-7-2-6-5-2-1	0.0-3.0-7.0-4.0-8.0-5.0-6.0-2.0-4.1-7.1-2.1-6.1-5.1-2.0-4.1-7.1-2.1-6.1-5.1-2.0-1.0	155	354984	357728
HG00621#1#JAHBCD010000034.1_2122997_2624098_1	HG00621	357827	369955	5	78	1	77	5	12128	356367	344239	0-3-7-4-8-5-6-2-4-7-2-6-5-2-4-7-2-6-5-2-1	0.0-3.0-7.0-4.0-8.0-5.0-6.0-2.0-4.1-7.1-2.1-6.1-5.1-2.0-4.1-7.1-2.1-6.1-5.1-2.0-1.0	155	357672	369800
HG00621#1#JAHBCD010000034.1_2122997_2624098_1	HG00621	370921	398837	2	172	0	15	171	27916	384283	356367	0-3-7-4-8-5-6-2-4-7-2-6-5-2-4-7-2-6-5-2-1	0.0-3.0-7.0-4.0-8.0-5.0-6.0-2.0-4.1-7.1-2.1-6.1-5.1-2.0-4.1-7.1-2.1-6.1-5.1-2.0-1.0	155	370766	398682
HG00621#1#JAHBCD010000034.1_2122997_2624098_1	HG00621	398781	500897	1	612	0	0	604	102116	486399	384283	0-3-7-4-8-5-6-2-4-7-2-6-5-2-4-7-2-6-5-2-1	0.0-3.0-7.0-4.0-8.0-5.0-6.0-2.0-4.1-7.1-2.1-6.1-5.1-2.0-4.1-7.1-2.1-6.1-5.1-2.0-1.0	155	398626	500742
HG00621#2#JAHBCC010000031.1_16669999_17077865_0	HG00621	99	115498	0	671	0	0	670	115399	115399	0	0-3-7-4-8-5-6-2-4-7-2-5-6-2-1	0.0-3.0-7.0-4.0-8.0-5.0-6.0-2.0-4.1-7.1-2.1-5.0-6.0-2.0-1.0	99	0	115399
HG00621#2#JAHBCC010000031.1_16669999_17077865_0	HG00621	115589	138426	3	132	0	0	131	22837	138236	115399	0-3-7-4-8-5-6-2-4-7-2-5-6-2-1	0.0-3.0-7.0-4.0-8.0-5.0-6.0-2.0-4.1-7.1-2.1-5.0-6.0-2.0-1.0	99	115490	138327
HG00621#2#JAHBCC010000031.1_16669999_17077865_0	HG00621	139185	142481	7	17	0	0	16	3296	141532	138236	0-3-7-4-8-5-6-2-4-7-2-5-6-2-1	0.0-3.0-7.0-4.0-8.0-5.0-6.0-2.0-4.1-7.1-2.1-5.0-6.0-2.0-1.0	99	139086	142382
HG00621#2#JAHBCC010000031.1_16669999_17077865_0	HG00621	142929	161485	4	96	0	0	95	18556	160088	141532	0-3-7-4-8-5-6-2-4-7-2-5-6-2-1	0.0-3.0-7.0-4.0-8.0-5.0-6.0-2.0-4.1-7.1-2.1-5.0-6.0-2.0-1.0	99	142830	161386
HG00621#2#JAHBCC010000031.1_16669999_17077865_0	HG00621	161429	163199	8	8	0	0	7	1770	161858	160088	0-3-7-4-8-5-6-2-4-7-2-5-6-2-1	0.0-3.0-7.0-4.0-8.0-5.0-6.0-2.0-4.1-7.1-2.1-5.0-6.0-2.0-1.0	99	161330	163100
HG00621#2#JAHBCC010000031.1_16669999_17077865_0	HG00621	163143	176247	5	78	0	0	77	13104	174962	161858	0-3-7-4-8-5-6-2-4-7-2-5-6-2-1	0.0-3.0-7.0-4.0-8.0-5.0-6.0-2.0-4.1-7.1-2.1-5.0-6.0-2.0-1.0	99	163044	176148
HG00621#2#JAHBCC010000031.1_16669999_17077865_0	HG00621	176191	178935	6	24	0	0	21	2744	177706	174962	0-3-7-4-8-5-6-2-4-7-2-5-6-2-1	0.0-3.0-7.0-4.0-8.0-5.0-6.0-2.0-4.1-7.1-2.1-5.0-6.0-2.0-1.0	99	176092	178836
HG00621#2#JAHBCC010000031.1_16669999_17077865_0	HG00621	179293	210117	2	172	0	0	170	30824	208530	177706	0-3-7-4-8-5-6-2-4-7-2-5-6-2-1	0.0-3.0-7.0-4.0-8.0-5.0-6.0-2.0-4.1-7.1-2.1-5.0-6.0-2.0-1.0	99	179194	210018
HG00621#2#JAHBCC010000031.1_16669999_17077865_0	HG00621	212368	223914	4	96	1	58	4	11546	220076	208530	0-3-7-4-8-5-6-2-4-7-2-5-6-2-1	0.0-3.0-7.0-4.0-8.0-5.0-6.0-2.0-4.1-7.1-2.1-5.0-6.0-2.0-1.0	99	212269	223815
HG00621#2#JAHBCC010000031.1_16669999_17077865_0	HG00621	224983	228278	7	17	1	16	0	3295	223371	220076	0-3-7-4-8-5-6-2-4-7-2-5-6-2-1	0.0-3.0-7.0-4.0-8.0-5.0-6.0-2.0-4.1-7.1-2.1-5.0-6.0-2.0-1.0	99	224884	228179
HG00621#2#JAHBCC010000031.1_16669999_17077865_0	HG00621	229740	257267	2	172	1	170	15	27527	250898	223371	0-3-7-4-8-5-6-2-4-7-2-5-6-2-1	0.0-3.0-7.0-4.0-8.0-5.0-6.0-2.0-4.1-7.1-2.1-5.0-6.0-2.0-1.0	99	229641	257168
HG00621#2#JAHBCC010000031.1_16669999_17077865_0	HG00621	258233	269921	5	78	0	5	76	11688	262586	250898	0-3-7-4-8-5-6-2-4-7-2-5-6-2-1	0.0-3.0-7.0-4.0-8.0-5.0-6.0-2.0-4.1-7.1-2.1-5.0-6.0-2.0-1.0	99	258134	269822
HG00621#2#JAHBCC010000031.1_16669999_17077865_0	HG00621	270528	273055	6	24	0	1	21	2527	265113	262586	0-3-7-4-8-5-6-2-4-7-2-5-6-2-1	0.0-3.0-7.0-4.0-8.0-5.0-6.0-2.0-4.1-7.1-2.1-5.0-6.0-2.0-1.0	99	270429	272956
HG00621#2#JAHBCC010000031.1_16669999_17077865_0	HG00621	273413	304635	2	172	0	0	171	31222	296335	265113	0-3-7-4-8-5-6-2-4-7-2-5-6-2-1	0.0-3.0-7.0-4.0-8.0-5.0-6.0-2.0-4.1-7.1-2.1-5.0-6.0-2.0-1.0	99	273314	304536
HG00621#2#JAHBCC010000031.1_16669999_17077865_0	HG00621	304579	407794	1	612	0	0	611	103215	399550	296335	0-3-7-4-8-5-6-2-4-7-2-5-6-2-1	0.0-3.0-7.0-4.0-8.0-5.0-6.0-2.0-4.1-7.1-2.1-5.0-6.0-2.0-1.0	99	304480	407695
HG00733#1#JAHEPQ010000019.1_46106835_46420495_0	HG00733	99	115407	0	671	0	0	670	115308	115308	0	0-3-7-4-8-5-6-2-1	0.0-3.0-7.0-4.0-8.0-5.0-6.0-2.0-1.0	99	0	115308
HG00733#1#JAHEPQ010000019.1_46106835_46420495_0	HG00733	115498	138333	3	132	0	0	131	22835	138143	115308	0-3-7-4-8-5-6-2-1	0.0-3.0-7.0-4.0-8.0-5.0-6.0-2.0-1.0	99	115399	138234
HG00733#1#JAHEPQ010000019.1_46106835_46420495_0	HG00733	139092	142388	7	17	0	0	16	3296	141439	138143	0-3-7-4-8-5-6-2-1	0.0-3.0-7.0-4.0-8.0-5.0-6.0-2.0-1.0	99	138993	142289
HG00733#1#JAHEPQ010000019.1_46106835_46420495_0	HG00733	142836	161392	4	96	0	0	95	18556	159995	141439	0-3-7-4-8-5-6-2-1	0.0-3.0-7.0-4.0-8.0-5.0-6.0-2.0-1.0	99	142737	161293
HG00733#1#JAHEPQ010000019.1_46106835_46420495_0	HG00733	161336	163106	8	8	0	0	7	1770	161765	159995	0-3-7-4-8-5-6-2-1	0.0-3.0-7.0-4.0-8.0-5.0-6.0-2.0-1.0	99	161237	163007
HG00733#1#JAHEPQ010000019.1_46106835_46420495_0	HG00733	163050	176154	5	78	0	0	77	13104	174869	161765	0-3-7-4-8-5-6-2-1	0.0-3.0-7.0-4.0-8.0-5.0-6.0-2.0-1.0	99	162951	176055
HG00733#1#JAHEPQ010000019.1_46106835_46420495_0	HG00733	176098	178842	6	24	0	0	21	2744	177613	174869	0-3-7-4-8-5-6-2-1	0.0-3.0-7.0-4.0-8.0-5.0-6.0-2.0-1.0	99	175999	178743
HG00733#1#JAHEPQ010000019.1_46106835_46420495_0	HG00733	179200	210420	2	172	0	0	171	31220	208833	177613	0-3-7-4-8-5-6-2-1	0.0-3.0-7.0-4.0-8.0-5.0-6.0-2.0-1.0	99	179101	210321
HG00733#1#JAHEPQ010000019.1_46106835_46420495_0	HG00733	210364	313272	1	612	0	0	608	102908	311741	208833	0-3-7-4-8-5-6-2-1	0.0-3.0-7.0-4.0-8.0-5.0-6.0-2.0-1.0	99	210265	313173
HG00741#1#JAHALY010000007.1_18781197_19307680_1	HG00741	154	115531	0	671	0	0	670	115377	115377	0	0-3-7-4-8-5-6-2-4-0-3-7-4-8-5-6-2-4-4-2-5-6-2-1	0.0-3.0-7.0-4.0-8.0-5.0-6.0-2.0-4.1-0.0-3.0-7.0-4.0-8.0-5.0-6.0-2.0-4.1-4.0-2.1-5.0-6.0-2.0-1.0	154	0	115377
HG00741#1#JAHALY010000007.1_18781197_19307680_1	HG00741	115622	138454	3	132	0	0	131	22832	138209	115377	0-3-7-4-8-5-6-2-4-0-3-7-4-8-5-6-2-4-4-2-5-6-2-1	0.0-3.0-7.0-4.0-8.0-5.0-6.0-2.0-4.1-0.0-3.0-7.0-4.0-8.0-5.0-6.0-2.0-4.1-4.0-2.1-5.0-6.0-2.0-1.0	154	115468	138300
HG00741#1#JAHALY010000007.1_18781197_19307680_1	HG00741	139213	142509	7	17	0	0	16	3296	141505	138209	0-3-7-4-8-5-6-2-4-0-3-7-4-8-5-6-2-4-4-2-5-6-2-1	0.0-3.0-7.0-4.0-8.0-5.0-6.0-2.0-4.1-0.0-3.0-7.0-4.0-8.0-5.0-6.0-2.0-4.1-4.0-2.1-5.0-6.0-2.0-1.0	154	139059	142355
HG00741#1#JAHALY010000007.1_18781197_19307680_1	HG00741	142957	161525	4	96	0	0	95	18568	160073	141505	0-3-7-4-8-5-6-2-4-0-3-7-4-8-5-6-2-4-4-2-5-6-2-1	0.0-3.0-7.0-4.0-8.0-5.0-6.0-2.0-4.1-0.0-3.0-7.0-4.0-8.0-5.0-6.0-2.0-4.1-4.0-2.1-5.0-6.0-2.0-1.0	154	142803	161371
HG00741#1#JAHALY010000007.1_18781197_19307680_1	HG00741	161469	163239	8	8	0	0	7	1770	161843	160073	0-3-7-4-8-5-6-2-4-0-3-7-4-8-5-6-2-4-4-2-5-6-2-1	0.0-3.0-7.0-4.0-8.0-5.0-6.0-2.0-4.1-0.0-3.0-7.0-4.0-8.0-5.0-6.0-2.0-4.1-4.0-2.1-5.0-6.0-2.0-1.0	154	161315	163085
HG00741#1#JAHALY010000007.1_18781197_19307680_1	HG00741	163183	176287	5	78	0	0	77	13104	174947	161843	0-3-7-4-8-5-6-2-4-0-3-7-4-8-5-6-2-4-4-2-5-6-2-1	0.0-3.0-7.0-4.0-8.0-5.0-6.0-2.0-4.1-0.0-3.0-7.0-4.0-8.0-5.0-6.0-2.0-4.1-4.0-2.1-5.0-6.0-2.0-1.0	154	163029	176133
HG00741#1#JAHALY010000007.1_18781197_19307680_1	HG00741	176231	179391	6	24	0	0	23	3160	178107	174947	0-3-7-4-8-5-6-2-4-0-3-7-4-8-5-6-2-4-4-2-5-6-2-1	0.0-3.0-7.0-4.0-8.0-5.0-6.0-2.0-4.1-0.0-3.0-7.0-4.0-8.0-5.0-6.0-2.0-4.1-4.0-2.1-5.0-6.0-2.0-1.0	154	176077	179237
HG00741#1#JAHALY010000007.1_18781197_19307680_1	HG00741	179335	210539	2	172	0	0	171	31204	209311	178107	0-3-7-4-8-5-6-2-4-0-3-7-4-8-5-6-2-4-4-2-5-6-2-1	0.0-3.0-7.0-4.0-8.0-5.0-6.0-2.0-4.1-0.0-3.0-7.0-4.0-8.0-5.0-6.0-2.0-4.1-4.0-2.1-5.0-6.0-2.0-1.0	154	179181	210385
HG00741#1#JAHALY010000007.1_18781197_19307680_1	HG00741	212405	220885	4	96	1	58	22	8480	217791	209311	0-3-7-4-8-5-6-2-4-0-3-7-4-8-5-6-2-4-4-2-5-6-2-1	0.0-3.0-7.0-4.0-8.0-5.0-6.0-2.0-4.1-0.0-3.0-7.0-4.0-8.0-5.0-6.0-2.0-4.1-4.0-2.1-5.0-6.0-2.0-1.0	154	212251	220731
HG00741#1#JAHALY010000007.1_18781197_19307680_1	HG00741	221062	231273	0	671	0	603	670	10211	228002	217791	0-3-7-4-8-5-6-2-4-0-3-7-4-8-5-6-2-4-4-2-5-6-2-1	0.0-3.0-7.0-4.0-8.0-5.0-6.0-2.0-4.1-0.0-3.0-7.0-4.0-8.0-5.0-6.0-2.0-4.1-4.0-2.1-5.0-6.0-2.0-1.0	154	220908	231119
HG00741#1#JAHALY010000007.1_18781197_19307680_1	HG00741	231364	254196	3	132	0	0	131	22832	250834	228002	0-3-7-4-8-5-6-2-4-0-3-7-4-8-5-6-2-4-4-2-5-6-2-1	0.0-3.0-7.0-4.0-8.0-5.0-6.0-2.0-4.1-0.0-3.0-7.0-4.0-8.0-5.0-6.0-2.0-4.1-4.0-2.1-5.0-6.0-2.0-1.0	154	231210	254042
HG00741#1#JAHALY010000007.1_18781197_19307680_1	HG00741	254955	258251	7	17	0	0	16	3296	254130	250834	0-3-7-4-8-5-6-2-4-0-3-7-4-8-5-6-2-4-4-2-5-6-2-1	0.0-3.0-7.0-4.0-8.0-5.0-6.0-2.0-4.1-0.0-3.0-7.0-4.0-8.0-5.0-6.0-2.0-4.1-4.0-2.1-5.0-6.0-2.0-1.0	154	254801	258097
HG00741#1#JAHALY010000007.1_18781197_19307680_1	HG00741	258699	277269	4	96	0	0	95	18570	272700	254130	0-3-7-4-8-5-6-2-4-0-3-7-4-8-5-6-2-4-4-2-5-6-2-1	0.0-3.0-7.0-4.0-8.0-5.0-6.0-2.0-4.1-0.0-3.0-7.0-4.0-8.0-5.0-6.0-2.0-4.1-4.0-2.1-5.0-6.0-2.0-1.0	154	258545	277115
HG00741#1#JAHALY010000007.1_18781197_19307680_1	HG00741	277213	278983	8	8	0	0	7	1770	274470	272700	0-3-7-4-8-5-6-2-4-0-3-7-4-8-5-6-2-4-4-2-5-6-2-1	0.0-3.0-7.0-4.0-8.0-5.0-6.0-2.0-4.1-0.0-3.0-7.0-4.0-8.0-5.0-6.0-2.0-4.1-4.0-2.1-5.0-6.0-2.0-1.0	154	277059	278829
HG00741#1#JAHALY010000007.1_18781197_19307680_1	HG00741	278927	292066	5	78	0	0	77	13139	287609	274470	0-3-7-4-8-5-6-2-4-0-3-7-4-8-5-6-2-4-4-2-5-6-2-1	0.0-3.0-7.0-4.0-8.0-5.0-6.0-2.0-4.1-0.0-3.0-7.0-4.0-8.0-5.0-6.0-2.0-4.1-4.0-2.1-5.0-6.0-2.0-1.0	154	278773	291912
HG00741#1#JAHALY010000007.1_18781197_19307680_1	HG00741	292010	295170	6	24	0	0	23	3160	290769	287609	0-3-7-4-8-5-6-2-4-0-3-7-4-8-5-6-2-4-4-2-5-6-2-1	0.0-3.0-7.0-4.0-8.0-5.0-6.0-2.0-4.1-0.0-3.0-7.0-4.0-8.0-5.0-6.0-2.0-4.1-4.0-2.1-5.0-6.0-2.0-1.0	154	291856	295016
HG00741#1#JAHALY010000007.1_18781197_19307680_1	HG00741	295114	326321	2	172	0	0	171	31207	321976	290769	0-3-7-4-8-5-6-2-4-0-3-7-4-8-5-6-2-4-4-2-5-6-2-1	0.0-3.0-7.0-4.0-8.0-5.0-6.0-2.0-4.1-0.0-3.0-7.0-4.0-8.0-5.0-6.0-2.0-4.1-4.0-2.1-5.0-6.0-2.0-1.0	154	294960	326167
HG00741#1#JAHALY010000007.1_18781197_19307680_1	HG00741	328187	336668	4	96	1	58	22	8481	330457	321976	0-3-7-4-8-5-6-2-4-0-3-7-4-8-5-6-2-4-4-2-5-6-2-1	0.0-3.0-7.0-4.0-8.0-5.0-6.0-2.0-4.1-0.0-3.0-7.0-4.0-8.0-5.0-6.0-2.0-4.1-4.0-2.1-5.0-6.0-2.0-1.0	154	328033	336514
HG00741#1#JAHALY010000007.1_18781197_19307680_1	HG00741	336976	346209	4	96	0	20	58	9233	339690	330457	0-3-7-4-8-5-6-2-4-0-3-7-4-8-5-6-2-4-4-2-5-6-2-1	0.0-3.0-7.0-4.0-8.0-5.0-6.0-2.0-4.1-0.0-3.0-7.0-4.0-8.0-5.0-6.0-2.0-4.1-4.0-2.1-5.0-6.0-2.0-1.0	154	336822	346055
HG00741#1#JAHALY010000007.1_18781197_19307680_1	HG00741	348075	375982	2	172	1	171	15	27907	367597	339690	0-3-7-4-8-5-6-2-4-0-3-7-4-8-5-6-2-4-4-2-5-6-2-1	0.0-3.0-7.0-4.0-8.0-5.0-6.0-2.0-4.1-0.0-3.0-7.0-4.0-8.0-5.0-6.0-2.0-4.1-4.0-2.1-5.0-6.0-2.0-1.0	154	347921	375828
HG00741#1#JAHALY010000007.1_18781197_19307680_1	HG00741	376421	389076	5	78	0	3	77	12655	380252	367597	0-3-7-4-8-5-6-2-4-0-3-7-4-8-5-6-2-4-4-2-5-6-2-1	0.0-3.0-7.0-4.0-8.0-5.0-6.0-2.0-4.1-0.0-3.0-7.0-4.0-8.0-5.0-6.0-2.0-4.1-4.0-2.1-5.0-6.0-2.0-1.0	154	376267	388922
HG00741#1#JAHALY010000007.1_18781197_19307680_1	HG00741	389020	391764	6	24	0	0	21	2744	382996	380252	0-3-7-4-8-5-6-2-4-0-3-7-4-8-5-6-2-4-4-2-5-6-2-1	0.0-3.0-7.0-4.0-8.0-5.0-6.0-2.0-4.1-0.0-3.0-7.0-4.0-8.0-5.0-6.0-2.0-4.1-4.0-2.1-5.0-6.0-2.0-1.0	154	388866	391610
HG00741#1#JAHALY010000007.1_18781197_19307680_1	HG00741	392125	423341	2	172	0	0	171	31216	414212	382996	0-3-7-4-8-5-6-2-4-0-3-7-4-8-5-6-2-4-4-2-5-6-2-1	0.0-3.0-7.0-4.0-8.0-5.0-6.0-2.0-4.1-0.0-3.0-7.0-4.0-8.0-5.0-6.0-2.0-4.1-4.0-2.1-5.0-6.0-2.0-1.0	154	391971	423187
HG00741#1#JAHALY010000007.1_18781197_19307680_1	HG00741	423285	526467	1	612	0	0	611	103182	517394	414212	0-3-7-4-8-5-6-2-4-0-3-7-4-8-5-6-2-4-4-2-5-6-2-1	0.0-3.0-7.0-4.0-8.0-5.0-6.0-2.0-4.1-0.0-3.0-7.0-4.0-8.0-5.0-6.0-2.0-4.1-4.0-2.1-5.0-6.0-2.0-1.0	154	423131	526313
HG00741#2#JAHALX010000013.1_51574319_51981226_0	HG00741	98	115506	0	671	0	0	670	115408	115408	0	0-3-7-4-8-5-6-2-7-4-2-6-5-2-1	0.0-3.0-7.0-4.0-8.0-5.0-6.0-2.0-7.0-4.0-2.1-6.1-5.1-2.0-1.0	98	0	115408
HG00741#2#JAHALX010000013.1_51574319_51981226_0	HG00741	115597	138431	3	132	0	0	131	22834	138242	115408	0-3-7-4-8-5-6-2-7-4-2-6-5-2-1	0.0-3.0-7.0-4.0-8.0-5.0-6.0-2.0-7.0-4.0-2.1-6.1-5.1-2.0-1.0	98	115499	138333
HG00741#2#JAHALX010000013.1_51574319_51981226_0	HG00741	139190	142486	7	17	0	0	16	3296	141538	138242	0-3-7-4-8-5-6-2-7-4-2-6-5-2-1	0.0-3.0-7.0-4.0-8.0-5.0-6.0-2.0-7.0-4.0-2.1-6.1-5.1-2.0-1.0	98	139092	142388
HG00741#2#JAHALX010000013.1_51574319_51981226_0	HG00741	142934	161480	4	96	0	0	95	18546	160084	141538	0-3-7-4-8-5-6-2-7-4-2-6-5-2-1	0.0-3.0-7.0-4.0-8.0-5.0-6.0-2.0-7.0-4.0-2.1-6.1-5.1-2.0-1.0	98	142836	161382
HG00741#2#JAHALX010000013.1_51574319_51981226_0	HG00741	161424	163194	8	8	0	0	7	1770	161854	160084	0-3-7-4-8-5-6-2-7-4-2-6-5-2-1	0.0-3.0-7.0-4.0-8.0-5.0-6.0-2.0-7.0-4.0-2.1-6.1-5.1-2.0-1.0	98	161326	163096
HG00741#2#JAHALX010000013.1_51574319_51981226_0	HG00741	163138	175802	5	78	0	0	76	12664	174518	161854	0-3-7-4-8-5-6-2-7-4-2-6-5-2-1	0.0-3.0-7.0-4.0-8.0-5.0-6.0-2.0-7.0-4.0-2.1-6.1-5.1-2.0-1.0	98	163040	175704
HG00741#2#JAHALX010000013.1_51574319_51981226_0	HG00741	176409	179352	6	24	0	1	23	2943	177461	174518	0-3-7-4-8-5-6-2-7-4-2-6-5-2-1	0.0-3.0-7.0-4.0-8.0-5.0-6.0-2.0-7.0-4.0-2.1-6.1-5.1-2.0-1.0	98	176311	179254
HG00741#2#JAHALX010000013.1_51574319_51981226_0	HG00741	179296	210520	2	172	0	0	171	31224	208685	177461	0-3-7-4-8-5-6-2-7-4-2-6-5-2-1	0.0-3.0-7.0-4.0-8.0-5.0-6.0-2.0-7.0-4.0-2.1-6.1-5.1-2.0-1.0	98	179198	210422
HG00741#2#JAHALX010000013.1_51574319_51981226_0	HG00741	211597	214893	7	17	0	0	16	3296	211981	208685	0-3-7-4-8-5-6-2-7-4-2-6-5-2-1	0.0-3.0-7.0-4.0-8.0-5.0-6.0-2.0-7.0-4.0-2.1-6.1-5.1-2.0-1.0	98	211499	214795
HG00741#2#JAHALX010000013.1_51574319_51981226_0	HG00741	215956	227501	4	96	0	4	58	11545	223526	211981	0-3-7-4-8-5-6-2-7-4-2-6-5-2-1	0.0-3.0-7.0-4.0-8.0-5.0-6.0-2.0-7.0-4.0-2.1-6.1-5.1-2.0-1.0	98	215858	227403
HG00741#2#JAHALX010000013.1_51574319_51981226_0	HG00741	229367	260587	2	172	1	171	0	31220	254746	223526	0-3-7-4-8-5-6-2-7-4-2-6-5-2-1	0.0-3.0-7.0-4.0-8.0-5.0-6.0-2.0-7.0-4.0-2.1-6.1-5.1-2.0-1.0	98	229269	260489
HG00741#2#JAHALX010000013.1_51574319_51981226_0	HG00741	260948	263475	6	24	1	21	1	2527	257273	254746	0-3-7-4-8-5-6-2-7-4-2-6-5-2-1	0.0-3.0-7.0-4.0-8.0-5.0-6.0-2.0-7.0-4.0-2.1-6.1-5.1-2.0-1.0	98	260850	263377
HG00741#2#JAHALX010000013.1_51574319_51981226_0	HG00741	264082	276297	5	78	1	76	3	12215	269488	257273	0-3-7-4-8-5-6-2-7-4-2-6-5-2-1	0.0-3.0-7.0-4.0-8.0-5.0-6.0-2.0-7.0-4.0-2.1-6.1-5.1-2.0-1.0	98	263984	276199
HG00741#2#JAHALX010000013.1_51574319_51981226_0	HG00741	276736	304649	2	172	0	15	171	27913	297401	269488	0-3-7-4-8-5-6-2-7-4-2-6-5-2-1	0.0-3.0-7.0-4.0-8.0-5.0-6.0-2.0-7.0-4.0-2.1-6.1-5.1-2.0-1.0	98	276638	304551
HG00741#2#JAHALX010000013.1_51574319_51981226_0	HG00741	304593	406963	1	612	0	0	606	102370	399771	297401	0-3-7-4-8-5-6-2-7-4-2-6-5-2-1	0.0-3.0-7.0-4.0-8.0-5.0-6.0-2.0-7.0-4.0-2.1-6.1-5.1-2.0-1.0	98	304495	406865
HG01071#1#JAHBCF010000053.1_26607100_27108065_1	HG01071	155	115478	0	671	0	0	670	115323	115323	0	0-3-7-4-8-5-6-2-4-7-2-5-6-2-7-4-2-6-5-2-1	0.0-3.0-7.0-4.0-8.0-5.0-6.0-2.0-4.1-7.1-2.1-5.0-6.0-2.0-7.0-4.0-2.1-6.1-5.1-2.0-1.0	155	0	115323
HG01071#1#JAHBCF010000053.1_26607100_27108065_1	HG01071	115569	138405	3	132	0	0	131	22836	138159	115323	0-3-7-4-8-5-6-2-4-7-2-5-6-2-7-4-2-6-5-2-1	0.0-3.0-7.0-4.0-8.0-5.0-6.0-2.0-4.1-7.1-2.1-5.0-6.0-2.0-7.0-4.0-2.1-6.1-5.1-2.0-1.0	155	115414	138250
HG01071#1#JAHBCF010000053.1_26607100_27108065_1	HG01071	139164	142460	7	17	0	0	16	3296	141455	138159	0-3-7-4-8-5-6-2-4-7-2-5-6-2-7-4-2-6-5-2-1	0.0-3.0-7.0-4.0-8.0-5.0-6.0-2.0-4.1-7.1-2.1-5.0-6.0-2.0-7.0-4.0-2.1-6.1-5.1-2.0-1.0	155	139009	142305
HG01071#1#JAHBCF010000053.1_26607100_27108065_1	HG01071	142908	161466	4	96	0	0	95	18558	160013	141455	0-3-7-4-8-5-6-2-4-7-2-5-6-2-7-4-2-6-5-2-1	0.0-3.0-7.0-4.0-8.0-5.0-6.0-2.0-4.1-7.1-2.1-5.0-6.0-2.0-7.0-4.0-2.1-6.1-5.1-2.0-1.0	155	142753	161311
HG01071#1#JAHBCF010000053.1_26607100_27108065_1	HG01071	161410	163180	8	8	0	0	7	1770	161783	160013	0-3-7-4-8-5-6-2-4-7-2-5-6-2-7-4-2-6-5-2-1	0.0-3.0-7.0-4.0-8.0-5.0-6.0-2.0-4.1-7.1-2.1-5.0-6.0-2.0-7.0-4.0-2.1-6.1-5.1-2.0-1.0	155	161255	163025
HG01071#1#JAHBCF010000053.1_26607100_27108065_1	HG01071	163124	176228	5	78	0	0	77	13104	174887	161783	0-3-7-4-8-5-6-2-4-7-2-5-6-2-7-4-2-6-5-2-1	0.0-3.0-7.0-4.0-8.0-5.0-6.0-2.0-4.1-7.1-2.1-5.0-6.0-2.0-7.0-4.0-2.1-6.1-5.1-2.0-1.0	155	162969	176073
HG01071#1#JAHBCF010000053.1_26607100_27108065_1	HG01071	176172	178916	6	24	0	0	21	2744	177631	174887	0-3-7-4-8-5-6-2-4-7-2-5-6-2-7-4-2-6-5-2-1	0.0-3.0-7.0-4.0-8.0-5.0-6.0-2.0-4.1-7.1-2.1-5.0-6.0-2.0-7.0-4.0-2.1-6.1-5.1-2.0-1.0	155	176017	178761
HG01071#1#JAHBCF010000053.1_26607100_27108065_1	HG01071	179274	210112	2	172	0	0	170	30838	208469	177631	0-3-7-4-8-5-6-2-4-7-2-5-6-2-7-4-2-6-5-2-1	0.0-3.0-7.0-4.0-8.0-5.0-6.0-2.0-4.1-7.1-2.1-5.0-6.0-2.0-7.0-4.0-2.1-6.1-5.1-2.0-1.0	155	179119	209957
HG01071#1#JAHBCF010000053.1_26607100_27108065_1	HG01071	212363	223909	4	96	1	58	4	11546	220015	208469	0-3-7-4-8-5-6-2-4-7-2-5-6-2-7-4-2-6-5-2-1	0.0-3.0-7.0-4.0-8.0-5.0-6.0-2.0-4.1-7.1-2.1-5.0-6.0-2.0-7.0-4.0-2.1-6.1-5.1-2.0-1.0	155	212208	223754
HG01071#1#JAHBCF010000053.1_26607100_27108065_1	HG01071	224974	228269	7	17	1	16	0	3295	223310	220015	0-3-7-4-8-5-6-2-4-7-2-5-6-2-7-4-2-6-5-2-1	0.0-3.0-7.0-4.0-8.0-5.0-6.0-2.0-4.1-7.1-2.1-5.0-6.0-2.0-7.0-4.0-2.1-6.1-5.1-2.0-1.0	155	224819	228114
HG01071#1#JAHBCF010000053.1_26607100_27108065_1	HG01071	229731	257259	2	172	1	170	15	27528	250838	223310	0-3-7-4-8-5-6-2-4-7-2-5-6-2-7-4-2-6-5-2-1	0.0-3.0-7.0-4.0-8.0-5.0-6.0-2.0-4.1-7.1-2.1-5.0-6.0-2.0-7.0-4.0-2.1-6.1-5.1-2.0-1.0	155	229576	257104
HG01071#1#JAHBCF010000053.1_26607100_27108065_1	HG01071	258225	269913	5	78	0	5	76	11688	262526	250838	0-3-7-4-8-5-6-2-4-7-2-5-6-2-7-4-2-6-5-2-1	0.0-3.0-7.0-4.0-8.0-5.0-6.0-2.0-4.1-7.1-2.1-5.0-6.0-2.0-7.0-4.0-2.1-6.1-5.1-2.0-1.0	155	258070	269758
HG01071#1#JAHBCF010000053.1_26607100_27108065_1	HG01071	270520	273047	6	24	0	1	21	2527	265053	262526	0-3-7-4-8-5-6-2-4-7-2-5-6-2-7-4-2-6-5-2-1	0.0-3.0-7.0-4.0-8.0-5.0-6.0-2.0-4.1-7.1-2.1-5.0-6.0-2.0-7.0-4.0-2.1-6.1-5.1-2.0-1.0	155	270365	272892
HG01071#1#JAHBCF010000053.1_26607100_27108065_1	HG01071	273405	304623	2	172	0	0	171	31218	296271	265053	0-3-7-4-8-5-6-2-4-7-2-5-6-2-7-4-2-6-5-2-1	0.0-3.0-7.0-4.0-8.0-5.0-6.0-2.0-4.1-7.1-2.1-5.0-6.0-2.0-7.0-4.0-2.1-6.1-5.1-2.0-1.0	155	273250	304468
HG01071#1#JAHBCF010000053.1_26607100_27108065_1	HG01071	305700	308996	7	17	0	0	16	3296	299567	296271	0-3-7-4-8-5-6-2-4-7-2-5-6-2-7-4-2-6-5-2-1	0.0-3.0-7.0-4.0-8.0-5.0-6.0-2.0-4.1-7.1-2.1-5.0-6.0-2.0-7.0-4.0-2.1-6.1-5.1-2.0-1.0	155	305545	308841
HG01071#1#JAHBCF010000053.1_26607100_27108065_1	HG01071	310059	321608	4	96	0	4	58	11549	311116	299567	0-3-7-4-8-5-6-2-4-7-2-5-6-2-7-4-2-6-5-2-1	0.0-3.0-7.0-4.0-8.0-5.0-6.0-2.0-4.1-7.1-2.1-5.0-6.0-2.0-7.0-4.0-2.1-6.1-5.1-2.0-1.0	155	309904	321453
HG01071#1#JAHBCF010000053.1_26607100_27108065_1	HG01071	323474	354692	2	172	1	171	0	31218	342334	311116	0-3-7-4-8-5-6-2-4-7-2-5-6-2-7-4-2-6-5-2-1	0.0-3.0-7.0-4.0-8.0-5.0-6.0-2.0-4.1-7.1-2.1-5.0-6.0-2.0-7.0-4.0-2.1-6.1-5.1-2.0-1.0	155	323319	354537
HG01071#1#JAHBCF010000053.1_26607100_27108065_1	HG01071	355053	357580	6	24	1	21	1	2527	344861	342334	0-3-7-4-8-5-6-2-4-7-2-5-6-2-7-4-2-6-5-2-1	0.0-3.0-7.0-4.0-8.0-5.0-6.0-2.0-4.1-7.1-2.1-5.0-6.0-2.0-7.0-4.0-2.1-6.1-5.1-2.0-1.0	155	354898	357425
HG01071#1#JAHBCF010000053.1_26607100_27108065_1	HG01071	358187	370402	5	78	1	76	3	12215	357076	344861	0-3-7-4-8-5-6-2-4-7-2-5-6-2-7-4-2-6-5-2-1	0.0-3.0-7.0-4.0-8.0-5.0-6.0-2.0-4.1-7.1-2.1-5.0-6.0-2.0-7.0-4.0-2.1-6.1-5.1-2.0-1.0	155	358032	370247
HG01071#1#JAHBCF010000053.1_26607100_27108065_1	HG01071	370840	398757	2	172	0	15	171	27917	384993	357076	0-3-7-4-8-5-6-2-4-7-2-5-6-2-7-4-2-6-5-2-1	0.0-3.0-7.0-4.0-8.0-5.0-6.0-2.0-4.1-7.1-2.1-5.0-6.0-2.0-7.0-4.0-2.1-6.1-5.1-2.0-1.0	155	370685	398602
HG01071#1#JAHBCF010000053.1_26607100_27108065_1	HG01071	398701	500903	1	612	0	0	605	102202	487195	384993	0-3-7-4-8-5-6-2-4-7-2-5-6-2-7-4-2-6-5-2-1	0.0-3.0-7.0-4.0-8.0-5.0-6.0-2.0-4.1-7.1-2.1-5.0-6.0-2.0-7.0-4.0-2.1-6.1-5.1-2.0-1.0	155	398546	500748
HG01099.verkko_filt_mat.fa:haplotype1-0000034_142513097_142920876_1	HG01099	154	115523	0	671	0	0	670	115369	115369	0	0-3-7-4-8-5-6-2-4-7-2-6-5-2-1	0.0-3.0-7.0-4.0-8.0-5.0-6.0-2.0-4.1-7.1-2.1-6.1-5.1-2.0-1.0	154	0	115369
HG01099.verkko_filt_mat.fa:haplotype1-0000034_142513097_142920876_1	HG01099	115614	138445	3	132	0	0	131	22831	138200	115369	0-3-7-4-8-5-6-2-4-7-2-6-5-2-1	0.0-3.0-7.0-4.0-8.0-5.0-6.0-2.0-4.1-7.1-2.1-6.1-5.1-2.0-1.0	154	115460	138291
HG01099.verkko_filt_mat.fa:haplotype1-0000034_142513097_142920876_1	HG01099	139204	142499	7	17	0	0	16	3295	141495	138200	0-3-7-4-8-5-6-2-4-7-2-6-5-2-1	0.0-3.0-7.0-4.0-8.0-5.0-6.0-2.0-4.1-7.1-2.1-6.1-5.1-2.0-1.0	154	139050	142345
HG01099.verkko_filt_mat.fa:haplotype1-0000034_142513097_142920876_1	HG01099	143290	161501	4	96	0	1	95	18211	159706	141495	0-3-7-4-8-5-6-2-4-7-2-6-5-2-1	0.0-3.0-7.0-4.0-8.0-5.0-6.0-2.0-4.1-7.1-2.1-6.1-5.1-2.0-1.0	154	143136	161347
HG01099.verkko_filt_mat.fa:haplotype1-0000034_142513097_142920876_1	HG01099	161445	163215	8	8	0	0	7	1770	161476	159706	0-3-7-4-8-5-6-2-4-7-2-6-5-2-1	0.0-3.0-7.0-4.0-8.0-5.0-6.0-2.0-4.1-7.1-2.1-6.1-5.1-2.0-1.0	154	161291	163061
HG01099.verkko_filt_mat.fa:haplotype1-0000034_142513097_142920876_1	HG01099	163159	176263	5	78	0	0	77	13104	174580	161476	0-3-7-4-8-5-6-2-4-7-2-6-5-2-1	0.0-3.0-7.0-4.0-8.0-5.0-6.0-2.0-4.1-7.1-2.1-6.1-5.1-2.0-1.0	154	163005	176109
HG01099.verkko_filt_mat.fa:haplotype1-0000034_142513097_142920876_1	HG01099	176207	178951	6	24	0	0	21	2744	177324	174580	0-3-7-4-8-5-6-2-4-7-2-6-5-2-1	0.0-3.0-7.0-4.0-8.0-5.0-6.0-2.0-4.1-7.1-2.1-6.1-5.1-2.0-1.0	154	176053	178797
HG01099.verkko_filt_mat.fa:haplotype1-0000034_142513097_142920876_1	HG01099	179310	210529	2	172	0	0	171	31219	208543	177324	0-3-7-4-8-5-6-2-4-7-2-6-5-2-1	0.0-3.0-7.0-4.0-8.0-5.0-6.0-2.0-4.1-7.1-2.1-6.1-5.1-2.0-1.0	154	179156	210375
HG01099.verkko_filt_mat.fa:haplotype1-0000034_142513097_142920876_1	HG01099	212395	224206	4	96	1	58	1	11811	220354	208543	0-3-7-4-8-5-6-2-4-7-2-6-5-2-1	0.0-3.0-7.0-4.0-8.0-5.0-6.0-2.0-4.1-7.1-2.1-6.1-5.1-2.0-1.0	154	212241	224052
HG01099.verkko_filt_mat.fa:haplotype1-0000034_142513097_142920876_1	HG01099	224997	228292	7	17	1	16	0	3295	223649	220354	0-3-7-4-8-5-6-2-4-7-2-6-5-2-1	0.0-3.0-7.0-4.0-8.0-5.0-6.0-2.0-4.1-7.1-2.1-6.1-5.1-2.0-1.0	154	224843	228138
HG01099.verkko_filt_mat.fa:haplotype1-0000034_142513097_142920876_1	HG01099	229369	260588	2	172	1	171	0	31219	254868	223649	0-3-7-4-8-5-6-2-4-7-2-6-5-2-1	0.0-3.0-7.0-4.0-8.0-5.0-6.0-2.0-4.1-7.1-2.1-6.1-5.1-2.0-1.0	154	229215	260434
HG01099.verkko_filt_mat.fa:haplotype1-0000034_142513097_142920876_1	HG01099	260947	263474	6	24	1	21	1	2527	257395	254868	0-3-7-4-8-5-6-2-4-7-2-6-5-2-1	0.0-3.0-7.0-4.0-8.0-5.0-6.0-2.0-4.1-7.1-2.1-6.1-5.1-2.0-1.0	154	260793	263320
HG01099.verkko_filt_mat.fa:haplotype1-0000034_142513097_142920876_1	HG01099	264081	276296	5	78	1	76	3	12215	269610	257395	0-3-7-4-8-5-6-2-4-7-2-6-5-2-1	0.0-3.0-7.0-4.0-8.0-5.0-6.0-2.0-4.1-7.1-2.1-6.1-5.1-2.0-1.0	154	263927	276142
HG01099.verkko_filt_mat.fa:haplotype1-0000034_142513097_142920876_1	HG01099	276735	304635	2	172	0	15	171	27900	297510	269610	0-3-7-4-8-5-6-2-4-7-2-6-5-2-1	0.0-3.0-7.0-4.0-8.0-5.0-6.0-2.0-4.1-7.1-2.1-6.1-5.1-2.0-1.0	154	276581	304481
HG01099.verkko_filt_mat.fa:haplotype1-0000034_142513097_142920876_1	HG01099	304579	407763	1	612	0	0	611	103184	400694	297510	0-3-7-4-8-5-6-2-4-7-2-6-5-2-1	0.0-3.0-7.0-4.0-8.0-5.0-6.0-2.0-4.1-7.1-2.1-6.1-5.1-2.0-1.0	154	304425	407609
HG01099.verkko_filt_pat.fa:haplotype2-0000583_143544270_144046196_1	HG01099	154	115543	0	671	0	0	670	115389	115389	0	0-3-7-4-8-5-6-2-4-7-2-5-6-2-4-7-2-6-5-2-1	0.0-3.0-7.0-4.0-8.0-5.0-6.0-2.0-4.1-7.1-2.1-5.0-6.0-2.0-4.1-7.1-2.1-6.1-5.1-2.0-1.0	154	0	115389
HG01099.verkko_filt_pat.fa:haplotype2-0000583_143544270_144046196_1	HG01099	115634	138467	3	132	0	0	131	22833	138222	115389	0-3-7-4-8-5-6-2-4-7-2-5-6-2-4-7-2-6-5-2-1	0.0-3.0-7.0-4.0-8.0-5.0-6.0-2.0-4.1-7.1-2.1-5.0-6.0-2.0-4.1-7.1-2.1-6.1-5.1-2.0-1.0	154	115480	138313
HG01099.verkko_filt_pat.fa:haplotype2-0000583_143544270_144046196_1	HG01099	139226	142521	7	17	0	0	16	3295	141517	138222	0-3-7-4-8-5-6-2-4-7-2-5-6-2-4-7-2-6-5-2-1	0.0-3.0-7.0-4.0-8.0-5.0-6.0-2.0-4.1-7.1-2.1-5.0-6.0-2.0-4.1-7.1-2.1-6.1-5.1-2.0-1.0	154	139072	142367
HG01099.verkko_filt_pat.fa:haplotype2-0000583_143544270_144046196_1	HG01099	142969	161533	4	96	0	0	95	18564	160081	141517	0-3-7-4-8-5-6-2-4-7-2-5-6-2-4-7-2-6-5-2-1	0.0-3.0-7.0-4.0-8.0-5.0-6.0-2.0-4.1-7.1-2.1-5.0-6.0-2.0-4.1-7.1-2.1-6.1-5.1-2.0-1.0	154	142815	161379
HG01099.verkko_filt_pat.fa:haplotype2-0000583_143544270_144046196_1	HG01099	161477	163247	8	8	0	0	7	1770	161851	160081	0-3-7-4-8-5-6-2-4-7-2-5-6-2-4-7-2-6-5-2-1	0.0-3.0-7.0-4.0-8.0-5.0-6.0-2.0-4.1-7.1-2.1-5.0-6.0-2.0-4.1-7.1-2.1-6.1-5.1-2.0-1.0	154	161323	163093
HG01099.verkko_filt_pat.fa:haplotype2-0000583_143544270_144046196_1	HG01099	163191	175381	5	78	0	0	74	12190	174041	161851	0-3-7-4-8-5-6-2-4-7-2-5-6-2-4-7-2-6-5-2-1	0.0-3.0-7.0-4.0-8.0-5.0-6.0-2.0-4.1-7.1-2.1-5.0-6.0-2.0-4.1-7.1-2.1-6.1-5.1-2.0-1.0	154	163037	175227
HG01099.verkko_filt_pat.fa:haplotype2-0000583_143544270_144046196_1	HG01099	176462	179405	6	24	0	1	23	2943	176984	174041	0-3-7-4-8-5-6-2-4-7-2-5-6-2-4-7-2-6-5-2-1	0.0-3.0-7.0-4.0-8.0-5.0-6.0-2.0-4.1-7.1-2.1-5.0-6.0-2.0-4.1-7.1-2.1-6.1-5.1-2.0-1.0	154	176308	179251
HG01099.verkko_filt_pat.fa:haplotype2-0000583_143544270_144046196_1	HG01099	179349	210565	2	172	0	0	171	31216	208200	176984	0-3-7-4-8-5-6-2-4-7-2-5-6-2-4-7-2-6-5-2-1	0.0-3.0-7.0-4.0-8.0-5.0-6.0-2.0-4.1-7.1-2.1-5.0-6.0-2.0-4.1-7.1-2.1-6.1-5.1-2.0-1.0	154	179195	210411
HG01099.verkko_filt_pat.fa:haplotype2-0000583_143544270_144046196_1	HG01099	212431	223976	4	96	1	58	4	11545	219745	208200	0-3-7-4-8-5-6-2-4-7-2-5-6-2-4-7-2-6-5-2-1	0.0-3.0-7.0-4.0-8.0-5.0-6.0-2.0-4.1-7.1-2.1-5.0-6.0-2.0-4.1-7.1-2.1-6.1-5.1-2.0-1.0	154	212277	223822
HG01099.verkko_filt_pat.fa:haplotype2-0000583_143544270_144046196_1	HG01099	225041	228336	7	17	1	16	0	3295	223040	219745	0-3-7-4-8-5-6-2-4-7-2-5-6-2-4-7-2-6-5-2-1	0.0-3.0-7.0-4.0-8.0-5.0-6.0-2.0-4.1-7.1-2.1-5.0-6.0-2.0-4.1-7.1-2.1-6.1-5.1-2.0-1.0	154	224887	228182
HG01099.verkko_filt_pat.fa:haplotype2-0000583_143544270_144046196_1	HG01099	229413	257334	2	172	1	171	15	27921	250961	223040	0-3-7-4-8-5-6-2-4-7-2-5-6-2-4-7-2-6-5-2-1	0.0-3.0-7.0-4.0-8.0-5.0-6.0-2.0-4.1-7.1-2.1-5.0-6.0-2.0-4.1-7.1-2.1-6.1-5.1-2.0-1.0	154	229259	257180
HG01099.verkko_filt_pat.fa:haplotype2-0000583_143544270_144046196_1	HG01099	257773	269515	5	78	0	3	74	11742	262703	250961	0-3-7-4-8-5-6-2-4-7-2-5-6-2-4-7-2-6-5-2-1	0.0-3.0-7.0-4.0-8.0-5.0-6.0-2.0-4.1-7.1-2.1-5.0-6.0-2.0-4.1-7.1-2.1-6.1-5.1-2.0-1.0	154	257619	269361
HG01099.verkko_filt_pat.fa:haplotype2-0000583_143544270_144046196_1	HG01099	270596	273539	6	24	0	1	23	2943	265646	262703	0-3-7-4-8-5-6-2-4-7-2-5-6-2-4-7-2-6-5-2-1	0.0-3.0-7.0-4.0-8.0-5.0-6.0-2.0-4.1-7.1-2.1-5.0-6.0-2.0-4.1-7.1-2.1-6.1-5.1-2.0-1.0	154	270442	273385
HG01099.verkko_filt_pat.fa:haplotype2-0000583_143544270_144046196_1	HG01099	273483	304696	2	172	0	0	171	31213	296859	265646	0-3-7-4-8-5-6-2-4-7-2-5-6-2-4-7-2-6-5-2-1	0.0-3.0-7.0-4.0-8.0-5.0-6.0-2.0-4.1-7.1-2.1-5.0-6.0-2.0-4.1-7.1-2.1-6.1-5.1-2.0-1.0	154	273329	304542
HG01099.verkko_filt_pat.fa:haplotype2-0000583_143544270_144046196_1	HG01099	306562	317683	4	96	1	58	6	11121	307980	296859	0-3-7-4-8-5-6-2-4-7-2-5-6-2-4-7-2-6-5-2-1	0.0-3.0-7.0-4.0-8.0-5.0-6.0-2.0-4.1-7.1-2.1-5.0-6.0-2.0-4.1-7.1-2.1-6.1-5.1-2.0-1.0	154	306408	317529
HG01099.verkko_filt_pat.fa:haplotype2-0000583_143544270_144046196_1	HG01099	319174	322469	7	17	1	16	0	3295	311275	307980	0-3-7-4-8-5-6-2-4-7-2-5-6-2-4-7-2-6-5-2-1	0.0-3.0-7.0-4.0-8.0-5.0-6.0-2.0-4.1-7.1-2.1-5.0-6.0-2.0-4.1-7.1-2.1-6.1-5.1-2.0-1.0	154	319020	322315
HG01099.verkko_filt_pat.fa:haplotype2-0000583_143544270_144046196_1	HG01099	323931	354772	2	172	1	170	0	30841	342116	311275	0-3-7-4-8-5-6-2-4-7-2-5-6-2-4-7-2-6-5-2-1	0.0-3.0-7.0-4.0-8.0-5.0-6.0-2.0-4.1-7.1-2.1-5.0-6.0-2.0-4.1-7.1-2.1-6.1-5.1-2.0-1.0	154	323777	354618
HG01099.verkko_filt_pat.fa:haplotype2-0000583_143544270_144046196_1	HG01099	354716	357659	6	24	1	23	1	2943	345059	342116	0-3-7-4-8-5-6-2-4-7-2-5-6-2-4-7-2-6-5-2-1	0.0-3.0-7.0-4.0-8.0-5.0-6.0-2.0-4.1-7.1-2.1-5.0-6.0-2.0-4.1-7.1-2.1-6.1-5.1-2.0-1.0	154	354562	357505
HG01099.verkko_filt_pat.fa:haplotype2-0000583_143544270_144046196_1	HG01099	358740	370480	5	78	1	74	3	11740	356799	345059	0-3-7-4-8-5-6-2-4-7-2-5-6-2-4-7-2-6-5-2-1	0.0-3.0-7.0-4.0-8.0-5.0-6.0-2.0-4.1-7.1-2.1-5.0-6.0-2.0-4.1-7.1-2.1-6.1-5.1-2.0-1.0	154	358586	370326
HG01099.verkko_filt_pat.fa:haplotype2-0000583_143544270_144046196_1	HG01099	370919	398831	2	172	0	15	171	27912	384711	356799	0-3-7-4-8-5-6-2-4-7-2-5-6-2-4-7-2-6-5-2-1	0.0-3.0-7.0-4.0-8.0-5.0-6.0-2.0-4.1-7.1-2.1-5.0-6.0-2.0-4.1-7.1-2.1-6.1-5.1-2.0-1.0	154	370765	398677
HG01099.verkko_filt_pat.fa:haplotype2-0000583_143544270_144046196_1	HG01099	398775	501910	1	612	0	0	611	103135	487846	384711	0-3-7-4-8-5-6-2-4-7-2-5-6-2-4-7-2-6-5-2-1	0.0-3.0-7.0-4.0-8.0-5.0-6.0-2.0-4.1-7.1-2.1-5.0-6.0-2.0-4.1-7.1-2.1-6.1-5.1-2.0-1.0	154	398621	501756
HG01109#1#JAHEPA010000099.1_2104245_2511104_1	HG01109	155	115513	0	671	0	0	670	115358	115358	0	0-3-7-4-8-5-6-2-7-4-2-6-5-2-1	0.0-3.0-7.0-4.0-8.0-5.0-6.0-2.0-7.0-4.0-2.1-6.1-5.1-2.0-1.0	155	0	115358
HG01109#1#JAHEPA010000099.1_2104245_2511104_1	HG01109	115604	138440	3	132	0	0	131	22836	138194	115358	0-3-7-4-8-5-6-2-7-4-2-6-5-2-1	0.0-3.0-7.0-4.0-8.0-5.0-6.0-2.0-7.0-4.0-2.1-6.1-5.1-2.0-1.0	155	115449	138285
HG01109#1#JAHEPA010000099.1_2104245_2511104_1	HG01109	139199	142495	7	17	0	0	16	3296	141490	138194	0-3-7-4-8-5-6-2-7-4-2-6-5-2-1	0.0-3.0-7.0-4.0-8.0-5.0-6.0-2.0-7.0-4.0-2.1-6.1-5.1-2.0-1.0	155	139044	142340
HG01109#1#JAHEPA010000099.1_2104245_2511104_1	HG01109	142943	161499	4	96	0	0	95	18556	160046	141490	0-3-7-4-8-5-6-2-7-4-2-6-5-2-1	0.0-3.0-7.0-4.0-8.0-5.0-6.0-2.0-7.0-4.0-2.1-6.1-5.1-2.0-1.0	155	142788	161344
HG01109#1#JAHEPA010000099.1_2104245_2511104_1	HG01109	161443	163213	8	8	0	0	7	1770	161816	160046	0-3-7-4-8-5-6-2-7-4-2-6-5-2-1	0.0-3.0-7.0-4.0-8.0-5.0-6.0-2.0-7.0-4.0-2.1-6.1-5.1-2.0-1.0	155	161288	163058
HG01109#1#JAHEPA010000099.1_2104245_2511104_1	HG01109	163157	176261	5	78	0	0	77	13104	174920	161816	0-3-7-4-8-5-6-2-7-4-2-6-5-2-1	0.0-3.0-7.0-4.0-8.0-5.0-6.0-2.0-7.0-4.0-2.1-6.1-5.1-2.0-1.0	155	163002	176106
HG01109#1#JAHEPA010000099.1_2104245_2511104_1	HG01109	176205	178949	6	24	0	0	21	2744	177664	174920	0-3-7-4-8-5-6-2-7-4-2-6-5-2-1	0.0-3.0-7.0-4.0-8.0-5.0-6.0-2.0-7.0-4.0-2.1-6.1-5.1-2.0-1.0	155	176050	178794
HG01109#1#JAHEPA010000099.1_2104245_2511104_1	HG01109	179307	210525	2	172	0	0	171	31218	208882	177664	0-3-7-4-8-5-6-2-7-4-2-6-5-2-1	0.0-3.0-7.0-4.0-8.0-5.0-6.0-2.0-7.0-4.0-2.1-6.1-5.1-2.0-1.0	155	179152	210370
HG01109#1#JAHEPA010000099.1_2104245_2511104_1	HG01109	211602	214898	7	17	0	0	16	3296	212178	208882	0-3-7-4-8-5-6-2-7-4-2-6-5-2-1	0.0-3.0-7.0-4.0-8.0-5.0-6.0-2.0-7.0-4.0-2.1-6.1-5.1-2.0-1.0	155	211447	214743
HG01109#1#JAHEPA010000099.1_2104245_2511104_1	HG01109	215961	227507	4	96	0	4	58	11546	223724	212178	0-3-7-4-8-5-6-2-7-4-2-6-5-2-1	0.0-3.0-7.0-4.0-8.0-5.0-6.0-2.0-7.0-4.0-2.1-6.1-5.1-2.0-1.0	155	215806	227352
HG01109#1#JAHEPA010000099.1_2104245_2511104_1	HG01109	229373	260591	2	172	1	171	0	31218	254942	223724	0-3-7-4-8-5-6-2-7-4-2-6-5-2-1	0.0-3.0-7.0-4.0-8.0-5.0-6.0-2.0-7.0-4.0-2.1-6.1-5.1-2.0-1.0	155	229218	260436
HG01109#1#JAHEPA010000099.1_2104245_2511104_1	HG01109	260535	263478	6	24	1	23	1	2943	257885	254942	0-3-7-4-8-5-6-2-7-4-2-6-5-2-1	0.0-3.0-7.0-4.0-8.0-5.0-6.0-2.0-7.0-4.0-2.1-6.1-5.1-2.0-1.0	155	260380	263323
HG01109#1#JAHEPA010000099.1_2104245_2511104_1	HG01109	264085	276300	5	78	1	76	3	12215	270100	257885	0-3-7-4-8-5-6-2-7-4-2-6-5-2-1	0.0-3.0-7.0-4.0-8.0-5.0-6.0-2.0-7.0-4.0-2.1-6.1-5.1-2.0-1.0	155	263930	276145
HG01109#1#JAHEPA010000099.1_2104245_2511104_1	HG01109	276739	304663	2	172	0	15	171	27924	298024	270100	0-3-7-4-8-5-6-2-7-4-2-6-5-2-1	0.0-3.0-7.0-4.0-8.0-5.0-6.0-2.0-7.0-4.0-2.1-6.1-5.1-2.0-1.0	155	276584	304508
HG01109#1#JAHEPA010000099.1_2104245_2511104_1	HG01109	304607	406797	1	612	0	0	605	102190	400214	298024	0-3-7-4-8-5-6-2-7-4-2-6-5-2-1	0.0-3.0-7.0-4.0-8.0-5.0-6.0-2.0-7.0-4.0-2.1-6.1-5.1-2.0-1.0	155	304452	406642
HG01109#2#JAHEOZ010000047.1_16671232_17151375_0	HG01109	98	115416	0	671	0	0	670	115318	115318	0	0-3-7-4-8-5-6-2-7-4-8-5-6-2-7-4-2-5-6-2-1	0.0-3.0-7.0-4.0-8.0-5.0-6.0-2.0-7.0-4.0-8.0-5.0-6.0-2.0-7.0-4.0-2.1-5.0-6.0-2.0-1.0	98	0	115318
HG01109#2#JAHEOZ010000047.1_16671232_17151375_0	HG01109	115507	138338	3	132	0	0	131	22831	138149	115318	0-3-7-4-8-5-6-2-7-4-8-5-6-2-7-4-2-5-6-2-1	0.0-3.0-7.0-4.0-8.0-5.0-6.0-2.0-7.0-4.0-8.0-5.0-6.0-2.0-7.0-4.0-2.1-5.0-6.0-2.0-1.0	98	115409	138240
HG01109#2#JAHEOZ010000047.1_16671232_17151375_0	HG01109	139097	142392	7	17	0	0	16	3295	141444	138149	0-3-7-4-8-5-6-2-7-4-8-5-6-2-7-4-2-5-6-2-1	0.0-3.0-7.0-4.0-8.0-5.0-6.0-2.0-7.0-4.0-8.0-5.0-6.0-2.0-7.0-4.0-2.1-5.0-6.0-2.0-1.0	98	138999	142294
HG01109#2#JAHEOZ010000047.1_16671232_17151375_0	HG01109	142840	161400	4	96	0	0	95	18560	160004	141444	0-3-7-4-8-5-6-2-7-4-8-5-6-2-7-4-2-5-6-2-1	0.0-3.0-7.0-4.0-8.0-5.0-6.0-2.0-7.0-4.0-8.0-5.0-6.0-2.0-7.0-4.0-2.1-5.0-6.0-2.0-1.0	98	142742	161302
HG01109#2#JAHEOZ010000047.1_16671232_17151375_0	HG01109	161344	163114	8	8	0	0	7	1770	161774	160004	0-3-7-4-8-5-6-2-7-4-8-5-6-2-7-4-2-5-6-2-1	0.0-3.0-7.0-4.0-8.0-5.0-6.0-2.0-7.0-4.0-8.0-5.0-6.0-2.0-7.0-4.0-2.1-5.0-6.0-2.0-1.0	98	161246	163016
HG01109#2#JAHEOZ010000047.1_16671232_17151375_0	HG01109	163058	175715	5	78	0	0	76	12657	174431	161774	0-3-7-4-8-5-6-2-7-4-8-5-6-2-7-4-2-5-6-2-1	0.0-3.0-7.0-4.0-8.0-5.0-6.0-2.0-7.0-4.0-8.0-5.0-6.0-2.0-7.0-4.0-2.1-5.0-6.0-2.0-1.0	98	162960	175617
HG01109#2#JAHEOZ010000047.1_16671232_17151375_0	HG01109	176322	178849	6	24	0	1	21	2527	176958	174431	0-3-7-4-8-5-6-2-7-4-8-5-6-2-7-4-2-5-6-2-1	0.0-3.0-7.0-4.0-8.0-5.0-6.0-2.0-7.0-4.0-8.0-5.0-6.0-2.0-7.0-4.0-2.1-5.0-6.0-2.0-1.0	98	176224	178751
HG01109#2#JAHEOZ010000047.1_16671232_17151375_0	HG01109	179208	210418	2	172	0	0	171	31210	208168	176958	0-3-7-4-8-5-6-2-7-4-8-5-6-2-7-4-2-5-6-2-1	0.0-3.0-7.0-4.0-8.0-5.0-6.0-2.0-7.0-4.0-8.0-5.0-6.0-2.0-7.0-4.0-2.1-5.0-6.0-2.0-1.0	98	179110	210320
HG01109#2#JAHEOZ010000047.1_16671232_17151375_0	HG01109	211495	214790	7	17	0	0	16	3295	211463	208168	0-3-7-4-8-5-6-2-7-4-8-5-6-2-7-4-2-5-6-2-1	0.0-3.0-7.0-4.0-8.0-5.0-6.0-2.0-7.0-4.0-8.0-5.0-6.0-2.0-7.0-4.0-2.1-5.0-6.0-2.0-1.0	98	211397	214692
HG01109#2#JAHEOZ010000047.1_16671232_17151375_0	HG01109	215238	233799	4	96	0	0	95	18561	230024	211463	0-3-7-4-8-5-6-2-7-4-8-5-6-2-7-4-2-5-6-2-1	0.0-3.0-7.0-4.0-8.0-5.0-6.0-2.0-7.0-4.0-8.0-5.0-6.0-2.0-7.0-4.0-2.1-5.0-6.0-2.0-1.0	98	215140	233701
HG01109#2#JAHEOZ010000047.1_16671232_17151375_0	HG01109	233743	235269	8	8	0	0	6	1526	231550	230024	0-3-7-4-8-5-6-2-7-4-8-5-6-2-7-4-2-5-6-2-1	0.0-3.0-7.0-4.0-8.0-5.0-6.0-2.0-7.0-4.0-8.0-5.0-6.0-2.0-7.0-4.0-2.1-5.0-6.0-2.0-1.0	98	233645	235171
HG01109#2#JAHEOZ010000047.1_16671232_17151375_0	HG01109	235457	248114	5	78	0	0	76	12657	244207	231550	0-3-7-4-8-5-6-2-7-4-8-5-6-2-7-4-2-5-6-2-1	0.0-3.0-7.0-4.0-8.0-5.0-6.0-2.0-7.0-4.0-8.0-5.0-6.0-2.0-7.0-4.0-2.1-5.0-6.0-2.0-1.0	98	235359	248016
HG01109#2#JAHEOZ010000047.1_16671232_17151375_0	HG01109	248498	251658	6	24	0	0	23	3160	247367	244207	0-3-7-4-8-5-6-2-7-4-8-5-6-2-7-4-2-5-6-2-1	0.0-3.0-7.0-4.0-8.0-5.0-6.0-2.0-7.0-4.0-8.0-5.0-6.0-2.0-7.0-4.0-2.1-5.0-6.0-2.0-1.0	98	248400	251560
HG01109#2#JAHEOZ010000047.1_16671232_17151375_0	HG01109	251602	282820	2	172	0	0	171	31218	278585	247367	0-3-7-4-8-5-6-2-7-4-8-5-6-2-7-4-2-5-6-2-1	0.0-3.0-7.0-4.0-8.0-5.0-6.0-2.0-7.0-4.0-8.0-5.0-6.0-2.0-7.0-4.0-2.1-5.0-6.0-2.0-1.0	98	251504	282722
HG01109#2#JAHEOZ010000047.1_16671232_17151375_0	HG01109	283897	287192	7	17	0	0	16	3295	281880	278585	0-3-7-4-8-5-6-2-7-4-8-5-6-2-7-4-2-5-6-2-1	0.0-3.0-7.0-4.0-8.0-5.0-6.0-2.0-7.0-4.0-8.0-5.0-6.0-2.0-7.0-4.0-2.1-5.0-6.0-2.0-1.0	98	283799	287094
HG01109#2#JAHEOZ010000047.1_16671232_17151375_0	HG01109	288259	299806	4	96	0	4	58	11547	293427	281880	0-3-7-4-8-5-6-2-7-4-8-5-6-2-7-4-2-5-6-2-1	0.0-3.0-7.0-4.0-8.0-5.0-6.0-2.0-7.0-4.0-8.0-5.0-6.0-2.0-7.0-4.0-2.1-5.0-6.0-2.0-1.0	98	288161	299708
HG01109#2#JAHEOZ010000047.1_16671232_17151375_0	HG01109	301672	329587	2	172	1	171	15	27915	321342	293427	0-3-7-4-8-5-6-2-7-4-8-5-6-2-7-4-2-5-6-2-1	0.0-3.0-7.0-4.0-8.0-5.0-6.0-2.0-7.0-4.0-8.0-5.0-6.0-2.0-7.0-4.0-2.1-5.0-6.0-2.0-1.0	98	301574	329489
HG01109#2#JAHEOZ010000047.1_16671232_17151375_0	HG01109	330026	342234	5	78	0	3	76	12208	333550	321342	0-3-7-4-8-5-6-2-7-4-8-5-6-2-7-4-2-5-6-2-1	0.0-3.0-7.0-4.0-8.0-5.0-6.0-2.0-7.0-4.0-8.0-5.0-6.0-2.0-7.0-4.0-2.1-5.0-6.0-2.0-1.0	98	329928	342136
HG01109#2#JAHEOZ010000047.1_16671232_17151375_0	HG01109	342618	345778	6	24	0	0	23	3160	336710	333550	0-3-7-4-8-5-6-2-7-4-8-5-6-2-7-4-2-5-6-2-1	0.0-3.0-7.0-4.0-8.0-5.0-6.0-2.0-7.0-4.0-8.0-5.0-6.0-2.0-7.0-4.0-2.1-5.0-6.0-2.0-1.0	98	342520	345680
HG01109#2#JAHEOZ010000047.1_16671232_17151375_0	HG01109	345722	376940	2	172	0	0	171	31218	367928	336710	0-3-7-4-8-5-6-2-7-4-8-5-6-2-7-4-2-5-6-2-1	0.0-3.0-7.0-4.0-8.0-5.0-6.0-2.0-7.0-4.0-8.0-5.0-6.0-2.0-7.0-4.0-2.1-5.0-6.0-2.0-1.0	98	345624	376842
HG01109#2#JAHEOZ010000047.1_16671232_17151375_0	HG01109	376884	480071	1	612	0	0	611	103187	471115	367928	0-3-7-4-8-5-6-2-7-4-8-5-6-2-7-4-2-5-6-2-1	0.0-3.0-7.0-4.0-8.0-5.0-6.0-2.0-7.0-4.0-8.0-5.0-6.0-2.0-7.0-4.0-2.1-5.0-6.0-2.0-1.0	98	376786	479973
HG01123#1#JAGYYZ010000015.1_51528240_51935090_0	HG01123	98	115453	0	671	0	0	670	115355	115355	0	0-3-7-4-8-5-6-2-7-4-2-6-5-2-1	0.0-3.0-7.0-4.0-8.0-5.0-6.0-2.0-7.0-4.0-2.1-6.1-5.1-2.0-1.0	98	0	115355
HG01123#1#JAGYYZ010000015.1_51528240_51935090_0	HG01123	115544	138378	3	132	0	0	131	22834	138189	115355	0-3-7-4-8-5-6-2-7-4-2-6-5-2-1	0.0-3.0-7.0-4.0-8.0-5.0-6.0-2.0-7.0-4.0-2.1-6.1-5.1-2.0-1.0	98	115446	138280
HG01123#1#JAGYYZ010000015.1_51528240_51935090_0	HG01123	139137	142433	7	17	0	0	16	3296	141485	138189	0-3-7-4-8-5-6-2-7-4-2-6-5-2-1	0.0-3.0-7.0-4.0-8.0-5.0-6.0-2.0-7.0-4.0-2.1-6.1-5.1-2.0-1.0	98	139039	142335
HG01123#1#JAGYYZ010000015.1_51528240_51935090_0	HG01123	143496	161433	4	96	0	4	95	17937	159422	141485	0-3-7-4-8-5-6-2-7-4-2-6-5-2-1	0.0-3.0-7.0-4.0-8.0-5.0-6.0-2.0-7.0-4.0-2.1-6.1-5.1-2.0-1.0	98	143398	161335
HG01123#1#JAGYYZ010000015.1_51528240_51935090_0	HG01123	161377	163147	8	8	0	0	7	1770	161192	159422	0-3-7-4-8-5-6-2-7-4-2-6-5-2-1	0.0-3.0-7.0-4.0-8.0-5.0-6.0-2.0-7.0-4.0-2.1-6.1-5.1-2.0-1.0	98	161279	163049
HG01123#1#JAGYYZ010000015.1_51528240_51935090_0	HG01123	163091	175755	5	78	0	0	76	12664	173856	161192	0-3-7-4-8-5-6-2-7-4-2-6-5-2-1	0.0-3.0-7.0-4.0-8.0-5.0-6.0-2.0-7.0-4.0-2.1-6.1-5.1-2.0-1.0	98	162993	175657
HG01123#1#JAGYYZ010000015.1_51528240_51935090_0	HG01123	176362	179305	6	24	0	1	23	2943	176799	173856	0-3-7-4-8-5-6-2-7-4-2-6-5-2-1	0.0-3.0-7.0-4.0-8.0-5.0-6.0-2.0-7.0-4.0-2.1-6.1-5.1-2.0-1.0	98	176264	179207
HG01123#1#JAGYYZ010000015.1_51528240_51935090_0	HG01123	179249	210469	2	172	0	0	171	31220	208019	176799	0-3-7-4-8-5-6-2-7-4-2-6-5-2-1	0.0-3.0-7.0-4.0-8.0-5.0-6.0-2.0-7.0-4.0-2.1-6.1-5.1-2.0-1.0	98	179151	210371
HG01123#1#JAGYYZ010000015.1_51528240_51935090_0	HG01123	211546	214842	7	17	0	0	16	3296	211315	208019	0-3-7-4-8-5-6-2-7-4-2-6-5-2-1	0.0-3.0-7.0-4.0-8.0-5.0-6.0-2.0-7.0-4.0-2.1-6.1-5.1-2.0-1.0	98	211448	214744
HG01123#1#JAGYYZ010000015.1_51528240_51935090_0	HG01123	215905	227451	4	96	0	4	58	11546	222861	211315	0-3-7-4-8-5-6-2-7-4-2-6-5-2-1	0.0-3.0-7.0-4.0-8.0-5.0-6.0-2.0-7.0-4.0-2.1-6.1-5.1-2.0-1.0	98	215807	227353
HG01123#1#JAGYYZ010000015.1_51528240_51935090_0	HG01123	229317	260545	2	172	1	171	0	31228	254089	222861	0-3-7-4-8-5-6-2-7-4-2-6-5-2-1	0.0-3.0-7.0-4.0-8.0-5.0-6.0-2.0-7.0-4.0-2.1-6.1-5.1-2.0-1.0	98	229219	260447
HG01123#1#JAGYYZ010000015.1_51528240_51935090_0	HG01123	260489	263432	6	24	1	23	1	2943	257032	254089	0-3-7-4-8-5-6-2-7-4-2-6-5-2-1	0.0-3.0-7.0-4.0-8.0-5.0-6.0-2.0-7.0-4.0-2.1-6.1-5.1-2.0-1.0	98	260391	263334
HG01123#1#JAGYYZ010000015.1_51528240_51935090_0	HG01123	264039	276254	5	78	1	76	3	12215	269247	257032	0-3-7-4-8-5-6-2-7-4-2-6-5-2-1	0.0-3.0-7.0-4.0-8.0-5.0-6.0-2.0-7.0-4.0-2.1-6.1-5.1-2.0-1.0	98	263941	276156
HG01123#1#JAGYYZ010000015.1_51528240_51935090_0	HG01123	276693	304603	2	172	0	15	171	27910	297157	269247	0-3-7-4-8-5-6-2-7-4-2-6-5-2-1	0.0-3.0-7.0-4.0-8.0-5.0-6.0-2.0-7.0-4.0-2.1-6.1-5.1-2.0-1.0	98	276595	304505
HG01123#1#JAGYYZ010000015.1_51528240_51935090_0	HG01123	304547	406906	1	612	0	0	606	102359	399516	297157	0-3-7-4-8-5-6-2-7-4-2-6-5-2-1	0.0-3.0-7.0-4.0-8.0-5.0-6.0-2.0-7.0-4.0-2.1-6.1-5.1-2.0-1.0	98	304449	406808
HG01123#2#JAGYYY010000006.1_51579630_51892388_0	HG01123	99	115455	0	671	0	0	670	115356	115356	0	0-3-7-4-8-5-6-2-1	0.0-3.0-7.0-4.0-8.0-5.0-6.0-2.0-1.0	99	0	115356
HG01123#2#JAGYYY010000006.1_51579630_51892388_0	HG01123	115546	138383	3	132	0	0	131	22837	138193	115356	0-3-7-4-8-5-6-2-1	0.0-3.0-7.0-4.0-8.0-5.0-6.0-2.0-1.0	99	115447	138284
HG01123#2#JAGYYY010000006.1_51579630_51892388_0	HG01123	139142	142438	7	17	0	0	16	3296	141489	138193	0-3-7-4-8-5-6-2-1	0.0-3.0-7.0-4.0-8.0-5.0-6.0-2.0-1.0	99	139043	142339
HG01123#2#JAGYYY010000006.1_51579630_51892388_0	HG01123	143232	161445	4	96	0	1	95	18213	159702	141489	0-3-7-4-8-5-6-2-1	0.0-3.0-7.0-4.0-8.0-5.0-6.0-2.0-1.0	99	143133	161346
HG01123#2#JAGYYY010000006.1_51579630_51892388_0	HG01123	161389	163159	8	8	0	0	7	1770	161472	159702	0-3-7-4-8-5-6-2-1	0.0-3.0-7.0-4.0-8.0-5.0-6.0-2.0-1.0	99	161290	163060
HG01123#2#JAGYYY010000006.1_51579630_51892388_0	HG01123	163103	176207	5	78	0	0	77	13104	174576	161472	0-3-7-4-8-5-6-2-1	0.0-3.0-7.0-4.0-8.0-5.0-6.0-2.0-1.0	99	163004	176108
HG01123#2#JAGYYY010000006.1_51579630_51892388_0	HG01123	176151	178895	6	24	0	0	21	2744	177320	174576	0-3-7-4-8-5-6-2-1	0.0-3.0-7.0-4.0-8.0-5.0-6.0-2.0-1.0	99	176052	178796
HG01123#2#JAGYYY010000006.1_51579630_51892388_0	HG01123	179253	210469	2	172	0	0	171	31216	208536	177320	0-3-7-4-8-5-6-2-1	0.0-3.0-7.0-4.0-8.0-5.0-6.0-2.0-1.0	99	179154	210370
HG01123#2#JAGYYY010000006.1_51579630_51892388_0	HG01123	210413	312814	1	612	0	0	606	102401	310937	208536	0-3-7-4-8-5-6-2-1	0.0-3.0-7.0-4.0-8.0-5.0-6.0-2.0-1.0	99	210314	312715
HG01243#1#JAHEOY010000013.1_90081_424495_0	HG01243	98	115458	0	671	0	0	670	115360	115360	0	0-3-7-4-2-6-5-2-1	0.0-3.0-7.0-4.0-2.1-6.1-5.1-2.0-1.0	98	0	115360
HG01243#1#JAHEOY010000013.1_90081_424495_0	HG01243	115549	138382	3	132	0	0	131	22833	138193	115360	0-3-7-4-2-6-5-2-1	0.0-3.0-7.0-4.0-2.1-6.1-5.1-2.0-1.0	98	115451	138284
HG01243#1#JAHEOY010000013.1_90081_424495_0	HG01243	139141	142437	7	17	0	0	16	3296	141489	138193	0-3-7-4-2-6-5-2-1	0.0-3.0-7.0-4.0-2.1-6.1-5.1-2.0-1.0	98	139043	142339
HG01243#1#JAHEOY010000013.1_90081_424495_0	HG01243	142885	155042	4	96	0	0	58	12157	153646	141489	0-3-7-4-2-6-5-2-1	0.0-3.0-7.0-4.0-2.1-6.1-5.1-2.0-1.0	98	142787	154944
HG01243#1#JAHEOY010000013.1_90081_424495_0	HG01243	156908	188130	2	172	1	171	0	31222	184868	153646	0-3-7-4-2-6-5-2-1	0.0-3.0-7.0-4.0-2.1-6.1-5.1-2.0-1.0	98	156810	188032
HG01243#1#JAHEOY010000013.1_90081_424495_0	HG01243	188491	191018	6	24	1	21	1	2527	187395	184868	0-3-7-4-2-6-5-2-1	0.0-3.0-7.0-4.0-2.1-6.1-5.1-2.0-1.0	98	188393	190920
HG01243#1#JAHEOY010000013.1_90081_424495_0	HG01243	191625	203840	5	78	1	76	3	12215	199610	187395	0-3-7-4-2-6-5-2-1	0.0-3.0-7.0-4.0-2.1-6.1-5.1-2.0-1.0	98	191527	203742
HG01243#1#JAHEOY010000013.1_90081_424495_0	HG01243	204279	231807	2	172	0	15	170	27528	227138	199610	0-3-7-4-2-6-5-2-1	0.0-3.0-7.0-4.0-2.1-6.1-5.1-2.0-1.0	98	204181	231709
HG01243#1#JAHEOY010000013.1_90081_424495_0	HG01243	232231	334470	1	612	0	1	606	102239	329377	227138	0-3-7-4-2-6-5-2-1	0.0-3.0-7.0-4.0-2.1-6.1-5.1-2.0-1.0	98	232133	334372
HG01258#1#JAGYYV010000004.1_56955948_57456952_1	HG01258	155	115533	0	671	0	0	670	115378	115378	0	0-3-7-4-8-5-6-2-4-7-2-5-6-2-7-4-2-5-6-2-1	0.0-3.0-7.0-4.0-8.0-5.0-6.0-2.0-4.1-7.1-2.1-5.0-6.0-2.0-7.0-4.0-2.1-5.0-6.0-2.0-1.0	155	0	115378
HG01258#1#JAGYYV010000004.1_56955948_57456952_1	HG01258	115624	138460	3	132	0	0	131	22836	138214	115378	0-3-7-4-8-5-6-2-4-7-2-5-6-2-7-4-2-5-6-2-1	0.0-3.0-7.0-4.0-8.0-5.0-6.0-2.0-4.1-7.1-2.1-5.0-6.0-2.0-7.0-4.0-2.1-5.0-6.0-2.0-1.0	155	115469	138305
HG01258#1#JAGYYV010000004.1_56955948_57456952_1	HG01258	139219	142515	7	17	0	0	16	3296	141510	138214	0-3-7-4-8-5-6-2-4-7-2-5-6-2-7-4-2-5-6-2-1	0.0-3.0-7.0-4.0-8.0-5.0-6.0-2.0-4.1-7.1-2.1-5.0-6.0-2.0-7.0-4.0-2.1-5.0-6.0-2.0-1.0	155	139064	142360
HG01258#1#JAGYYV010000004.1_56955948_57456952_1	HG01258	142963	161521	4	96	0	0	95	18558	160068	141510	0-3-7-4-8-5-6-2-4-7-2-5-6-2-7-4-2-5-6-2-1	0.0-3.0-7.0-4.0-8.0-5.0-6.0-2.0-4.1-7.1-2.1-5.0-6.0-2.0-7.0-4.0-2.1-5.0-6.0-2.0-1.0	155	142808	161366
HG01258#1#JAGYYV010000004.1_56955948_57456952_1	HG01258	161465	163235	8	8	0	0	7	1770	161838	160068	0-3-7-4-8-5-6-2-4-7-2-5-6-2-7-4-2-5-6-2-1	0.0-3.0-7.0-4.0-8.0-5.0-6.0-2.0-4.1-7.1-2.1-5.0-6.0-2.0-7.0-4.0-2.1-5.0-6.0-2.0-1.0	155	161310	163080
HG01258#1#JAGYYV010000004.1_56955948_57456952_1	HG01258	163179	176283	5	78	0	0	77	13104	174942	161838	0-3-7-4-8-5-6-2-4-7-2-5-6-2-7-4-2-5-6-2-1	0.0-3.0-7.0-4.0-8.0-5.0-6.0-2.0-4.1-7.1-2.1-5.0-6.0-2.0-7.0-4.0-2.1-5.0-6.0-2.0-1.0	155	163024	176128
HG01258#1#JAGYYV010000004.1_56955948_57456952_1	HG01258	176227	178971	6	24	0	0	21	2744	177686	174942	0-3-7-4-8-5-6-2-4-7-2-5-6-2-7-4-2-5-6-2-1	0.0-3.0-7.0-4.0-8.0-5.0-6.0-2.0-4.1-7.1-2.1-5.0-6.0-2.0-7.0-4.0-2.1-5.0-6.0-2.0-1.0	155	176072	178816
HG01258#1#JAGYYV010000004.1_56955948_57456952_1	HG01258	179329	210165	2	172	0	0	170	30836	208522	177686	0-3-7-4-8-5-6-2-4-7-2-5-6-2-7-4-2-5-6-2-1	0.0-3.0-7.0-4.0-8.0-5.0-6.0-2.0-4.1-7.1-2.1-5.0-6.0-2.0-7.0-4.0-2.1-5.0-6.0-2.0-1.0	155	179174	210010
HG01258#1#JAGYYV010000004.1_56955948_57456952_1	HG01258	212416	223963	4	96	1	58	4	11547	220069	208522	0-3-7-4-8-5-6-2-4-7-2-5-6-2-7-4-2-5-6-2-1	0.0-3.0-7.0-4.0-8.0-5.0-6.0-2.0-4.1-7.1-2.1-5.0-6.0-2.0-7.0-4.0-2.1-5.0-6.0-2.0-1.0	155	212261	223808
HG01258#1#JAGYYV010000004.1_56955948_57456952_1	HG01258	225028	228324	7	17	1	16	0	3296	223365	220069	0-3-7-4-8-5-6-2-4-7-2-5-6-2-7-4-2-5-6-2-1	0.0-3.0-7.0-4.0-8.0-5.0-6.0-2.0-4.1-7.1-2.1-5.0-6.0-2.0-7.0-4.0-2.1-5.0-6.0-2.0-1.0	155	224873	228169
HG01258#1#JAGYYV010000004.1_56955948_57456952_1	HG01258	229786	257316	2	172	1	170	15	27530	250895	223365	0-3-7-4-8-5-6-2-4-7-2-5-6-2-7-4-2-5-6-2-1	0.0-3.0-7.0-4.0-8.0-5.0-6.0-2.0-4.1-7.1-2.1-5.0-6.0-2.0-7.0-4.0-2.1-5.0-6.0-2.0-1.0	155	229631	257161
HG01258#1#JAGYYV010000004.1_56955948_57456952_1	HG01258	258282	269970	5	78	0	5	76	11688	262583	250895	0-3-7-4-8-5-6-2-4-7-2-5-6-2-7-4-2-5-6-2-1	0.0-3.0-7.0-4.0-8.0-5.0-6.0-2.0-4.1-7.1-2.1-5.0-6.0-2.0-7.0-4.0-2.1-5.0-6.0-2.0-1.0	155	258127	269815
HG01258#1#JAGYYV010000004.1_56955948_57456952_1	HG01258	270577	273104	6	24	0	1	21	2527	265110	262583	0-3-7-4-8-5-6-2-4-7-2-5-6-2-7-4-2-5-6-2-1	0.0-3.0-7.0-4.0-8.0-5.0-6.0-2.0-4.1-7.1-2.1-5.0-6.0-2.0-7.0-4.0-2.1-5.0-6.0-2.0-1.0	155	270422	272949
HG01258#1#JAGYYV010000004.1_56955948_57456952_1	HG01258	273462	304675	2	172	0	0	171	31213	296323	265110	0-3-7-4-8-5-6-2-4-7-2-5-6-2-7-4-2-5-6-2-1	0.0-3.0-7.0-4.0-8.0-5.0-6.0-2.0-4.1-7.1-2.1-5.0-6.0-2.0-7.0-4.0-2.1-5.0-6.0-2.0-1.0	155	273307	304520
HG01258#1#JAGYYV010000004.1_56955948_57456952_1	HG01258	305752	309048	7	17	0	0	16	3296	299619	296323	0-3-7-4-8-5-6-2-4-7-2-5-6-2-7-4-2-5-6-2-1	0.0-3.0-7.0-4.0-8.0-5.0-6.0-2.0-4.1-7.1-2.1-5.0-6.0-2.0-7.0-4.0-2.1-5.0-6.0-2.0-1.0	155	305597	308893
HG01258#1#JAGYYV010000004.1_56955948_57456952_1	HG01258	310113	321658	4	96	0	4	58	11545	311164	299619	0-3-7-4-8-5-6-2-4-7-2-5-6-2-7-4-2-5-6-2-1	0.0-3.0-7.0-4.0-8.0-5.0-6.0-2.0-4.1-7.1-2.1-5.0-6.0-2.0-7.0-4.0-2.1-5.0-6.0-2.0-1.0	155	309958	321503
HG01258#1#JAGYYV010000004.1_56955948_57456952_1	HG01258	323524	351439	2	172	1	171	15	27915	339079	311164	0-3-7-4-8-5-6-2-4-7-2-5-6-2-7-4-2-5-6-2-1	0.0-3.0-7.0-4.0-8.0-5.0-6.0-2.0-4.1-7.1-2.1-5.0-6.0-2.0-7.0-4.0-2.1-5.0-6.0-2.0-1.0	155	323369	351284
HG01258#1#JAGYYV010000004.1_56955948_57456952_1	HG01258	351878	364093	5	78	0	3	76	12215	351294	339079	0-3-7-4-8-5-6-2-4-7-2-5-6-2-7-4-2-5-6-2-1	0.0-3.0-7.0-4.0-8.0-5.0-6.0-2.0-4.1-7.1-2.1-5.0-6.0-2.0-7.0-4.0-2.1-5.0-6.0-2.0-1.0	155	351723	363938
HG01258#1#JAGYYV010000004.1_56955948_57456952_1	HG01258	364700	367643	6	24	0	1	23	2943	354237	351294	0-3-7-4-8-5-6-2-4-7-2-5-6-2-7-4-2-5-6-2-1	0.0-3.0-7.0-4.0-8.0-5.0-6.0-2.0-4.1-7.1-2.1-5.0-6.0-2.0-7.0-4.0-2.1-5.0-6.0-2.0-1.0	155	364545	367488
HG01258#1#JAGYYV010000004.1_56955948_57456952_1	HG01258	367587	398805	2	172	0	0	171	31218	385455	354237	0-3-7-4-8-5-6-2-4-7-2-5-6-2-7-4-2-5-6-2-1	0.0-3.0-7.0-4.0-8.0-5.0-6.0-2.0-4.1-7.1-2.1-5.0-6.0-2.0-7.0-4.0-2.1-5.0-6.0-2.0-1.0	155	367432	398650
HG01258#1#JAGYYV010000004.1_56955948_57456952_1	HG01258	398749	500942	1	612	0	0	605	102193	487648	385455	0-3-7-4-8-5-6-2-4-7-2-5-6-2-7-4-2-5-6-2-1	0.0-3.0-7.0-4.0-8.0-5.0-6.0-2.0-4.1-7.1-2.1-5.0-6.0-2.0-7.0-4.0-2.1-5.0-6.0-2.0-1.0	155	398594	500787
HG01258#2#JAGYYU010000072.1_51562603_51970395_0	HG01258	98	115466	0	671	0	0	670	115368	115368	0	0-3-7-4-8-5-6-2-7-4-2-6-5-2-1	0.0-3.0-7.0-4.0-8.0-5.0-6.0-2.0-7.0-4.0-2.1-6.1-5.1-2.0-1.0	98	0	115368
HG01258#2#JAGYYU010000072.1_51562603_51970395_0	HG01258	115557	138391	3	132	0	0	131	22834	138202	115368	0-3-7-4-8-5-6-2-7-4-2-6-5-2-1	0.0-3.0-7.0-4.0-8.0-5.0-6.0-2.0-7.0-4.0-2.1-6.1-5.1-2.0-1.0	98	115459	138293
HG01258#2#JAGYYU010000072.1_51562603_51970395_0	HG01258	139150	142446	7	17	0	0	16	3296	141498	138202	0-3-7-4-8-5-6-2-7-4-2-6-5-2-1	0.0-3.0-7.0-4.0-8.0-5.0-6.0-2.0-7.0-4.0-2.1-6.1-5.1-2.0-1.0	98	139052	142348
HG01258#2#JAGYYU010000072.1_51562603_51970395_0	HG01258	142894	161461	4	96	0	0	95	18567	160065	141498	0-3-7-4-8-5-6-2-7-4-2-6-5-2-1	0.0-3.0-7.0-4.0-8.0-5.0-6.0-2.0-7.0-4.0-2.1-6.1-5.1-2.0-1.0	98	142796	161363
HG01258#2#JAGYYU010000072.1_51562603_51970395_0	HG01258	161405	163175	8	8	0	0	7	1770	161835	160065	0-3-7-4-8-5-6-2-7-4-2-6-5-2-1	0.0-3.0-7.0-4.0-8.0-5.0-6.0-2.0-7.0-4.0-2.1-6.1-5.1-2.0-1.0	98	161307	163077
HG01258#2#JAGYYU010000072.1_51562603_51970395_0	HG01258	163119	175783	5	78	0	0	76	12664	174499	161835	0-3-7-4-8-5-6-2-7-4-2-6-5-2-1	0.0-3.0-7.0-4.0-8.0-5.0-6.0-2.0-7.0-4.0-2.1-6.1-5.1-2.0-1.0	98	163021	175685
HG01258#2#JAGYYU010000072.1_51562603_51970395_0	HG01258	176390	178917	6	24	0	1	21	2527	177026	174499	0-3-7-4-8-5-6-2-7-4-2-6-5-2-1	0.0-3.0-7.0-4.0-8.0-5.0-6.0-2.0-7.0-4.0-2.1-6.1-5.1-2.0-1.0	98	176292	178819
HG01258#2#JAGYYU010000072.1_51562603_51970395_0	HG01258	179276	210488	2	172	0	0	171	31212	208238	177026	0-3-7-4-8-5-6-2-7-4-2-6-5-2-1	0.0-3.0-7.0-4.0-8.0-5.0-6.0-2.0-7.0-4.0-2.1-6.1-5.1-2.0-1.0	98	179178	210390
HG01258#2#JAGYYU010000072.1_51562603_51970395_0	HG01258	211565	214861	7	17	0	0	16	3296	211534	208238	0-3-7-4-8-5-6-2-7-4-2-6-5-2-1	0.0-3.0-7.0-4.0-8.0-5.0-6.0-2.0-7.0-4.0-2.1-6.1-5.1-2.0-1.0	98	211467	214763
HG01258#2#JAGYYU010000072.1_51562603_51970395_0	HG01258	215926	227471	4	96	0	4	58	11545	223079	211534	0-3-7-4-8-5-6-2-7-4-2-6-5-2-1	0.0-3.0-7.0-4.0-8.0-5.0-6.0-2.0-7.0-4.0-2.1-6.1-5.1-2.0-1.0	98	215828	227373
HG01258#2#JAGYYU010000072.1_51562603_51970395_0	HG01258	229337	260559	2	172	1	171	0	31222	254301	223079	0-3-7-4-8-5-6-2-7-4-2-6-5-2-1	0.0-3.0-7.0-4.0-8.0-5.0-6.0-2.0-7.0-4.0-2.1-6.1-5.1-2.0-1.0	98	229239	260461
HG01258#2#JAGYYU010000072.1_51562603_51970395_0	HG01258	260503	263446	6	24	1	23	1	2943	257244	254301	0-3-7-4-8-5-6-2-7-4-2-6-5-2-1	0.0-3.0-7.0-4.0-8.0-5.0-6.0-2.0-7.0-4.0-2.1-6.1-5.1-2.0-1.0	98	260405	263348
HG01258#2#JAGYYU010000072.1_51562603_51970395_0	HG01258	264053	276268	5	78	1	76	3	12215	269459	257244	0-3-7-4-8-5-6-2-7-4-2-6-5-2-1	0.0-3.0-7.0-4.0-8.0-5.0-6.0-2.0-7.0-4.0-2.1-6.1-5.1-2.0-1.0	98	263955	276170
HG01258#2#JAGYYU010000072.1_51562603_51970395_0	HG01258	276707	304624	2	172	0	15	171	27917	297376	269459	0-3-7-4-8-5-6-2-7-4-2-6-5-2-1	0.0-3.0-7.0-4.0-8.0-5.0-6.0-2.0-7.0-4.0-2.1-6.1-5.1-2.0-1.0	98	276609	304526
HG01258#2#JAGYYU010000072.1_51562603_51970395_0	HG01258	304568	407720	1	612	0	0	611	103152	400528	297376	0-3-7-4-8-5-6-2-7-4-2-6-5-2-1	0.0-3.0-7.0-4.0-8.0-5.0-6.0-2.0-7.0-4.0-2.1-6.1-5.1-2.0-1.0	98	304470	407622
HG01358#1#JAGYZB010000020.1_27445742_27855492_1	HG01358	154	115517	0	671	0	0	670	115363	115363	0	0-3-7-4-8-5-6-2-4-4-2-6-5-2-1	0.0-3.0-7.0-4.0-8.0-5.0-6.0-2.0-4.1-4.0-2.1-6.1-5.1-2.0-1.0	154	0	115363
HG01358#1#JAGYZB010000020.1_27445742_27855492_1	HG01358	115608	138441	3	132	0	0	131	22833	138196	115363	0-3-7-4-8-5-6-2-4-4-2-6-5-2-1	0.0-3.0-7.0-4.0-8.0-5.0-6.0-2.0-4.1-4.0-2.1-6.1-5.1-2.0-1.0	154	115454	138287
HG01358#1#JAGYZB010000020.1_27445742_27855492_1	HG01358	139200	142495	7	17	0	0	16	3295	141491	138196	0-3-7-4-8-5-6-2-4-4-2-6-5-2-1	0.0-3.0-7.0-4.0-8.0-5.0-6.0-2.0-4.1-4.0-2.1-6.1-5.1-2.0-1.0	154	139046	142341
HG01358#1#JAGYZB010000020.1_27445742_27855492_1	HG01358	142943	161511	4	96	0	0	95	18568	160059	141491	0-3-7-4-8-5-6-2-4-4-2-6-5-2-1	0.0-3.0-7.0-4.0-8.0-5.0-6.0-2.0-4.1-4.0-2.1-6.1-5.1-2.0-1.0	154	142789	161357
HG01358#1#JAGYZB010000020.1_27445742_27855492_1	HG01358	161455	163225	8	8	0	0	7	1770	161829	160059	0-3-7-4-8-5-6-2-4-4-2-6-5-2-1	0.0-3.0-7.0-4.0-8.0-5.0-6.0-2.0-4.1-4.0-2.1-6.1-5.1-2.0-1.0	154	161301	163071
HG01358#1#JAGYZB010000020.1_27445742_27855492_1	HG01358	163169	176273	5	78	0	0	77	13104	174933	161829	0-3-7-4-8-5-6-2-4-4-2-6-5-2-1	0.0-3.0-7.0-4.0-8.0-5.0-6.0-2.0-4.1-4.0-2.1-6.1-5.1-2.0-1.0	154	163015	176119
HG01358#1#JAGYZB010000020.1_27445742_27855492_1	HG01358	176217	178961	6	24	0	0	21	2744	177677	174933	0-3-7-4-8-5-6-2-4-4-2-6-5-2-1	0.0-3.0-7.0-4.0-8.0-5.0-6.0-2.0-4.1-4.0-2.1-6.1-5.1-2.0-1.0	154	176063	178807
HG01358#1#JAGYZB010000020.1_27445742_27855492_1	HG01358	179323	210527	2	172	0	0	171	31204	208881	177677	0-3-7-4-8-5-6-2-4-4-2-6-5-2-1	0.0-3.0-7.0-4.0-8.0-5.0-6.0-2.0-4.1-4.0-2.1-6.1-5.1-2.0-1.0	154	179169	210373
HG01358#1#JAGYZB010000020.1_27445742_27855492_1	HG01358	212393	221622	4	96	1	58	20	9229	218110	208881	0-3-7-4-8-5-6-2-4-4-2-6-5-2-1	0.0-3.0-7.0-4.0-8.0-5.0-6.0-2.0-4.1-4.0-2.1-6.1-5.1-2.0-1.0	154	212239	221468
HG01358#1#JAGYZB010000020.1_27445742_27855492_1	HG01358	221930	230407	4	96	0	22	58	8477	226587	218110	0-3-7-4-8-5-6-2-4-4-2-6-5-2-1	0.0-3.0-7.0-4.0-8.0-5.0-6.0-2.0-4.1-4.0-2.1-6.1-5.1-2.0-1.0	154	221776	230253
HG01358#1#JAGYZB010000020.1_27445742_27855492_1	HG01358	232273	263490	2	172	1	171	0	31217	257804	226587	0-3-7-4-8-5-6-2-4-4-2-6-5-2-1	0.0-3.0-7.0-4.0-8.0-5.0-6.0-2.0-4.1-4.0-2.1-6.1-5.1-2.0-1.0	154	232119	263336
HG01358#1#JAGYZB010000020.1_27445742_27855492_1	HG01358	263852	266379	6	24	1	21	1	2527	260331	257804	0-3-7-4-8-5-6-2-4-4-2-6-5-2-1	0.0-3.0-7.0-4.0-8.0-5.0-6.0-2.0-4.1-4.0-2.1-6.1-5.1-2.0-1.0	154	263698	266225
HG01358#1#JAGYZB010000020.1_27445742_27855492_1	HG01358	266986	279201	5	78	1	76	3	12215	272546	260331	0-3-7-4-8-5-6-2-4-4-2-6-5-2-1	0.0-3.0-7.0-4.0-8.0-5.0-6.0-2.0-4.1-4.0-2.1-6.1-5.1-2.0-1.0	154	266832	279047
HG01358#1#JAGYZB010000020.1_27445742_27855492_1	HG01358	279640	307549	2	172	0	15	171	27909	300455	272546	0-3-7-4-8-5-6-2-4-4-2-6-5-2-1	0.0-3.0-7.0-4.0-8.0-5.0-6.0-2.0-4.1-4.0-2.1-6.1-5.1-2.0-1.0	154	279486	307395
HG01358#1#JAGYZB010000020.1_27445742_27855492_1	HG01358	307493	409688	1	612	0	0	605	102195	402650	300455	0-3-7-4-8-5-6-2-4-4-2-6-5-2-1	0.0-3.0-7.0-4.0-8.0-5.0-6.0-2.0-4.1-4.0-2.1-6.1-5.1-2.0-1.0	154	307339	409534
HG01891#1#JAGYVO010000014.1_22855818_23168577_1	HG01891	154	115518	0	671	0	0	670	115364	115364	0	0-3-7-4-8-5-6-2-1	0.0-3.0-7.0-4.0-8.0-5.0-6.0-2.0-1.0	154	0	115364
HG01891#1#JAGYVO010000014.1_22855818_23168577_1	HG01891	115609	138440	3	132	0	0	131	22831	138195	115364	0-3-7-4-8-5-6-2-1	0.0-3.0-7.0-4.0-8.0-5.0-6.0-2.0-1.0	154	115455	138286
HG01891#1#JAGYVO010000014.1_22855818_23168577_1	HG01891	139199	142494	7	17	0	0	16	3295	141490	138195	0-3-7-4-8-5-6-2-1	0.0-3.0-7.0-4.0-8.0-5.0-6.0-2.0-1.0	154	139045	142340
HG01891#1#JAGYVO010000014.1_22855818_23168577_1	HG01891	142942	161511	4	96	0	0	95	18569	160059	141490	0-3-7-4-8-5-6-2-1	0.0-3.0-7.0-4.0-8.0-5.0-6.0-2.0-1.0	154	142788	161357
HG01891#1#JAGYVO010000014.1_22855818_23168577_1	HG01891	161455	163225	8	8	0	0	7	1770	161829	160059	0-3-7-4-8-5-6-2-1	0.0-3.0-7.0-4.0-8.0-5.0-6.0-2.0-1.0	154	161301	163071
HG01891#1#JAGYVO010000014.1_22855818_23168577_1	HG01891	163169	175826	5	78	0	0	76	12657	174486	161829	0-3-7-4-8-5-6-2-1	0.0-3.0-7.0-4.0-8.0-5.0-6.0-2.0-1.0	154	163015	175672
HG01891#1#JAGYVO010000014.1_22855818_23168577_1	HG01891	176433	178960	6	24	0	1	21	2527	177013	174486	0-3-7-4-8-5-6-2-1	0.0-3.0-7.0-4.0-8.0-5.0-6.0-2.0-1.0	154	176279	178806
HG01891#1#JAGYVO010000014.1_22855818_23168577_1	HG01891	179319	210535	2	172	0	0	171	31216	208229	177013	0-3-7-4-8-5-6-2-1	0.0-3.0-7.0-4.0-8.0-5.0-6.0-2.0-1.0	154	179165	210381
HG01891#1#JAGYVO010000014.1_22855818_23168577_1	HG01891	210479	312697	1	612	0	0	605	102218	310447	208229	0-3-7-4-8-5-6-2-1	0.0-3.0-7.0-4.0-8.0-5.0-6.0-2.0-1.0	154	210325	312543
HG01928#1#JAGYVQ010000053.1_16676493_17083407_0	HG01928	99	115441	0	671	0	0	670	115342	115342	0	0-3-7-4-8-5-6-2-4-7-2-6-5-2-1	0.0-3.0-7.0-4.0-8.0-5.0-6.0-2.0-4.1-7.1-2.1-6.1-5.1-2.0-1.0	99	0	115342
HG01928#1#JAGYVQ010000053.1_16676493_17083407_0	HG01928	115532	138365	3	132	0	0	131	22833	138175	115342	0-3-7-4-8-5-6-2-4-7-2-6-5-2-1	0.0-3.0-7.0-4.0-8.0-5.0-6.0-2.0-4.1-7.1-2.1-6.1-5.1-2.0-1.0	99	115433	138266
HG01928#1#JAGYVQ010000053.1_16676493_17083407_0	HG01928	139124	142420	7	17	0	0	16	3296	141471	138175	0-3-7-4-8-5-6-2-4-7-2-6-5-2-1	0.0-3.0-7.0-4.0-8.0-5.0-6.0-2.0-4.1-7.1-2.1-6.1-5.1-2.0-1.0	99	139025	142321
HG01928#1#JAGYVQ010000053.1_16676493_17083407_0	HG01928	142868	161424	4	96	0	0	95	18556	160027	141471	0-3-7-4-8-5-6-2-4-7-2-6-5-2-1	0.0-3.0-7.0-4.0-8.0-5.0-6.0-2.0-4.1-7.1-2.1-6.1-5.1-2.0-1.0	99	142769	161325
HG01928#1#JAGYVQ010000053.1_16676493_17083407_0	HG01928	161368	163138	8	8	0	0	7	1770	161797	160027	0-3-7-4-8-5-6-2-4-7-2-6-5-2-1	0.0-3.0-7.0-4.0-8.0-5.0-6.0-2.0-4.1-7.1-2.1-6.1-5.1-2.0-1.0	99	161269	163039
HG01928#1#JAGYVQ010000053.1_16676493_17083407_0	HG01928	163082	176186	5	78	0	0	77	13104	174901	161797	0-3-7-4-8-5-6-2-4-7-2-6-5-2-1	0.0-3.0-7.0-4.0-8.0-5.0-6.0-2.0-4.1-7.1-2.1-6.1-5.1-2.0-1.0	99	162983	176087
HG01928#1#JAGYVQ010000053.1_16676493_17083407_0	HG01928	176130	178874	6	24	0	0	21	2744	177645	174901	0-3-7-4-8-5-6-2-4-7-2-6-5-2-1	0.0-3.0-7.0-4.0-8.0-5.0-6.0-2.0-4.1-7.1-2.1-6.1-5.1-2.0-1.0	99	176031	178775
HG01928#1#JAGYVQ010000053.1_16676493_17083407_0	HG01928	179232	210067	2	172	0	0	170	30835	208480	177645	0-3-7-4-8-5-6-2-4-7-2-6-5-2-1	0.0-3.0-7.0-4.0-8.0-5.0-6.0-2.0-4.1-7.1-2.1-6.1-5.1-2.0-1.0	99	179133	209968
HG01928#1#JAGYVQ010000053.1_16676493_17083407_0	HG01928	212318	223867	4	96	1	58	4	11549	220029	208480	0-3-7-4-8-5-6-2-4-7-2-6-5-2-1	0.0-3.0-7.0-4.0-8.0-5.0-6.0-2.0-4.1-7.1-2.1-6.1-5.1-2.0-1.0	99	212219	223768
HG01928#1#JAGYVQ010000053.1_16676493_17083407_0	HG01928	224932	228227	7	17	1	16	0	3295	223324	220029	0-3-7-4-8-5-6-2-4-7-2-6-5-2-1	0.0-3.0-7.0-4.0-8.0-5.0-6.0-2.0-4.1-7.1-2.1-6.1-5.1-2.0-1.0	99	224833	228128
HG01928#1#JAGYVQ010000053.1_16676493_17083407_0	HG01928	229689	260525	2	172	1	170	0	30836	254160	223324	0-3-7-4-8-5-6-2-4-7-2-6-5-2-1	0.0-3.0-7.0-4.0-8.0-5.0-6.0-2.0-4.1-7.1-2.1-6.1-5.1-2.0-1.0	99	229590	260426
HG01928#1#JAGYVQ010000053.1_16676493_17083407_0	HG01928	260902	263646	6	24	1	21	0	2744	256904	254160	0-3-7-4-8-5-6-2-4-7-2-6-5-2-1	0.0-3.0-7.0-4.0-8.0-5.0-6.0-2.0-4.1-7.1-2.1-6.1-5.1-2.0-1.0	99	260803	263547
HG01928#1#JAGYVQ010000053.1_16676493_17083407_0	HG01928	263590	275718	5	78	1	77	5	12128	269032	256904	0-3-7-4-8-5-6-2-4-7-2-6-5-2-1	0.0-3.0-7.0-4.0-8.0-5.0-6.0-2.0-4.1-7.1-2.1-6.1-5.1-2.0-1.0	99	263491	275619
HG01928#1#JAGYVQ010000053.1_16676493_17083407_0	HG01928	276684	304604	2	172	0	15	171	27920	296952	269032	0-3-7-4-8-5-6-2-4-7-2-6-5-2-1	0.0-3.0-7.0-4.0-8.0-5.0-6.0-2.0-4.1-7.1-2.1-6.1-5.1-2.0-1.0	99	276585	304505
HG01928#1#JAGYVQ010000053.1_16676493_17083407_0	HG01928	304548	406970	1	612	0	0	606	102422	399374	296952	0-3-7-4-8-5-6-2-4-7-2-6-5-2-1	0.0-3.0-7.0-4.0-8.0-5.0-6.0-2.0-4.1-7.1-2.1-6.1-5.1-2.0-1.0	99	304449	406871
HG01978#1#JAGYVS010000002.1_51519970_52021951_0	HG01978	99	115460	0	671	0	0	670	115361	115361	0	0-3-7-4-8-5-6-2-4-7-2-6-5-2-4-7-2-5-6-2-1	0.0-3.0-7.0-4.0-8.0-5.0-6.0-2.0-4.1-7.1-2.1-6.1-5.1-2.0-4.1-7.1-2.1-5.0-6.0-2.0-1.0	99	0	115361
HG01978#1#JAGYVS010000002.1_51519970_52021951_0	HG01978	115551	138384	3	132	0	0	131	22833	138194	115361	0-3-7-4-8-5-6-2-4-7-2-6-5-2-4-7-2-5-6-2-1	0.0-3.0-7.0-4.0-8.0-5.0-6.0-2.0-4.1-7.1-2.1-6.1-5.1-2.0-4.1-7.1-2.1-5.0-6.0-2.0-1.0	99	115452	138285
HG01978#1#JAGYVS010000002.1_51519970_52021951_0	HG01978	139143	142439	7	17	0	0	16	3296	141490	138194	0-3-7-4-8-5-6-2-4-7-2-6-5-2-4-7-2-5-6-2-1	0.0-3.0-7.0-4.0-8.0-5.0-6.0-2.0-4.1-7.1-2.1-6.1-5.1-2.0-4.1-7.1-2.1-5.0-6.0-2.0-1.0	99	139044	142340
HG01978#1#JAGYVS010000002.1_51519970_52021951_0	HG01978	143233	161445	4	96	0	1	95	18212	159702	141490	0-3-7-4-8-5-6-2-4-7-2-6-5-2-4-7-2-5-6-2-1	0.0-3.0-7.0-4.0-8.0-5.0-6.0-2.0-4.1-7.1-2.1-6.1-5.1-2.0-4.1-7.1-2.1-5.0-6.0-2.0-1.0	99	143134	161346
HG01978#1#JAGYVS010000002.1_51519970_52021951_0	HG01978	161389	163159	8	8	0	0	7	1770	161472	159702	0-3-7-4-8-5-6-2-4-7-2-6-5-2-4-7-2-5-6-2-1	0.0-3.0-7.0-4.0-8.0-5.0-6.0-2.0-4.1-7.1-2.1-6.1-5.1-2.0-4.1-7.1-2.1-5.0-6.0-2.0-1.0	99	161290	163060
HG01978#1#JAGYVS010000002.1_51519970_52021951_0	HG01978	163103	176207	5	78	0	0	77	13104	174576	161472	0-3-7-4-8-5-6-2-4-7-2-6-5-2-4-7-2-5-6-2-1	0.0-3.0-7.0-4.0-8.0-5.0-6.0-2.0-4.1-7.1-2.1-6.1-5.1-2.0-4.1-7.1-2.1-5.0-6.0-2.0-1.0	99	163004	176108
HG01978#1#JAGYVS010000002.1_51519970_52021951_0	HG01978	176151	178895	6	24	0	0	21	2744	177320	174576	0-3-7-4-8-5-6-2-4-7-2-6-5-2-4-7-2-5-6-2-1	0.0-3.0-7.0-4.0-8.0-5.0-6.0-2.0-4.1-7.1-2.1-6.1-5.1-2.0-4.1-7.1-2.1-5.0-6.0-2.0-1.0	99	176052	178796
HG01978#1#JAGYVS010000002.1_51519970_52021951_0	HG01978	179254	210086	2	172	0	0	170	30832	208152	177320	0-3-7-4-8-5-6-2-4-7-2-6-5-2-4-7-2-5-6-2-1	0.0-3.0-7.0-4.0-8.0-5.0-6.0-2.0-4.1-7.1-2.1-6.1-5.1-2.0-4.1-7.1-2.1-5.0-6.0-2.0-1.0	99	179155	209987
HG01978#1#JAGYVS010000002.1_51519970_52021951_0	HG01978	212337	223884	4	96	1	58	4	11547	219699	208152	0-3-7-4-8-5-6-2-4-7-2-6-5-2-4-7-2-5-6-2-1	0.0-3.0-7.0-4.0-8.0-5.0-6.0-2.0-4.1-7.1-2.1-6.1-5.1-2.0-4.1-7.1-2.1-5.0-6.0-2.0-1.0	99	212238	223785
HG01978#1#JAGYVS010000002.1_51519970_52021951_0	HG01978	224951	228247	7	17	1	16	0	3296	222995	219699	0-3-7-4-8-5-6-2-4-7-2-6-5-2-4-7-2-5-6-2-1	0.0-3.0-7.0-4.0-8.0-5.0-6.0-2.0-4.1-7.1-2.1-6.1-5.1-2.0-4.1-7.1-2.1-5.0-6.0-2.0-1.0	99	224852	228148
HG01978#1#JAGYVS010000002.1_51519970_52021951_0	HG01978	229709	260545	2	172	1	170	0	30836	253831	222995	0-3-7-4-8-5-6-2-4-7-2-6-5-2-4-7-2-5-6-2-1	0.0-3.0-7.0-4.0-8.0-5.0-6.0-2.0-4.1-7.1-2.1-6.1-5.1-2.0-4.1-7.1-2.1-5.0-6.0-2.0-1.0	99	229610	260446
HG01978#1#JAGYVS010000002.1_51519970_52021951_0	HG01978	260922	263666	6	24	1	21	0	2744	256575	253831	0-3-7-4-8-5-6-2-4-7-2-6-5-2-4-7-2-5-6-2-1	0.0-3.0-7.0-4.0-8.0-5.0-6.0-2.0-4.1-7.1-2.1-6.1-5.1-2.0-4.1-7.1-2.1-5.0-6.0-2.0-1.0	99	260823	263567
HG01978#1#JAGYVS010000002.1_51519970_52021951_0	HG01978	263610	275738	5	78	1	77	5	12128	268703	256575	0-3-7-4-8-5-6-2-4-7-2-6-5-2-4-7-2-5-6-2-1	0.0-3.0-7.0-4.0-8.0-5.0-6.0-2.0-4.1-7.1-2.1-6.1-5.1-2.0-4.1-7.1-2.1-5.0-6.0-2.0-1.0	99	263511	275639
HG01978#1#JAGYVS010000002.1_51519970_52021951_0	HG01978	276704	303895	2	172	0	15	167	27191	295894	268703	0-3-7-4-8-5-6-2-4-7-2-6-5-2-4-7-2-5-6-2-1	0.0-3.0-7.0-4.0-8.0-5.0-6.0-2.0-4.1-7.1-2.1-6.1-5.1-2.0-4.1-7.1-2.1-5.0-6.0-2.0-1.0	99	276605	303796
HG01978#1#JAGYVS010000002.1_51519970_52021951_0	HG01978	306487	318039	4	96	1	58	4	11552	307446	295894	0-3-7-4-8-5-6-2-4-7-2-6-5-2-4-7-2-5-6-2-1	0.0-3.0-7.0-4.0-8.0-5.0-6.0-2.0-4.1-7.1-2.1-6.1-5.1-2.0-4.1-7.1-2.1-5.0-6.0-2.0-1.0	99	306388	317940
HG01978#1#JAGYVS010000002.1_51519970_52021951_0	HG01978	319106	322401	7	17	1	16	0	3295	310741	307446	0-3-7-4-8-5-6-2-4-7-2-6-5-2-4-7-2-5-6-2-1	0.0-3.0-7.0-4.0-8.0-5.0-6.0-2.0-4.1-7.1-2.1-6.1-5.1-2.0-4.1-7.1-2.1-5.0-6.0-2.0-1.0	99	319007	322302
HG01978#1#JAGYVS010000002.1_51519970_52021951_0	HG01978	323863	351387	2	172	1	170	15	27524	338265	310741	0-3-7-4-8-5-6-2-4-7-2-6-5-2-4-7-2-5-6-2-1	0.0-3.0-7.0-4.0-8.0-5.0-6.0-2.0-4.1-7.1-2.1-6.1-5.1-2.0-4.1-7.1-2.1-5.0-6.0-2.0-1.0	99	323764	351288
HG01978#1#JAGYVS010000002.1_51519970_52021951_0	HG01978	352834	364041	5	78	0	8	76	11207	349472	338265	0-3-7-4-8-5-6-2-4-7-2-6-5-2-4-7-2-5-6-2-1	0.0-3.0-7.0-4.0-8.0-5.0-6.0-2.0-4.1-7.1-2.1-6.1-5.1-2.0-4.1-7.1-2.1-5.0-6.0-2.0-1.0	99	352735	363942
HG01978#1#JAGYVS010000002.1_51519970_52021951_0	HG01978	364648	367175	6	24	0	1	21	2527	351999	349472	0-3-7-4-8-5-6-2-4-7-2-6-5-2-4-7-2-5-6-2-1	0.0-3.0-7.0-4.0-8.0-5.0-6.0-2.0-4.1-7.1-2.1-6.1-5.1-2.0-4.1-7.1-2.1-5.0-6.0-2.0-1.0	99	364549	367076
HG01978#1#JAGYVS010000002.1_51519970_52021951_0	HG01978	367534	398750	2	172	0	0	171	31216	383215	351999	0-3-7-4-8-5-6-2-4-7-2-6-5-2-4-7-2-5-6-2-1	0.0-3.0-7.0-4.0-8.0-5.0-6.0-2.0-4.1-7.1-2.1-6.1-5.1-2.0-4.1-7.1-2.1-5.0-6.0-2.0-1.0	99	367435	398651
HG01978#1#JAGYVS010000002.1_51519970_52021951_0	HG01978	398694	501909	1	612	0	0	611	103215	486430	383215	0-3-7-4-8-5-6-2-4-7-2-6-5-2-4-7-2-5-6-2-1	0.0-3.0-7.0-4.0-8.0-5.0-6.0-2.0-4.1-7.1-2.1-6.1-5.1-2.0-4.1-7.1-2.1-5.0-6.0-2.0-1.0	99	398595	501810
HG01978#2#JAGYVR010000007.1_51532241_51939176_0	HG01978	99	115452	0	671	0	0	670	115353	115353	0	0-3-7-4-8-5-6-2-4-7-2-6-5-2-1	0.0-3.0-7.0-4.0-8.0-5.0-6.0-2.0-4.1-7.1-2.1-6.1-5.1-2.0-1.0	99	0	115353
HG01978#2#JAGYVR010000007.1_51532241_51939176_0	HG01978	115543	138376	3	132	0	0	131	22833	138186	115353	0-3-7-4-8-5-6-2-4-7-2-6-5-2-1	0.0-3.0-7.0-4.0-8.0-5.0-6.0-2.0-4.1-7.1-2.1-6.1-5.1-2.0-1.0	99	115444	138277
HG01978#2#JAGYVR010000007.1_51532241_51939176_0	HG01978	139135	142431	7	17	0	0	16	3296	141482	138186	0-3-7-4-8-5-6-2-4-7-2-6-5-2-1	0.0-3.0-7.0-4.0-8.0-5.0-6.0-2.0-4.1-7.1-2.1-6.1-5.1-2.0-1.0	99	139036	142332
HG01978#2#JAGYVR010000007.1_51532241_51939176_0	HG01978	142879	161440	4	96	0	0	95	18561	160043	141482	0-3-7-4-8-5-6-2-4-7-2-6-5-2-1	0.0-3.0-7.0-4.0-8.0-5.0-6.0-2.0-4.1-7.1-2.1-6.1-5.1-2.0-1.0	99	142780	161341
HG01978#2#JAGYVR010000007.1_51532241_51939176_0	HG01978	161384	163154	8	8	0	0	7	1770	161813	160043	0-3-7-4-8-5-6-2-4-7-2-6-5-2-1	0.0-3.0-7.0-4.0-8.0-5.0-6.0-2.0-4.1-7.1-2.1-6.1-5.1-2.0-1.0	99	161285	163055
HG01978#2#JAGYVR010000007.1_51532241_51939176_0	HG01978	163098	176202	5	78	0	0	77	13104	174917	161813	0-3-7-4-8-5-6-2-4-7-2-6-5-2-1	0.0-3.0-7.0-4.0-8.0-5.0-6.0-2.0-4.1-7.1-2.1-6.1-5.1-2.0-1.0	99	162999	176103
HG01978#2#JAGYVR010000007.1_51532241_51939176_0	HG01978	176146	178890	6	24	0	0	21	2744	177661	174917	0-3-7-4-8-5-6-2-4-7-2-6-5-2-1	0.0-3.0-7.0-4.0-8.0-5.0-6.0-2.0-4.1-7.1-2.1-6.1-5.1-2.0-1.0	99	176047	178791
HG01978#2#JAGYVR010000007.1_51532241_51939176_0	HG01978	179556	210088	2	172	0	1	170	30532	208193	177661	0-3-7-4-8-5-6-2-4-7-2-6-5-2-1	0.0-3.0-7.0-4.0-8.0-5.0-6.0-2.0-4.1-7.1-2.1-6.1-5.1-2.0-1.0	99	179457	209989
HG01978#2#JAGYVR010000007.1_51532241_51939176_0	HG01978	212339	223890	4	96	1	58	4	11551	219744	208193	0-3-7-4-8-5-6-2-4-7-2-6-5-2-1	0.0-3.0-7.0-4.0-8.0-5.0-6.0-2.0-4.1-7.1-2.1-6.1-5.1-2.0-1.0	99	212240	223791
HG01978#2#JAGYVR010000007.1_51532241_51939176_0	HG01978	224957	228252	7	17	1	16	0	3295	223039	219744	0-3-7-4-8-5-6-2-4-7-2-6-5-2-1	0.0-3.0-7.0-4.0-8.0-5.0-6.0-2.0-4.1-7.1-2.1-6.1-5.1-2.0-1.0	99	224858	228153
HG01978#2#JAGYVR010000007.1_51532241_51939176_0	HG01978	229714	260550	2	172	1	170	0	30836	253875	223039	0-3-7-4-8-5-6-2-4-7-2-6-5-2-1	0.0-3.0-7.0-4.0-8.0-5.0-6.0-2.0-4.1-7.1-2.1-6.1-5.1-2.0-1.0	99	229615	260451
HG01978#2#JAGYVR010000007.1_51532241_51939176_0	HG01978	260927	263671	6	24	1	21	0	2744	256619	253875	0-3-7-4-8-5-6-2-4-7-2-6-5-2-1	0.0-3.0-7.0-4.0-8.0-5.0-6.0-2.0-4.1-7.1-2.1-6.1-5.1-2.0-1.0	99	260828	263572
HG01978#2#JAGYVR010000007.1_51532241_51939176_0	HG01978	263615	275743	5	78	1	77	5	12128	268747	256619	0-3-7-4-8-5-6-2-4-7-2-6-5-2-1	0.0-3.0-7.0-4.0-8.0-5.0-6.0-2.0-4.1-7.1-2.1-6.1-5.1-2.0-1.0	99	263516	275644
HG01978#2#JAGYVR010000007.1_51532241_51939176_0	HG01978	276709	304621	2	172	0	15	171	27912	296659	268747	0-3-7-4-8-5-6-2-4-7-2-6-5-2-1	0.0-3.0-7.0-4.0-8.0-5.0-6.0-2.0-4.1-7.1-2.1-6.1-5.1-2.0-1.0	99	276610	304522
HG01978#2#JAGYVR010000007.1_51532241_51939176_0	HG01978	304565	406991	1	612	0	0	606	102426	399085	296659	0-3-7-4-8-5-6-2-4-7-2-6-5-2-1	0.0-3.0-7.0-4.0-8.0-5.0-6.0-2.0-4.1-7.1-2.1-6.1-5.1-2.0-1.0	99	304466	406892
HG02004.verkko_filt_mat.fa:haplotype1-0000022_97828542_98235483_0	HG02004	99	115453	0	671	0	0	670	115354	115354	0	0-3-7-4-8-5-6-2-4-7-2-6-5-2-1	0.0-3.0-7.0-4.0-8.0-5.0-6.0-2.0-4.1-7.1-2.1-6.1-5.1-2.0-1.0	99	0	115354
HG02004.verkko_filt_mat.fa:haplotype1-0000022_97828542_98235483_0	HG02004	115544	138377	3	132	0	0	131	22833	138187	115354	0-3-7-4-8-5-6-2-4-7-2-6-5-2-1	0.0-3.0-7.0-4.0-8.0-5.0-6.0-2.0-4.1-7.1-2.1-6.1-5.1-2.0-1.0	99	115445	138278
HG02004.verkko_filt_mat.fa:haplotype1-0000022_97828542_98235483_0	HG02004	139136	142432	7	17	0	0	16	3296	141483	138187	0-3-7-4-8-5-6-2-4-7-2-6-5-2-1	0.0-3.0-7.0-4.0-8.0-5.0-6.0-2.0-4.1-7.1-2.1-6.1-5.1-2.0-1.0	99	139037	142333
HG02004.verkko_filt_mat.fa:haplotype1-0000022_97828542_98235483_0	HG02004	142880	161442	4	96	0	0	95	18562	160045	141483	0-3-7-4-8-5-6-2-4-7-2-6-5-2-1	0.0-3.0-7.0-4.0-8.0-5.0-6.0-2.0-4.1-7.1-2.1-6.1-5.1-2.0-1.0	99	142781	161343
HG02004.verkko_filt_mat.fa:haplotype1-0000022_97828542_98235483_0	HG02004	161386	163156	8	8	0	0	7	1770	161815	160045	0-3-7-4-8-5-6-2-4-7-2-6-5-2-1	0.0-3.0-7.0-4.0-8.0-5.0-6.0-2.0-4.1-7.1-2.1-6.1-5.1-2.0-1.0	99	161287	163057
HG02004.verkko_filt_mat.fa:haplotype1-0000022_97828542_98235483_0	HG02004	163100	176204	5	78	0	0	77	13104	174919	161815	0-3-7-4-8-5-6-2-4-7-2-6-5-2-1	0.0-3.0-7.0-4.0-8.0-5.0-6.0-2.0-4.1-7.1-2.1-6.1-5.1-2.0-1.0	99	163001	176105
HG02004.verkko_filt_mat.fa:haplotype1-0000022_97828542_98235483_0	HG02004	176148	178892	6	24	0	0	21	2744	177663	174919	0-3-7-4-8-5-6-2-4-7-2-6-5-2-1	0.0-3.0-7.0-4.0-8.0-5.0-6.0-2.0-4.1-7.1-2.1-6.1-5.1-2.0-1.0	99	176049	178793
HG02004.verkko_filt_mat.fa:haplotype1-0000022_97828542_98235483_0	HG02004	179558	210088	2	172	0	1	170	30530	208193	177663	0-3-7-4-8-5-6-2-4-7-2-6-5-2-1	0.0-3.0-7.0-4.0-8.0-5.0-6.0-2.0-4.1-7.1-2.1-6.1-5.1-2.0-1.0	99	179459	209989
HG02004.verkko_filt_mat.fa:haplotype1-0000022_97828542_98235483_0	HG02004	212339	223889	4	96	1	58	4	11550	219743	208193	0-3-7-4-8-5-6-2-4-7-2-6-5-2-1	0.0-3.0-7.0-4.0-8.0-5.0-6.0-2.0-4.1-7.1-2.1-6.1-5.1-2.0-1.0	99	212240	223790
HG02004.verkko_filt_mat.fa:haplotype1-0000022_97828542_98235483_0	HG02004	224956	228251	7	17	1	16	0	3295	223038	219743	0-3-7-4-8-5-6-2-4-7-2-6-5-2-1	0.0-3.0-7.0-4.0-8.0-5.0-6.0-2.0-4.1-7.1-2.1-6.1-5.1-2.0-1.0	99	224857	228152
HG02004.verkko_filt_mat.fa:haplotype1-0000022_97828542_98235483_0	HG02004	229713	260547	2	172	1	170	0	30834	253872	223038	0-3-7-4-8-5-6-2-4-7-2-6-5-2-1	0.0-3.0-7.0-4.0-8.0-5.0-6.0-2.0-4.1-7.1-2.1-6.1-5.1-2.0-1.0	99	229614	260448
HG02004.verkko_filt_mat.fa:haplotype1-0000022_97828542_98235483_0	HG02004	260923	263667	6	24	1	21	0	2744	256616	253872	0-3-7-4-8-5-6-2-4-7-2-6-5-2-1	0.0-3.0-7.0-4.0-8.0-5.0-6.0-2.0-4.1-7.1-2.1-6.1-5.1-2.0-1.0	99	260824	263568
HG02004.verkko_filt_mat.fa:haplotype1-0000022_97828542_98235483_0	HG02004	263611	275739	5	78	1	77	5	12128	268744	256616	0-3-7-4-8-5-6-2-4-7-2-6-5-2-1	0.0-3.0-7.0-4.0-8.0-5.0-6.0-2.0-4.1-7.1-2.1-6.1-5.1-2.0-1.0	99	263512	275640
HG02004.verkko_filt_mat.fa:haplotype1-0000022_97828542_98235483_0	HG02004	276705	304620	2	172	0	15	171	27915	296659	268744	0-3-7-4-8-5-6-2-4-7-2-6-5-2-1	0.0-3.0-7.0-4.0-8.0-5.0-6.0-2.0-4.1-7.1-2.1-6.1-5.1-2.0-1.0	99	276606	304521
HG02004.verkko_filt_mat.fa:haplotype1-0000022_97828542_98235483_0	HG02004	304564	406997	1	612	0	0	606	102433	399092	296659	0-3-7-4-8-5-6-2-4-7-2-6-5-2-1	0.0-3.0-7.0-4.0-8.0-5.0-6.0-2.0-4.1-7.1-2.1-6.1-5.1-2.0-1.0	99	304465	406898
HG02004.verkko_filt_pat.fa:haplotype2-0000813_139386576_140076845_1	HG02004	154	115548	0	671	0	0	670	115394	115394	0	0-3-7-4-8-5-6-2-4-7-2-6-5-2-4-7-2-6-5-2-4-7-2-6-5-2-4-7-2-5-6-2-1	0.0-3.0-7.0-4.0-8.0-5.0-6.0-2.0-4.1-7.1-2.1-6.1-5.1-2.0-4.1-7.1-2.1-6.1-5.1-2.0-4.1-7.1-2.1-6.1-5.1-2.0-4.1-7.1-2.1-5.0-6.0-2.0-1.0	154	0	115394
HG02004.verkko_filt_pat.fa:haplotype2-0000813_139386576_140076845_1	HG02004	115639	138474	3	132	0	0	131	22835	138229	115394	0-3-7-4-8-5-6-2-4-7-2-6-5-2-4-7-2-6-5-2-4-7-2-6-5-2-4-7-2-5-6-2-1	0.0-3.0-7.0-4.0-8.0-5.0-6.0-2.0-4.1-7.1-2.1-6.1-5.1-2.0-4.1-7.1-2.1-6.1-5.1-2.0-4.1-7.1-2.1-6.1-5.1-2.0-4.1-7.1-2.1-5.0-6.0-2.0-1.0	154	115485	138320
HG02004.verkko_filt_pat.fa:haplotype2-0000813_139386576_140076845_1	HG02004	139233	142529	7	17	0	0	16	3296	141525	138229	0-3-7-4-8-5-6-2-4-7-2-6-5-2-4-7-2-6-5-2-4-7-2-6-5-2-4-7-2-5-6-2-1	0.0-3.0-7.0-4.0-8.0-5.0-6.0-2.0-4.1-7.1-2.1-6.1-5.1-2.0-4.1-7.1-2.1-6.1-5.1-2.0-4.1-7.1-2.1-6.1-5.1-2.0-4.1-7.1-2.1-5.0-6.0-2.0-1.0	154	139079	142375
HG02004.verkko_filt_pat.fa:haplotype2-0000813_139386576_140076845_1	HG02004	142977	161533	4	96	0	0	95	18556	160081	141525	0-3-7-4-8-5-6-2-4-7-2-6-5-2-4-7-2-6-5-2-4-7-2-6-5-2-4-7-2-5-6-2-1	0.0-3.0-7.0-4.0-8.0-5.0-6.0-2.0-4.1-7.1-2.1-6.1-5.1-2.0-4.1-7.1-2.1-6.1-5.1-2.0-4.1-7.1-2.1-6.1-5.1-2.0-4.1-7.1-2.1-5.0-6.0-2.0-1.0	154	142823	161379
HG02004.verkko_filt_pat.fa:haplotype2-0000813_139386576_140076845_1	HG02004	161477	163247	8	8	0	0	7	1770	161851	160081	0-3-7-4-8-5-6-2-4-7-2-6-5-2-4-7-2-6-5-2-4-7-2-6-5-2-4-7-2-5-6-2-1	0.0-3.0-7.0-4.0-8.0-5.0-6.0-2.0-4.1-7.1-2.1-6.1-5.1-2.0-4.1-7.1-2.1-6.1-5.1-2.0-4.1-7.1-2.1-6.1-5.1-2.0-4.1-7.1-2.1-5.0-6.0-2.0-1.0	154	161323	163093
HG02004.verkko_filt_pat.fa:haplotype2-0000813_139386576_140076845_1	HG02004	163191	175855	5	78	0	0	76	12664	174515	161851	0-3-7-4-8-5-6-2-4-7-2-6-5-2-4-7-2-6-5-2-4-7-2-6-5-2-4-7-2-5-6-2-1	0.0-3.0-7.0-4.0-8.0-5.0-6.0-2.0-4.1-7.1-2.1-6.1-5.1-2.0-4.1-7.1-2.1-6.1-5.1-2.0-4.1-7.1-2.1-6.1-5.1-2.0-4.1-7.1-2.1-5.0-6.0-2.0-1.0	154	163037	175701
HG02004.verkko_filt_pat.fa:haplotype2-0000813_139386576_140076845_1	HG02004	176239	178983	6	24	0	0	21	2744	177259	174515	0-3-7-4-8-5-6-2-4-7-2-6-5-2-4-7-2-6-5-2-4-7-2-6-5-2-4-7-2-5-6-2-1	0.0-3.0-7.0-4.0-8.0-5.0-6.0-2.0-4.1-7.1-2.1-6.1-5.1-2.0-4.1-7.1-2.1-6.1-5.1-2.0-4.1-7.1-2.1-6.1-5.1-2.0-4.1-7.1-2.1-5.0-6.0-2.0-1.0	154	176085	178829
HG02004.verkko_filt_pat.fa:haplotype2-0000813_139386576_140076845_1	HG02004	179341	210182	2	172	0	0	170	30841	208100	177259	0-3-7-4-8-5-6-2-4-7-2-6-5-2-4-7-2-6-5-2-4-7-2-6-5-2-4-7-2-5-6-2-1	0.0-3.0-7.0-4.0-8.0-5.0-6.0-2.0-4.1-7.1-2.1-6.1-5.1-2.0-4.1-7.1-2.1-6.1-5.1-2.0-4.1-7.1-2.1-6.1-5.1-2.0-4.1-7.1-2.1-5.0-6.0-2.0-1.0	154	179187	210028
HG02004.verkko_filt_pat.fa:haplotype2-0000813_139386576_140076845_1	HG02004	212433	223977	4	96	1	58	4	11544	219644	208100	0-3-7-4-8-5-6-2-4-7-2-6-5-2-4-7-2-6-5-2-4-7-2-6-5-2-4-7-2-5-6-2-1	0.0-3.0-7.0-4.0-8.0-5.0-6.0-2.0-4.1-7.1-2.1-6.1-5.1-2.0-4.1-7.1-2.1-6.1-5.1-2.0-4.1-7.1-2.1-6.1-5.1-2.0-4.1-7.1-2.1-5.0-6.0-2.0-1.0	154	212279	223823
HG02004.verkko_filt_pat.fa:haplotype2-0000813_139386576_140076845_1	HG02004	225042	228337	7	17	1	16	0	3295	222939	219644	0-3-7-4-8-5-6-2-4-7-2-6-5-2-4-7-2-6-5-2-4-7-2-6-5-2-4-7-2-5-6-2-1	0.0-3.0-7.0-4.0-8.0-5.0-6.0-2.0-4.1-7.1-2.1-6.1-5.1-2.0-4.1-7.1-2.1-6.1-5.1-2.0-4.1-7.1-2.1-6.1-5.1-2.0-4.1-7.1-2.1-5.0-6.0-2.0-1.0	154	224888	228183
HG02004.verkko_filt_pat.fa:haplotype2-0000813_139386576_140076845_1	HG02004	229799	260639	2	172	1	170	0	30840	253779	222939	0-3-7-4-8-5-6-2-4-7-2-6-5-2-4-7-2-6-5-2-4-7-2-6-5-2-4-7-2-5-6-2-1	0.0-3.0-7.0-4.0-8.0-5.0-6.0-2.0-4.1-7.1-2.1-6.1-5.1-2.0-4.1-7.1-2.1-6.1-5.1-2.0-4.1-7.1-2.1-6.1-5.1-2.0-4.1-7.1-2.1-5.0-6.0-2.0-1.0	154	229645	260485
HG02004.verkko_filt_pat.fa:haplotype2-0000813_139386576_140076845_1	HG02004	260997	263741	6	24	1	21	0	2744	256523	253779	0-3-7-4-8-5-6-2-4-7-2-6-5-2-4-7-2-6-5-2-4-7-2-6-5-2-4-7-2-5-6-2-1	0.0-3.0-7.0-4.0-8.0-5.0-6.0-2.0-4.1-7.1-2.1-6.1-5.1-2.0-4.1-7.1-2.1-6.1-5.1-2.0-4.1-7.1-2.1-6.1-5.1-2.0-4.1-7.1-2.1-5.0-6.0-2.0-1.0	154	260843	263587
HG02004.verkko_filt_pat.fa:haplotype2-0000813_139386576_140076845_1	HG02004	264125	275813	5	78	1	76	5	11688	268211	256523	0-3-7-4-8-5-6-2-4-7-2-6-5-2-4-7-2-6-5-2-4-7-2-6-5-2-4-7-2-5-6-2-1	0.0-3.0-7.0-4.0-8.0-5.0-6.0-2.0-4.1-7.1-2.1-6.1-5.1-2.0-4.1-7.1-2.1-6.1-5.1-2.0-4.1-7.1-2.1-6.1-5.1-2.0-4.1-7.1-2.1-5.0-6.0-2.0-1.0	154	263971	275659
HG02004.verkko_filt_pat.fa:haplotype2-0000813_139386576_140076845_1	HG02004	276779	304314	2	172	0	15	170	27535	295746	268211	0-3-7-4-8-5-6-2-4-7-2-6-5-2-4-7-2-6-5-2-4-7-2-6-5-2-4-7-2-5-6-2-1	0.0-3.0-7.0-4.0-8.0-5.0-6.0-2.0-4.1-7.1-2.1-6.1-5.1-2.0-4.1-7.1-2.1-6.1-5.1-2.0-4.1-7.1-2.1-6.1-5.1-2.0-4.1-7.1-2.1-5.0-6.0-2.0-1.0	154	276625	304160
HG02004.verkko_filt_pat.fa:haplotype2-0000813_139386576_140076845_1	HG02004	306565	318114	4	96	1	58	4	11549	307295	295746	0-3-7-4-8-5-6-2-4-7-2-6-5-2-4-7-2-6-5-2-4-7-2-6-5-2-4-7-2-5-6-2-1	0.0-3.0-7.0-4.0-8.0-5.0-6.0-2.0-4.1-7.1-2.1-6.1-5.1-2.0-4.1-7.1-2.1-6.1-5.1-2.0-4.1-7.1-2.1-6.1-5.1-2.0-4.1-7.1-2.1-5.0-6.0-2.0-1.0	154	306411	317960
HG02004.verkko_filt_pat.fa:haplotype2-0000813_139386576_140076845_1	HG02004	319179	322474	7	17	1	16	0	3295	310590	307295	0-3-7-4-8-5-6-2-4-7-2-6-5-2-4-7-2-6-5-2-4-7-2-6-5-2-4-7-2-5-6-2-1	0.0-3.0-7.0-4.0-8.0-5.0-6.0-2.0-4.1-7.1-2.1-6.1-5.1-2.0-4.1-7.1-2.1-6.1-5.1-2.0-4.1-7.1-2.1-6.1-5.1-2.0-4.1-7.1-2.1-5.0-6.0-2.0-1.0	154	319025	322320
HG02004.verkko_filt_pat.fa:haplotype2-0000813_139386576_140076845_1	HG02004	323936	354776	2	172	1	170	0	30840	341430	310590	0-3-7-4-8-5-6-2-4-7-2-6-5-2-4-7-2-6-5-2-4-7-2-6-5-2-4-7-2-5-6-2-1	0.0-3.0-7.0-4.0-8.0-5.0-6.0-2.0-4.1-7.1-2.1-6.1-5.1-2.0-4.1-7.1-2.1-6.1-5.1-2.0-4.1-7.1-2.1-6.1-5.1-2.0-4.1-7.1-2.1-5.0-6.0-2.0-1.0	154	323782	354622
HG02004.verkko_filt_pat.fa:haplotype2-0000813_139386576_140076845_1	HG02004	355134	357878	6	24	1	21	0	2744	344174	341430	0-3-7-4-8-5-6-2-4-7-2-6-5-2-4-7-2-6-5-2-4-7-2-6-5-2-4-7-2-5-6-2-1	0.0-3.0-7.0-4.0-8.0-5.0-6.0-2.0-4.1-7.1-2.1-6.1-5.1-2.0-4.1-7.1-2.1-6.1-5.1-2.0-4.1-7.1-2.1-6.1-5.1-2.0-4.1-7.1-2.1-5.0-6.0-2.0-1.0	154	354980	357724
HG02004.verkko_filt_pat.fa:haplotype2-0000813_139386576_140076845_1	HG02004	358262	369950	5	78	1	76	5	11688	355862	344174	0-3-7-4-8-5-6-2-4-7-2-6-5-2-4-7-2-6-5-2-4-7-2-6-5-2-4-7-2-5-6-2-1	0.0-3.0-7.0-4.0-8.0-5.0-6.0-2.0-4.1-7.1-2.1-6.1-5.1-2.0-4.1-7.1-2.1-6.1-5.1-2.0-4.1-7.1-2.1-6.1-5.1-2.0-4.1-7.1-2.1-5.0-6.0-2.0-1.0	154	358108	369796
HG02004.verkko_filt_pat.fa:haplotype2-0000813_139386576_140076845_1	HG02004	370916	398450	2	172	0	15	170	27534	383396	355862	0-3-7-4-8-5-6-2-4-7-2-6-5-2-4-7-2-6-5-2-4-7-2-6-5-2-4-7-2-5-6-2-1	0.0-3.0-7.0-4.0-8.0-5.0-6.0-2.0-4.1-7.1-2.1-6.1-5.1-2.0-4.1-7.1-2.1-6.1-5.1-2.0-4.1-7.1-2.1-6.1-5.1-2.0-4.1-7.1-2.1-5.0-6.0-2.0-1.0	154	370762	398296
HG02004.verkko_filt_pat.fa:haplotype2-0000813_139386576_140076845_1	HG02004	400701	412246	4	96	1	58	4	11545	394941	383396	0-3-7-4-8-5-6-2-4-7-2-6-5-2-4-7-2-6-5-2-4-7-2-6-5-2-4-7-2-5-6-2-1	0.0-3.0-7.0-4.0-8.0-5.0-6.0-2.0-4.1-7.1-2.1-6.1-5.1-2.0-4.1-7.1-2.1-6.1-5.1-2.0-4.1-7.1-2.1-6.1-5.1-2.0-4.1-7.1-2.1-5.0-6.0-2.0-1.0	154	400547	412092
HG02004.verkko_filt_pat.fa:haplotype2-0000813_139386576_140076845_1	HG02004	413311	416606	7	17	1	16	0	3295	398236	394941	0-3-7-4-8-5-6-2-4-7-2-6-5-2-4-7-2-6-5-2-4-7-2-6-5-2-4-7-2-5-6-2-1	0.0-3.0-7.0-4.0-8.0-5.0-6.0-2.0-4.1-7.1-2.1-6.1-5.1-2.0-4.1-7.1-2.1-6.1-5.1-2.0-4.1-7.1-2.1-6.1-5.1-2.0-4.1-7.1-2.1-5.0-6.0-2.0-1.0	154	413157	416452
HG02004.verkko_filt_pat.fa:haplotype2-0000813_139386576_140076845_1	HG02004	418068	448910	2	172	1	170	0	30842	429078	398236	0-3-7-4-8-5-6-2-4-7-2-6-5-2-4-7-2-6-5-2-4-7-2-6-5-2-4-7-2-5-6-2-1	0.0-3.0-7.0-4.0-8.0-5.0-6.0-2.0-4.1-7.1-2.1-6.1-5.1-2.0-4.1-7.1-2.1-6.1-5.1-2.0-4.1-7.1-2.1-6.1-5.1-2.0-4.1-7.1-2.1-5.0-6.0-2.0-1.0	154	417914	448756
HG02004.verkko_filt_pat.fa:haplotype2-0000813_139386576_140076845_1	HG02004	449268	452012	6	24	1	21	0	2744	431822	429078	0-3-7-4-8-5-6-2-4-7-2-6-5-2-4-7-2-6-5-2-4-7-2-6-5-2-4-7-2-5-6-2-1	0.0-3.0-7.0-4.0-8.0-5.0-6.0-2.0-4.1-7.1-2.1-6.1-5.1-2.0-4.1-7.1-2.1-6.1-5.1-2.0-4.1-7.1-2.1-6.1-5.1-2.0-4.1-7.1-2.1-5.0-6.0-2.0-1.0	154	449114	451858
HG02004.verkko_filt_pat.fa:haplotype2-0000813_139386576_140076845_1	HG02004	451956	464084	5	78	1	77	5	12128	443950	431822	0-3-7-4-8-5-6-2-4-7-2-6-5-2-4-7-2-6-5-2-4-7-2-6-5-2-4-7-2-5-6-2-1	0.0-3.0-7.0-4.0-8.0-5.0-6.0-2.0-4.1-7.1-2.1-6.1-5.1-2.0-4.1-7.1-2.1-6.1-5.1-2.0-4.1-7.1-2.1-6.1-5.1-2.0-4.1-7.1-2.1-5.0-6.0-2.0-1.0	154	451802	463930
HG02004.verkko_filt_pat.fa:haplotype2-0000813_139386576_140076845_1	HG02004	465050	492236	2	172	0	15	167	27186	471136	443950	0-3-7-4-8-5-6-2-4-7-2-6-5-2-4-7-2-6-5-2-4-7-2-6-5-2-4-7-2-5-6-2-1	0.0-3.0-7.0-4.0-8.0-5.0-6.0-2.0-4.1-7.1-2.1-6.1-5.1-2.0-4.1-7.1-2.1-6.1-5.1-2.0-4.1-7.1-2.1-6.1-5.1-2.0-4.1-7.1-2.1-5.0-6.0-2.0-1.0	154	464896	492082
HG02004.verkko_filt_pat.fa:haplotype2-0000813_139386576_140076845_1	HG02004	494828	506374	4	96	1	58	4	11546	482682	471136	0-3-7-4-8-5-6-2-4-7-2-6-5-2-4-7-2-6-5-2-4-7-2-6-5-2-4-7-2-5-6-2-1	0.0-3.0-7.0-4.0-8.0-5.0-6.0-2.0-4.1-7.1-2.1-6.1-5.1-2.0-4.1-7.1-2.1-6.1-5.1-2.0-4.1-7.1-2.1-6.1-5.1-2.0-4.1-7.1-2.1-5.0-6.0-2.0-1.0	154	494674	506220
HG02004.verkko_filt_pat.fa:haplotype2-0000813_139386576_140076845_1	HG02004	507441	510736	7	17	1	16	0	3295	485977	482682	0-3-7-4-8-5-6-2-4-7-2-6-5-2-4-7-2-6-5-2-4-7-2-6-5-2-4-7-2-5-6-2-1	0.0-3.0-7.0-4.0-8.0-5.0-6.0-2.0-4.1-7.1-2.1-6.1-5.1-2.0-4.1-7.1-2.1-6.1-5.1-2.0-4.1-7.1-2.1-6.1-5.1-2.0-4.1-7.1-2.1-5.0-6.0-2.0-1.0	154	507287	510582
HG02004.verkko_filt_pat.fa:haplotype2-0000813_139386576_140076845_1	HG02004	512198	539732	2	172	1	170	15	27534	513511	485977	0-3-7-4-8-5-6-2-4-7-2-6-5-2-4-7-2-6-5-2-4-7-2-6-5-2-4-7-2-5-6-2-1	0.0-3.0-7.0-4.0-8.0-5.0-6.0-2.0-4.1-7.1-2.1-6.1-5.1-2.0-4.1-7.1-2.1-6.1-5.1-2.0-4.1-7.1-2.1-6.1-5.1-2.0-4.1-7.1-2.1-5.0-6.0-2.0-1.0	154	512044	539578
HG02004.verkko_filt_pat.fa:haplotype2-0000813_139386576_140076845_1	HG02004	540698	552826	5	78	0	5	77	12128	525639	513511	0-3-7-4-8-5-6-2-4-7-2-6-5-2-4-7-2-6-5-2-4-7-2-6-5-2-4-7-2-5-6-2-1	0.0-3.0-7.0-4.0-8.0-5.0-6.0-2.0-4.1-7.1-2.1-6.1-5.1-2.0-4.1-7.1-2.1-6.1-5.1-2.0-4.1-7.1-2.1-6.1-5.1-2.0-4.1-7.1-2.1-5.0-6.0-2.0-1.0	154	540544	552672
HG02004.verkko_filt_pat.fa:haplotype2-0000813_139386576_140076845_1	HG02004	552770	555514	6	24	0	0	21	2744	528383	525639	0-3-7-4-8-5-6-2-4-7-2-6-5-2-4-7-2-6-5-2-4-7-2-6-5-2-4-7-2-5-6-2-1	0.0-3.0-7.0-4.0-8.0-5.0-6.0-2.0-4.1-7.1-2.1-6.1-5.1-2.0-4.1-7.1-2.1-6.1-5.1-2.0-4.1-7.1-2.1-6.1-5.1-2.0-4.1-7.1-2.1-5.0-6.0-2.0-1.0	154	552616	555360
HG02004.verkko_filt_pat.fa:haplotype2-0000813_139386576_140076845_1	HG02004	555872	587086	2	172	0	0	171	31214	559597	528383	0-3-7-4-8-5-6-2-4-7-2-6-5-2-4-7-2-6-5-2-4-7-2-6-5-2-4-7-2-5-6-2-1	0.0-3.0-7.0-4.0-8.0-5.0-6.0-2.0-4.1-7.1-2.1-6.1-5.1-2.0-4.1-7.1-2.1-6.1-5.1-2.0-4.1-7.1-2.1-6.1-5.1-2.0-4.1-7.1-2.1-5.0-6.0-2.0-1.0	154	555718	586932
HG02004.verkko_filt_pat.fa:haplotype2-0000813_139386576_140076845_1	HG02004	587030	690253	1	612	0	0	611	103223	662820	559597	0-3-7-4-8-5-6-2-4-7-2-6-5-2-4-7-2-6-5-2-4-7-2-6-5-2-4-7-2-5-6-2-1	0.0-3.0-7.0-4.0-8.0-5.0-6.0-2.0-4.1-7.1-2.1-6.1-5.1-2.0-4.1-7.1-2.1-6.1-5.1-2.0-4.1-7.1-2.1-6.1-5.1-2.0-4.1-7.1-2.1-5.0-6.0-2.0-1.0	154	586876	690099
HG02055#2#JAHEPJ010000017.1_24870122_25298560_1	HG02055	154	115477	0	671	0	0	670	115323	115323	0	0-3-7-4-8-5-6-2-4-0-3-7-4-8-5-6-2-1	0.0-3.0-7.0-4.0-8.0-5.0-6.0-2.0-4.1-0.0-3.0-7.0-4.0-8.0-5.0-6.0-2.0-1.0	154	0	115323
HG02055#2#JAHEPJ010000017.1_24870122_25298560_1	HG02055	115568	138400	3	132	0	0	131	22832	138155	115323	0-3-7-4-8-5-6-2-4-0-3-7-4-8-5-6-2-1	0.0-3.0-7.0-4.0-8.0-5.0-6.0-2.0-4.1-0.0-3.0-7.0-4.0-8.0-5.0-6.0-2.0-1.0	154	115414	138246
HG02055#2#JAHEPJ010000017.1_24870122_25298560_1	HG02055	139159	142455	7	17	0	0	16	3296	141451	138155	0-3-7-4-8-5-6-2-4-0-3-7-4-8-5-6-2-1	0.0-3.0-7.0-4.0-8.0-5.0-6.0-2.0-4.1-0.0-3.0-7.0-4.0-8.0-5.0-6.0-2.0-1.0	154	139005	142301
HG02055#2#JAHEPJ010000017.1_24870122_25298560_1	HG02055	142903	161474	4	96	0	0	95	18571	160022	141451	0-3-7-4-8-5-6-2-4-0-3-7-4-8-5-6-2-1	0.0-3.0-7.0-4.0-8.0-5.0-6.0-2.0-4.1-0.0-3.0-7.0-4.0-8.0-5.0-6.0-2.0-1.0	154	142749	161320
HG02055#2#JAHEPJ010000017.1_24870122_25298560_1	HG02055	161418	163188	8	8	0	0	7	1770	161792	160022	0-3-7-4-8-5-6-2-4-0-3-7-4-8-5-6-2-1	0.0-3.0-7.0-4.0-8.0-5.0-6.0-2.0-4.1-0.0-3.0-7.0-4.0-8.0-5.0-6.0-2.0-1.0	154	161264	163034
HG02055#2#JAHEPJ010000017.1_24870122_25298560_1	HG02055	163132	176236	5	78	0	0	77	13104	174896	161792	0-3-7-4-8-5-6-2-4-0-3-7-4-8-5-6-2-1	0.0-3.0-7.0-4.0-8.0-5.0-6.0-2.0-4.1-0.0-3.0-7.0-4.0-8.0-5.0-6.0-2.0-1.0	154	162978	176082
HG02055#2#JAHEPJ010000017.1_24870122_25298560_1	HG02055	176180	178924	6	24	0	0	21	2744	177640	174896	0-3-7-4-8-5-6-2-4-0-3-7-4-8-5-6-2-1	0.0-3.0-7.0-4.0-8.0-5.0-6.0-2.0-4.1-0.0-3.0-7.0-4.0-8.0-5.0-6.0-2.0-1.0	154	176026	178770
HG02055#2#JAHEPJ010000017.1_24870122_25298560_1	HG02055	179285	210496	2	172	0	0	171	31211	208851	177640	0-3-7-4-8-5-6-2-4-0-3-7-4-8-5-6-2-1	0.0-3.0-7.0-4.0-8.0-5.0-6.0-2.0-4.1-0.0-3.0-7.0-4.0-8.0-5.0-6.0-2.0-1.0	154	179131	210342
HG02055#2#JAHEPJ010000017.1_24870122_25298560_1	HG02055	212362	220842	4	96	1	58	22	8480	217331	208851	0-3-7-4-8-5-6-2-4-0-3-7-4-8-5-6-2-1	0.0-3.0-7.0-4.0-8.0-5.0-6.0-2.0-4.1-0.0-3.0-7.0-4.0-8.0-5.0-6.0-2.0-1.0	154	212208	220688
HG02055#2#JAHEPJ010000017.1_24870122_25298560_1	HG02055	221019	231226	0	671	0	603	670	10207	227538	217331	0-3-7-4-8-5-6-2-4-0-3-7-4-8-5-6-2-1	0.0-3.0-7.0-4.0-8.0-5.0-6.0-2.0-4.1-0.0-3.0-7.0-4.0-8.0-5.0-6.0-2.0-1.0	154	220865	231072
HG02055#2#JAHEPJ010000017.1_24870122_25298560_1	HG02055	231317	254149	3	132	0	0	131	22832	250370	227538	0-3-7-4-8-5-6-2-4-0-3-7-4-8-5-6-2-1	0.0-3.0-7.0-4.0-8.0-5.0-6.0-2.0-4.1-0.0-3.0-7.0-4.0-8.0-5.0-6.0-2.0-1.0	154	231163	253995
HG02055#2#JAHEPJ010000017.1_24870122_25298560_1	HG02055	254908	258204	7	17	0	0	16	3296	253666	250370	0-3-7-4-8-5-6-2-4-0-3-7-4-8-5-6-2-1	0.0-3.0-7.0-4.0-8.0-5.0-6.0-2.0-4.1-0.0-3.0-7.0-4.0-8.0-5.0-6.0-2.0-1.0	154	254754	258050
HG02055#2#JAHEPJ010000017.1_24870122_25298560_1	HG02055	258652	277223	4	96	0	0	95	18571	272237	253666	0-3-7-4-8-5-6-2-4-0-3-7-4-8-5-6-2-1	0.0-3.0-7.0-4.0-8.0-5.0-6.0-2.0-4.1-0.0-3.0-7.0-4.0-8.0-5.0-6.0-2.0-1.0	154	258498	277069
HG02055#2#JAHEPJ010000017.1_24870122_25298560_1	HG02055	277167	278937	8	8	0	0	7	1770	274007	272237	0-3-7-4-8-5-6-2-4-0-3-7-4-8-5-6-2-1	0.0-3.0-7.0-4.0-8.0-5.0-6.0-2.0-4.1-0.0-3.0-7.0-4.0-8.0-5.0-6.0-2.0-1.0	154	277013	278783
HG02055#2#JAHEPJ010000017.1_24870122_25298560_1	HG02055	278881	291985	5	78	0	0	77	13104	287111	274007	0-3-7-4-8-5-6-2-4-0-3-7-4-8-5-6-2-1	0.0-3.0-7.0-4.0-8.0-5.0-6.0-2.0-4.1-0.0-3.0-7.0-4.0-8.0-5.0-6.0-2.0-1.0	154	278727	291831
HG02055#2#JAHEPJ010000017.1_24870122_25298560_1	HG02055	291929	294673	6	24	0	0	21	2744	289855	287111	0-3-7-4-8-5-6-2-4-0-3-7-4-8-5-6-2-1	0.0-3.0-7.0-4.0-8.0-5.0-6.0-2.0-4.1-0.0-3.0-7.0-4.0-8.0-5.0-6.0-2.0-1.0	154	291775	294519
HG02055#2#JAHEPJ010000017.1_24870122_25298560_1	HG02055	295034	326257	2	172	0	0	171	31223	321078	289855	0-3-7-4-8-5-6-2-4-0-3-7-4-8-5-6-2-1	0.0-3.0-7.0-4.0-8.0-5.0-6.0-2.0-4.1-0.0-3.0-7.0-4.0-8.0-5.0-6.0-2.0-1.0	154	294880	326103
HG02055#2#JAHEPJ010000017.1_24870122_25298560_1	HG02055	326201	428376	1	612	0	0	605	102175	423253	321078	0-3-7-4-8-5-6-2-4-0-3-7-4-8-5-6-2-1	0.0-3.0-7.0-4.0-8.0-5.0-6.0-2.0-4.1-0.0-3.0-7.0-4.0-8.0-5.0-6.0-2.0-1.0	154	326047	428222
HG02071.verkko_filt_mat.fa:haplotype1-0000041_103610513_104018399_0	HG02071	99	115486	0	671	0	0	670	115387	115387	0	0-3-7-4-8-5-6-2-4-7-2-5-6-2-1	0.0-3.0-7.0-4.0-8.0-5.0-6.0-2.0-4.1-7.1-2.1-5.0-6.0-2.0-1.0	99	0	115387
HG02071.verkko_filt_mat.fa:haplotype1-0000041_103610513_104018399_0	HG02071	115577	138414	3	132	0	0	131	22837	138224	115387	0-3-7-4-8-5-6-2-4-7-2-5-6-2-1	0.0-3.0-7.0-4.0-8.0-5.0-6.0-2.0-4.1-7.1-2.1-5.0-6.0-2.0-1.0	99	115478	138315
HG02071.verkko_filt_mat.fa:haplotype1-0000041_103610513_104018399_0	HG02071	139173	142469	7	17	0	0	16	3296	141520	138224	0-3-7-4-8-5-6-2-4-7-2-5-6-2-1	0.0-3.0-7.0-4.0-8.0-5.0-6.0-2.0-4.1-7.1-2.1-5.0-6.0-2.0-1.0	99	139074	142370
HG02071.verkko_filt_mat.fa:haplotype1-0000041_103610513_104018399_0	HG02071	142917	161472	4	96	0	0	95	18555	160075	141520	0-3-7-4-8-5-6-2-4-7-2-5-6-2-1	0.0-3.0-7.0-4.0-8.0-5.0-6.0-2.0-4.1-7.1-2.1-5.0-6.0-2.0-1.0	99	142818	161373
HG02071.verkko_filt_mat.fa:haplotype1-0000041_103610513_104018399_0	HG02071	161416	162942	8	8	0	0	6	1526	161601	160075	0-3-7-4-8-5-6-2-4-7-2-5-6-2-1	0.0-3.0-7.0-4.0-8.0-5.0-6.0-2.0-4.1-7.1-2.1-5.0-6.0-2.0-1.0	99	161317	162843
HG02071.verkko_filt_mat.fa:haplotype1-0000041_103610513_104018399_0	HG02071	163130	176234	5	78	0	0	77	13104	174705	161601	0-3-7-4-8-5-6-2-4-7-2-5-6-2-1	0.0-3.0-7.0-4.0-8.0-5.0-6.0-2.0-4.1-7.1-2.1-5.0-6.0-2.0-1.0	99	163031	176135
HG02071.verkko_filt_mat.fa:haplotype1-0000041_103610513_104018399_0	HG02071	176178	178922	6	24	0	0	21	2744	177449	174705	0-3-7-4-8-5-6-2-4-7-2-5-6-2-1	0.0-3.0-7.0-4.0-8.0-5.0-6.0-2.0-4.1-7.1-2.1-5.0-6.0-2.0-1.0	99	176079	178823
HG02071.verkko_filt_mat.fa:haplotype1-0000041_103610513_104018399_0	HG02071	179280	210115	2	172	0	0	170	30835	208284	177449	0-3-7-4-8-5-6-2-4-7-2-5-6-2-1	0.0-3.0-7.0-4.0-8.0-5.0-6.0-2.0-4.1-7.1-2.1-5.0-6.0-2.0-1.0	99	179181	210016
HG02071.verkko_filt_mat.fa:haplotype1-0000041_103610513_104018399_0	HG02071	212366	223913	4	96	1	58	4	11547	219831	208284	0-3-7-4-8-5-6-2-4-7-2-5-6-2-1	0.0-3.0-7.0-4.0-8.0-5.0-6.0-2.0-4.1-7.1-2.1-5.0-6.0-2.0-1.0	99	212267	223814
HG02071.verkko_filt_mat.fa:haplotype1-0000041_103610513_104018399_0	HG02071	224978	228273	7	17	1	16	0	3295	223126	219831	0-3-7-4-8-5-6-2-4-7-2-5-6-2-1	0.0-3.0-7.0-4.0-8.0-5.0-6.0-2.0-4.1-7.1-2.1-5.0-6.0-2.0-1.0	99	224879	228174
HG02071.verkko_filt_mat.fa:haplotype1-0000041_103610513_104018399_0	HG02071	229735	257265	2	172	1	170	15	27530	250656	223126	0-3-7-4-8-5-6-2-4-7-2-5-6-2-1	0.0-3.0-7.0-4.0-8.0-5.0-6.0-2.0-4.1-7.1-2.1-5.0-6.0-2.0-1.0	99	229636	257166
HG02071.verkko_filt_mat.fa:haplotype1-0000041_103610513_104018399_0	HG02071	258231	269919	5	78	0	5	76	11688	262344	250656	0-3-7-4-8-5-6-2-4-7-2-5-6-2-1	0.0-3.0-7.0-4.0-8.0-5.0-6.0-2.0-4.1-7.1-2.1-5.0-6.0-2.0-1.0	99	258132	269820
HG02071.verkko_filt_mat.fa:haplotype1-0000041_103610513_104018399_0	HG02071	270526	273053	6	24	0	1	21	2527	264871	262344	0-3-7-4-8-5-6-2-4-7-2-5-6-2-1	0.0-3.0-7.0-4.0-8.0-5.0-6.0-2.0-4.1-7.1-2.1-5.0-6.0-2.0-1.0	99	270427	272954
HG02071.verkko_filt_mat.fa:haplotype1-0000041_103610513_104018399_0	HG02071	273411	304629	2	172	0	0	171	31218	296089	264871	0-3-7-4-8-5-6-2-4-7-2-5-6-2-1	0.0-3.0-7.0-4.0-8.0-5.0-6.0-2.0-4.1-7.1-2.1-5.0-6.0-2.0-1.0	99	273312	304530
HG02071.verkko_filt_mat.fa:haplotype1-0000041_103610513_104018399_0	HG02071	304573	407814	1	612	0	0	611	103241	399330	296089	0-3-7-4-8-5-6-2-4-7-2-5-6-2-1	0.0-3.0-7.0-4.0-8.0-5.0-6.0-2.0-4.1-7.1-2.1-5.0-6.0-2.0-1.0	99	304474	407715
HG02071.verkko_filt_pat.fa:haplotype2-0000736_102745972_103248026_0	HG02071	99	115493	0	671	0	0	670	115394	115394	0	0-3-7-4-8-5-6-2-4-7-2-6-5-2-4-7-2-6-5-2-1	0.0-3.0-7.0-4.0-8.0-5.0-6.0-2.0-4.1-7.1-2.1-6.1-5.1-2.0-4.1-7.1-2.1-6.1-5.1-2.0-1.0	99	0	115394
HG02071.verkko_filt_pat.fa:haplotype2-0000736_102745972_103248026_0	HG02071	115584	138421	3	132	0	0	131	22837	138231	115394	0-3-7-4-8-5-6-2-4-7-2-6-5-2-4-7-2-6-5-2-1	0.0-3.0-7.0-4.0-8.0-5.0-6.0-2.0-4.1-7.1-2.1-6.1-5.1-2.0-4.1-7.1-2.1-6.1-5.1-2.0-1.0	99	115485	138322
HG02071.verkko_filt_pat.fa:haplotype2-0000736_102745972_103248026_0	HG02071	139180	142476	7	17	0	0	16	3296	141527	138231	0-3-7-4-8-5-6-2-4-7-2-6-5-2-4-7-2-6-5-2-1	0.0-3.0-7.0-4.0-8.0-5.0-6.0-2.0-4.1-7.1-2.1-6.1-5.1-2.0-4.1-7.1-2.1-6.1-5.1-2.0-1.0	99	139081	142377
HG02071.verkko_filt_pat.fa:haplotype2-0000736_102745972_103248026_0	HG02071	142924	161479	4	96	0	0	95	18555	160082	141527	0-3-7-4-8-5-6-2-4-7-2-6-5-2-4-7-2-6-5-2-1	0.0-3.0-7.0-4.0-8.0-5.0-6.0-2.0-4.1-7.1-2.1-6.1-5.1-2.0-4.1-7.1-2.1-6.1-5.1-2.0-1.0	99	142825	161380
HG02071.verkko_filt_pat.fa:haplotype2-0000736_102745972_103248026_0	HG02071	161423	163193	8	8	0	0	7	1770	161852	160082	0-3-7-4-8-5-6-2-4-7-2-6-5-2-4-7-2-6-5-2-1	0.0-3.0-7.0-4.0-8.0-5.0-6.0-2.0-4.1-7.1-2.1-6.1-5.1-2.0-4.1-7.1-2.1-6.1-5.1-2.0-1.0	99	161324	163094
HG02071.verkko_filt_pat.fa:haplotype2-0000736_102745972_103248026_0	HG02071	163137	175801	5	78	0	0	76	12664	174516	161852	0-3-7-4-8-5-6-2-4-7-2-6-5-2-4-7-2-6-5-2-1	0.0-3.0-7.0-4.0-8.0-5.0-6.0-2.0-4.1-7.1-2.1-6.1-5.1-2.0-4.1-7.1-2.1-6.1-5.1-2.0-1.0	99	163038	175702
HG02071.verkko_filt_pat.fa:haplotype2-0000736_102745972_103248026_0	HG02071	176185	178929	6	24	0	0	21	2744	177260	174516	0-3-7-4-8-5-6-2-4-7-2-6-5-2-4-7-2-6-5-2-1	0.0-3.0-7.0-4.0-8.0-5.0-6.0-2.0-4.1-7.1-2.1-6.1-5.1-2.0-4.1-7.1-2.1-6.1-5.1-2.0-1.0	99	176086	178830
HG02071.verkko_filt_pat.fa:haplotype2-0000736_102745972_103248026_0	HG02071	179287	209785	2	172	0	0	167	30498	207758	177260	0-3-7-4-8-5-6-2-4-7-2-6-5-2-4-7-2-6-5-2-1	0.0-3.0-7.0-4.0-8.0-5.0-6.0-2.0-4.1-7.1-2.1-6.1-5.1-2.0-4.1-7.1-2.1-6.1-5.1-2.0-1.0	99	179188	209686
HG02071.verkko_filt_pat.fa:haplotype2-0000736_102745972_103248026_0	HG02071	212377	223921	4	96	1	58	4	11544	219302	207758	0-3-7-4-8-5-6-2-4-7-2-6-5-2-4-7-2-6-5-2-1	0.0-3.0-7.0-4.0-8.0-5.0-6.0-2.0-4.1-7.1-2.1-6.1-5.1-2.0-4.1-7.1-2.1-6.1-5.1-2.0-1.0	99	212278	223822
HG02071.verkko_filt_pat.fa:haplotype2-0000736_102745972_103248026_0	HG02071	224986	228281	7	17	1	16	0	3295	222597	219302	0-3-7-4-8-5-6-2-4-7-2-6-5-2-4-7-2-6-5-2-1	0.0-3.0-7.0-4.0-8.0-5.0-6.0-2.0-4.1-7.1-2.1-6.1-5.1-2.0-4.1-7.1-2.1-6.1-5.1-2.0-1.0	99	224887	228182
HG02071.verkko_filt_pat.fa:haplotype2-0000736_102745972_103248026_0	HG02071	229743	260583	2	172	1	170	0	30840	253437	222597	0-3-7-4-8-5-6-2-4-7-2-6-5-2-4-7-2-6-5-2-1	0.0-3.0-7.0-4.0-8.0-5.0-6.0-2.0-4.1-7.1-2.1-6.1-5.1-2.0-4.1-7.1-2.1-6.1-5.1-2.0-1.0	99	229644	260484
HG02071.verkko_filt_pat.fa:haplotype2-0000736_102745972_103248026_0	HG02071	260959	263703	6	24	1	21	0	2744	256181	253437	0-3-7-4-8-5-6-2-4-7-2-6-5-2-4-7-2-6-5-2-1	0.0-3.0-7.0-4.0-8.0-5.0-6.0-2.0-4.1-7.1-2.1-6.1-5.1-2.0-4.1-7.1-2.1-6.1-5.1-2.0-1.0	99	260860	263604
HG02071.verkko_filt_pat.fa:haplotype2-0000736_102745972_103248026_0	HG02071	263647	275775	5	78	1	77	5	12128	268309	256181	0-3-7-4-8-5-6-2-4-7-2-6-5-2-4-7-2-6-5-2-1	0.0-3.0-7.0-4.0-8.0-5.0-6.0-2.0-4.1-7.1-2.1-6.1-5.1-2.0-4.1-7.1-2.1-6.1-5.1-2.0-1.0	99	263548	275676
HG02071.verkko_filt_pat.fa:haplotype2-0000736_102745972_103248026_0	HG02071	276741	303931	2	172	0	15	167	27190	295499	268309	0-3-7-4-8-5-6-2-4-7-2-6-5-2-4-7-2-6-5-2-1	0.0-3.0-7.0-4.0-8.0-5.0-6.0-2.0-4.1-7.1-2.1-6.1-5.1-2.0-4.1-7.1-2.1-6.1-5.1-2.0-1.0	99	276642	303832
HG02071.verkko_filt_pat.fa:haplotype2-0000736_102745972_103248026_0	HG02071	306523	318079	4	96	1	58	4	11556	307055	295499	0-3-7-4-8-5-6-2-4-7-2-6-5-2-4-7-2-6-5-2-1	0.0-3.0-7.0-4.0-8.0-5.0-6.0-2.0-4.1-7.1-2.1-6.1-5.1-2.0-4.1-7.1-2.1-6.1-5.1-2.0-1.0	99	306424	317980
HG02071.verkko_filt_pat.fa:haplotype2-0000736_102745972_103248026_0	HG02071	319148	322443	7	17	1	16	0	3295	310350	307055	0-3-7-4-8-5-6-2-4-7-2-6-5-2-4-7-2-6-5-2-1	0.0-3.0-7.0-4.0-8.0-5.0-6.0-2.0-4.1-7.1-2.1-6.1-5.1-2.0-4.1-7.1-2.1-6.1-5.1-2.0-1.0	99	319049	322344
HG02071.verkko_filt_pat.fa:haplotype2-0000736_102745972_103248026_0	HG02071	323905	354747	2	172	1	170	0	30842	341192	310350	0-3-7-4-8-5-6-2-4-7-2-6-5-2-4-7-2-6-5-2-1	0.0-3.0-7.0-4.0-8.0-5.0-6.0-2.0-4.1-7.1-2.1-6.1-5.1-2.0-4.1-7.1-2.1-6.1-5.1-2.0-1.0	99	323806	354648
HG02071.verkko_filt_pat.fa:haplotype2-0000736_102745972_103248026_0	HG02071	355122	357866	6	24	1	21	0	2744	343936	341192	0-3-7-4-8-5-6-2-4-7-2-6-5-2-4-7-2-6-5-2-1	0.0-3.0-7.0-4.0-8.0-5.0-6.0-2.0-4.1-7.1-2.1-6.1-5.1-2.0-4.1-7.1-2.1-6.1-5.1-2.0-1.0	99	355023	357767
HG02071.verkko_filt_pat.fa:haplotype2-0000736_102745972_103248026_0	HG02071	357810	369938	5	78	1	77	5	12128	356064	343936	0-3-7-4-8-5-6-2-4-7-2-6-5-2-4-7-2-6-5-2-1	0.0-3.0-7.0-4.0-8.0-5.0-6.0-2.0-4.1-7.1-2.1-6.1-5.1-2.0-4.1-7.1-2.1-6.1-5.1-2.0-1.0	99	357711	369839
HG02071.verkko_filt_pat.fa:haplotype2-0000736_102745972_103248026_0	HG02071	370904	398824	2	172	0	15	171	27920	383984	356064	0-3-7-4-8-5-6-2-4-7-2-6-5-2-4-7-2-6-5-2-1	0.0-3.0-7.0-4.0-8.0-5.0-6.0-2.0-4.1-7.1-2.1-6.1-5.1-2.0-4.1-7.1-2.1-6.1-5.1-2.0-1.0	99	370805	398725
HG02071.verkko_filt_pat.fa:haplotype2-0000736_102745972_103248026_0	HG02071	398768	501982	1	612	0	0	611	103214	487198	383984	0-3-7-4-8-5-6-2-4-7-2-6-5-2-4-7-2-6-5-2-1	0.0-3.0-7.0-4.0-8.0-5.0-6.0-2.0-4.1-7.1-2.1-6.1-5.1-2.0-4.1-7.1-2.1-6.1-5.1-2.0-1.0	99	398669	501883
HG02080#1#JAHEOW010000048.1_16689583_17097287_0	HG02080	98	115419	0	671	0	0	670	115321	115321	0	0-3-7-4-8-5-6-2-4-7-2-6-5-2-1	0.0-3.0-7.0-4.0-8.0-5.0-6.0-2.0-4.1-7.1-2.1-6.1-5.1-2.0-1.0	98	0	115321
HG02080#1#JAHEOW010000048.1_16689583_17097287_0	HG02080	115510	138341	3	132	0	0	131	22831	138152	115321	0-3-7-4-8-5-6-2-4-7-2-6-5-2-1	0.0-3.0-7.0-4.0-8.0-5.0-6.0-2.0-4.1-7.1-2.1-6.1-5.1-2.0-1.0	98	115412	138243
HG02080#1#JAHEOW010000048.1_16689583_17097287_0	HG02080	139100	142395	7	17	0	0	16	3295	141447	138152	0-3-7-4-8-5-6-2-4-7-2-6-5-2-1	0.0-3.0-7.0-4.0-8.0-5.0-6.0-2.0-4.1-7.1-2.1-6.1-5.1-2.0-1.0	98	139002	142297
HG02080#1#JAHEOW010000048.1_16689583_17097287_0	HG02080	143186	161395	4	96	0	1	95	18209	159656	141447	0-3-7-4-8-5-6-2-4-7-2-6-5-2-1	0.0-3.0-7.0-4.0-8.0-5.0-6.0-2.0-4.1-7.1-2.1-6.1-5.1-2.0-1.0	98	143088	161297
HG02080#1#JAHEOW010000048.1_16689583_17097287_0	HG02080	161339	163109	8	8	0	0	7	1770	161426	159656	0-3-7-4-8-5-6-2-4-7-2-6-5-2-1	0.0-3.0-7.0-4.0-8.0-5.0-6.0-2.0-4.1-7.1-2.1-6.1-5.1-2.0-1.0	98	161241	163011
HG02080#1#JAHEOW010000048.1_16689583_17097287_0	HG02080	163053	176157	5	78	0	0	77	13104	174530	161426	0-3-7-4-8-5-6-2-4-7-2-6-5-2-1	0.0-3.0-7.0-4.0-8.0-5.0-6.0-2.0-4.1-7.1-2.1-6.1-5.1-2.0-1.0	98	162955	176059
HG02080#1#JAHEOW010000048.1_16689583_17097287_0	HG02080	176101	178420	6	24	0	0	17	2319	176849	174530	0-3-7-4-8-5-6-2-4-7-2-6-5-2-1	0.0-3.0-7.0-4.0-8.0-5.0-6.0-2.0-4.1-7.1-2.1-6.1-5.1-2.0-1.0	98	176003	178322
HG02080#1#JAHEOW010000048.1_16689583_17097287_0	HG02080	179204	210420	2	172	0	0	171	31216	208065	176849	0-3-7-4-8-5-6-2-4-7-2-6-5-2-1	0.0-3.0-7.0-4.0-8.0-5.0-6.0-2.0-4.1-7.1-2.1-6.1-5.1-2.0-1.0	98	179106	210322
HG02080#1#JAHEOW010000048.1_16689583_17097287_0	HG02080	212512	224087	4	96	1	57	1	11575	219640	208065	0-3-7-4-8-5-6-2-4-7-2-6-5-2-1	0.0-3.0-7.0-4.0-8.0-5.0-6.0-2.0-4.1-7.1-2.1-6.1-5.1-2.0-1.0	98	212414	223989
HG02080#1#JAHEOW010000048.1_16689583_17097287_0	HG02080	224878	228173	7	17	1	16	0	3295	222935	219640	0-3-7-4-8-5-6-2-4-7-2-6-5-2-1	0.0-3.0-7.0-4.0-8.0-5.0-6.0-2.0-4.1-7.1-2.1-6.1-5.1-2.0-1.0	98	224780	228075
HG02080#1#JAHEOW010000048.1_16689583_17097287_0	HG02080	229250	260463	2	172	1	171	0	31213	254148	222935	0-3-7-4-8-5-6-2-4-7-2-6-5-2-1	0.0-3.0-7.0-4.0-8.0-5.0-6.0-2.0-4.1-7.1-2.1-6.1-5.1-2.0-1.0	98	229152	260365
HG02080#1#JAHEOW010000048.1_16689583_17097287_0	HG02080	260407	263350	6	24	1	23	1	2943	257091	254148	0-3-7-4-8-5-6-2-4-7-2-6-5-2-1	0.0-3.0-7.0-4.0-8.0-5.0-6.0-2.0-4.1-7.1-2.1-6.1-5.1-2.0-1.0	98	260309	263252
HG02080#1#JAHEOW010000048.1_16689583_17097287_0	HG02080	263957	276172	5	78	1	76	3	12215	269306	257091	0-3-7-4-8-5-6-2-4-7-2-6-5-2-1	0.0-3.0-7.0-4.0-8.0-5.0-6.0-2.0-4.1-7.1-2.1-6.1-5.1-2.0-1.0	98	263859	276074
HG02080#1#JAHEOW010000048.1_16689583_17097287_0	HG02080	276611	304516	2	172	0	15	171	27905	297211	269306	0-3-7-4-8-5-6-2-4-7-2-6-5-2-1	0.0-3.0-7.0-4.0-8.0-5.0-6.0-2.0-4.1-7.1-2.1-6.1-5.1-2.0-1.0	98	276513	304418
HG02080#1#JAHEOW010000048.1_16689583_17097287_0	HG02080	304460	407632	1	612	0	0	611	103172	400383	297211	0-3-7-4-8-5-6-2-4-7-2-6-5-2-1	0.0-3.0-7.0-4.0-8.0-5.0-6.0-2.0-4.1-7.1-2.1-6.1-5.1-2.0-1.0	98	304362	407534
HG02080#2#JAHEOV010000017.1_16662177_17164189_0	HG02080	99	115482	0	671	0	0	670	115383	115383	0	0-3-7-4-8-5-6-2-4-7-2-5-6-2-4-7-2-5-6-2-1	0.0-3.0-7.0-4.0-8.0-5.0-6.0-2.0-4.1-7.1-2.1-5.0-6.0-2.0-4.1-7.1-2.1-5.0-6.0-2.0-1.0	99	0	115383
HG02080#2#JAHEOV010000017.1_16662177_17164189_0	HG02080	115573	138410	3	132	0	0	131	22837	138220	115383	0-3-7-4-8-5-6-2-4-7-2-5-6-2-4-7-2-5-6-2-1	0.0-3.0-7.0-4.0-8.0-5.0-6.0-2.0-4.1-7.1-2.1-5.0-6.0-2.0-4.1-7.1-2.1-5.0-6.0-2.0-1.0	99	115474	138311
HG02080#2#JAHEOV010000017.1_16662177_17164189_0	HG02080	139169	142465	7	17	0	0	16	3296	141516	138220	0-3-7-4-8-5-6-2-4-7-2-5-6-2-4-7-2-5-6-2-1	0.0-3.0-7.0-4.0-8.0-5.0-6.0-2.0-4.1-7.1-2.1-5.0-6.0-2.0-4.1-7.1-2.1-5.0-6.0-2.0-1.0	99	139070	142366
HG02080#2#JAHEOV010000017.1_16662177_17164189_0	HG02080	142913	161465	4	96	0	0	95	18552	160068	141516	0-3-7-4-8-5-6-2-4-7-2-5-6-2-4-7-2-5-6-2-1	0.0-3.0-7.0-4.0-8.0-5.0-6.0-2.0-4.1-7.1-2.1-5.0-6.0-2.0-4.1-7.1-2.1-5.0-6.0-2.0-1.0	99	142814	161366
HG02080#2#JAHEOV010000017.1_16662177_17164189_0	HG02080	161409	163179	8	8	0	0	7	1770	161838	160068	0-3-7-4-8-5-6-2-4-7-2-5-6-2-4-7-2-5-6-2-1	0.0-3.0-7.0-4.0-8.0-5.0-6.0-2.0-4.1-7.1-2.1-5.0-6.0-2.0-4.1-7.1-2.1-5.0-6.0-2.0-1.0	99	161310	163080
HG02080#2#JAHEOV010000017.1_16662177_17164189_0	HG02080	163123	176227	5	78	0	0	77	13104	174942	161838	0-3-7-4-8-5-6-2-4-7-2-5-6-2-4-7-2-5-6-2-1	0.0-3.0-7.0-4.0-8.0-5.0-6.0-2.0-4.1-7.1-2.1-5.0-6.0-2.0-4.1-7.1-2.1-5.0-6.0-2.0-1.0	99	163024	176128
HG02080#2#JAHEOV010000017.1_16662177_17164189_0	HG02080	176171	178915	6	24	0	0	21	2744	177686	174942	0-3-7-4-8-5-6-2-4-7-2-5-6-2-4-7-2-5-6-2-1	0.0-3.0-7.0-4.0-8.0-5.0-6.0-2.0-4.1-7.1-2.1-5.0-6.0-2.0-4.1-7.1-2.1-5.0-6.0-2.0-1.0	99	176072	178816
HG02080#2#JAHEOV010000017.1_16662177_17164189_0	HG02080	179274	210110	2	172	0	0	170	30836	208522	177686	0-3-7-4-8-5-6-2-4-7-2-5-6-2-4-7-2-5-6-2-1	0.0-3.0-7.0-4.0-8.0-5.0-6.0-2.0-4.1-7.1-2.1-5.0-6.0-2.0-4.1-7.1-2.1-5.0-6.0-2.0-1.0	99	179175	210011
HG02080#2#JAHEOV010000017.1_16662177_17164189_0	HG02080	212361	223909	4	96	1	58	4	11548	220070	208522	0-3-7-4-8-5-6-2-4-7-2-5-6-2-4-7-2-5-6-2-1	0.0-3.0-7.0-4.0-8.0-5.0-6.0-2.0-4.1-7.1-2.1-5.0-6.0-2.0-4.1-7.1-2.1-5.0-6.0-2.0-1.0	99	212262	223810
HG02080#2#JAHEOV010000017.1_16662177_17164189_0	HG02080	224976	228271	7	17	1	16	0	3295	223365	220070	0-3-7-4-8-5-6-2-4-7-2-5-6-2-4-7-2-5-6-2-1	0.0-3.0-7.0-4.0-8.0-5.0-6.0-2.0-4.1-7.1-2.1-5.0-6.0-2.0-4.1-7.1-2.1-5.0-6.0-2.0-1.0	99	224877	228172
HG02080#2#JAHEOV010000017.1_16662177_17164189_0	HG02080	229733	257263	2	172	1	170	15	27530	250895	223365	0-3-7-4-8-5-6-2-4-7-2-5-6-2-4-7-2-5-6-2-1	0.0-3.0-7.0-4.0-8.0-5.0-6.0-2.0-4.1-7.1-2.1-5.0-6.0-2.0-4.1-7.1-2.1-5.0-6.0-2.0-1.0	99	229634	257164
HG02080#2#JAHEOV010000017.1_16662177_17164189_0	HG02080	258229	270357	5	78	0	5	77	12128	263023	250895	0-3-7-4-8-5-6-2-4-7-2-5-6-2-4-7-2-5-6-2-1	0.0-3.0-7.0-4.0-8.0-5.0-6.0-2.0-4.1-7.1-2.1-5.0-6.0-2.0-4.1-7.1-2.1-5.0-6.0-2.0-1.0	99	258130	270258
HG02080#2#JAHEOV010000017.1_16662177_17164189_0	HG02080	270301	273045	6	24	0	0	21	2744	265767	263023	0-3-7-4-8-5-6-2-4-7-2-5-6-2-4-7-2-5-6-2-1	0.0-3.0-7.0-4.0-8.0-5.0-6.0-2.0-4.1-7.1-2.1-5.0-6.0-2.0-4.1-7.1-2.1-5.0-6.0-2.0-1.0	99	270202	272946
HG02080#2#JAHEOV010000017.1_16662177_17164189_0	HG02080	273404	303902	2	172	0	0	167	30498	296265	265767	0-3-7-4-8-5-6-2-4-7-2-5-6-2-4-7-2-5-6-2-1	0.0-3.0-7.0-4.0-8.0-5.0-6.0-2.0-4.1-7.1-2.1-5.0-6.0-2.0-4.1-7.1-2.1-5.0-6.0-2.0-1.0	99	273305	303803
HG02080#2#JAHEOV010000017.1_16662177_17164189_0	HG02080	306494	318039	4	96	1	58	4	11545	307810	296265	0-3-7-4-8-5-6-2-4-7-2-5-6-2-4-7-2-5-6-2-1	0.0-3.0-7.0-4.0-8.0-5.0-6.0-2.0-4.1-7.1-2.1-5.0-6.0-2.0-4.1-7.1-2.1-5.0-6.0-2.0-1.0	99	306395	317940
HG02080#2#JAHEOV010000017.1_16662177_17164189_0	HG02080	319106	322401	7	17	1	16	0	3295	311105	307810	0-3-7-4-8-5-6-2-4-7-2-5-6-2-4-7-2-5-6-2-1	0.0-3.0-7.0-4.0-8.0-5.0-6.0-2.0-4.1-7.1-2.1-5.0-6.0-2.0-4.1-7.1-2.1-5.0-6.0-2.0-1.0	99	319007	322302
HG02080#2#JAHEOV010000017.1_16662177_17164189_0	HG02080	324047	351391	2	172	1	168	15	27344	338449	311105	0-3-7-4-8-5-6-2-4-7-2-5-6-2-4-7-2-5-6-2-1	0.0-3.0-7.0-4.0-8.0-5.0-6.0-2.0-4.1-7.1-2.1-5.0-6.0-2.0-4.1-7.1-2.1-5.0-6.0-2.0-1.0	99	323948	351292
HG02080#2#JAHEOV010000017.1_16662177_17164189_0	HG02080	352357	364485	5	78	0	5	77	12128	350577	338449	0-3-7-4-8-5-6-2-4-7-2-5-6-2-4-7-2-5-6-2-1	0.0-3.0-7.0-4.0-8.0-5.0-6.0-2.0-4.1-7.1-2.1-5.0-6.0-2.0-4.1-7.1-2.1-5.0-6.0-2.0-1.0	99	352258	364386
HG02080#2#JAHEOV010000017.1_16662177_17164189_0	HG02080	364429	367173	6	24	0	0	21	2744	353321	350577	0-3-7-4-8-5-6-2-4-7-2-5-6-2-4-7-2-5-6-2-1	0.0-3.0-7.0-4.0-8.0-5.0-6.0-2.0-4.1-7.1-2.1-5.0-6.0-2.0-4.1-7.1-2.1-5.0-6.0-2.0-1.0	99	364330	367074
HG02080#2#JAHEOV010000017.1_16662177_17164189_0	HG02080	367550	398766	2	172	0	0	171	31216	384537	353321	0-3-7-4-8-5-6-2-4-7-2-5-6-2-4-7-2-5-6-2-1	0.0-3.0-7.0-4.0-8.0-5.0-6.0-2.0-4.1-7.1-2.1-5.0-6.0-2.0-4.1-7.1-2.1-5.0-6.0-2.0-1.0	99	367451	398667
HG02080#2#JAHEOV010000017.1_16662177_17164189_0	HG02080	398710	501940	1	612	0	0	611	103230	487767	384537	0-3-7-4-8-5-6-2-4-7-2-5-6-2-4-7-2-5-6-2-1	0.0-3.0-7.0-4.0-8.0-5.0-6.0-2.0-4.1-7.1-2.1-5.0-6.0-2.0-4.1-7.1-2.1-5.0-6.0-2.0-1.0	99	398611	501841
HG02109#1#JAHEPG010000026.1_16673035_17080816_0	HG02109	98	115458	0	671	0	0	670	115360	115360	0	0-3-7-4-8-5-6-2-4-7-2-6-5-2-1	0.0-3.0-7.0-4.0-8.0-5.0-6.0-2.0-4.1-7.1-2.1-6.1-5.1-2.0-1.0	98	0	115360
HG02109#1#JAHEPG010000026.1_16673035_17080816_0	HG02109	115549	138378	3	132	0	0	131	22829	138189	115360	0-3-7-4-8-5-6-2-4-7-2-6-5-2-1	0.0-3.0-7.0-4.0-8.0-5.0-6.0-2.0-4.1-7.1-2.1-6.1-5.1-2.0-1.0	98	115451	138280
HG02109#1#JAHEPG010000026.1_16673035_17080816_0	HG02109	139137	142432	7	17	0	0	16	3295	141484	138189	0-3-7-4-8-5-6-2-4-7-2-6-5-2-1	0.0-3.0-7.0-4.0-8.0-5.0-6.0-2.0-4.1-7.1-2.1-6.1-5.1-2.0-1.0	98	139039	142334
HG02109#1#JAHEPG010000026.1_16673035_17080816_0	HG02109	142880	161448	4	96	0	0	95	18568	160052	141484	0-3-7-4-8-5-6-2-4-7-2-6-5-2-1	0.0-3.0-7.0-4.0-8.0-5.0-6.0-2.0-4.1-7.1-2.1-6.1-5.1-2.0-1.0	98	142782	161350
HG02109#1#JAHEPG010000026.1_16673035_17080816_0	HG02109	161392	163162	8	8	0	0	7	1770	161822	160052	0-3-7-4-8-5-6-2-4-7-2-6-5-2-1	0.0-3.0-7.0-4.0-8.0-5.0-6.0-2.0-4.1-7.1-2.1-6.1-5.1-2.0-1.0	98	161294	163064
HG02109#1#JAHEPG010000026.1_16673035_17080816_0	HG02109	163106	176210	5	78	0	0	77	13104	174926	161822	0-3-7-4-8-5-6-2-4-7-2-6-5-2-1	0.0-3.0-7.0-4.0-8.0-5.0-6.0-2.0-4.1-7.1-2.1-6.1-5.1-2.0-1.0	98	163008	176112
HG02109#1#JAHEPG010000026.1_16673035_17080816_0	HG02109	176154	178898	6	24	0	0	21	2744	177670	174926	0-3-7-4-8-5-6-2-4-7-2-6-5-2-1	0.0-3.0-7.0-4.0-8.0-5.0-6.0-2.0-4.1-7.1-2.1-6.1-5.1-2.0-1.0	98	176056	178800
HG02109#1#JAHEPG010000026.1_16673035_17080816_0	HG02109	179257	210476	2	172	0	0	171	31219	208889	177670	0-3-7-4-8-5-6-2-4-7-2-6-5-2-1	0.0-3.0-7.0-4.0-8.0-5.0-6.0-2.0-4.1-7.1-2.1-6.1-5.1-2.0-1.0	98	179159	210378
HG02109#1#JAHEPG010000026.1_16673035_17080816_0	HG02109	212342	223887	4	96	1	58	4	11545	220434	208889	0-3-7-4-8-5-6-2-4-7-2-6-5-2-1	0.0-3.0-7.0-4.0-8.0-5.0-6.0-2.0-4.1-7.1-2.1-6.1-5.1-2.0-1.0	98	212244	223789
HG02109#1#JAHEPG010000026.1_16673035_17080816_0	HG02109	224950	228245	7	17	1	16	0	3295	223729	220434	0-3-7-4-8-5-6-2-4-7-2-6-5-2-1	0.0-3.0-7.0-4.0-8.0-5.0-6.0-2.0-4.1-7.1-2.1-6.1-5.1-2.0-1.0	98	224852	228147
HG02109#1#JAHEPG010000026.1_16673035_17080816_0	HG02109	229322	260534	2	172	1	171	0	31212	254941	223729	0-3-7-4-8-5-6-2-4-7-2-6-5-2-1	0.0-3.0-7.0-4.0-8.0-5.0-6.0-2.0-4.1-7.1-2.1-6.1-5.1-2.0-1.0	98	229224	260436
HG02109#1#JAHEPG010000026.1_16673035_17080816_0	HG02109	260893	263420	6	24	1	21	1	2527	257468	254941	0-3-7-4-8-5-6-2-4-7-2-6-5-2-1	0.0-3.0-7.0-4.0-8.0-5.0-6.0-2.0-4.1-7.1-2.1-6.1-5.1-2.0-1.0	98	260795	263322
HG02109#1#JAHEPG010000026.1_16673035_17080816_0	HG02109	264027	276242	5	78	1	76	3	12215	269683	257468	0-3-7-4-8-5-6-2-4-7-2-6-5-2-1	0.0-3.0-7.0-4.0-8.0-5.0-6.0-2.0-4.1-7.1-2.1-6.1-5.1-2.0-1.0	98	263929	276144
HG02109#1#JAHEPG010000026.1_16673035_17080816_0	HG02109	276681	304588	2	172	0	15	171	27907	297590	269683	0-3-7-4-8-5-6-2-4-7-2-6-5-2-1	0.0-3.0-7.0-4.0-8.0-5.0-6.0-2.0-4.1-7.1-2.1-6.1-5.1-2.0-1.0	98	276583	304490
HG02109#1#JAHEPG010000026.1_16673035_17080816_0	HG02109	304532	407709	1	612	0	0	611	103177	400767	297590	0-3-7-4-8-5-6-2-4-7-2-6-5-2-1	0.0-3.0-7.0-4.0-8.0-5.0-6.0-2.0-4.1-7.1-2.1-6.1-5.1-2.0-1.0	98	304434	407611
HG02109#2#JAHEPF010000078.1_16678387_16991144_0	HG02109	98	115474	0	671	0	0	670	115376	115376	0	0-3-7-4-8-5-6-2-1	0.0-3.0-7.0-4.0-8.0-5.0-6.0-2.0-1.0	98	0	115376
HG02109#2#JAHEPF010000078.1_16678387_16991144_0	HG02109	115565	138400	3	132	0	0	131	22835	138211	115376	0-3-7-4-8-5-6-2-1	0.0-3.0-7.0-4.0-8.0-5.0-6.0-2.0-1.0	98	115467	138302
HG02109#2#JAHEPF010000078.1_16678387_16991144_0	HG02109	139159	142454	7	17	0	0	16	3295	141506	138211	0-3-7-4-8-5-6-2-1	0.0-3.0-7.0-4.0-8.0-5.0-6.0-2.0-1.0	98	139061	142356
HG02109#2#JAHEPF010000078.1_16678387_16991144_0	HG02109	142902	161466	4	96	0	0	95	18564	160070	141506	0-3-7-4-8-5-6-2-1	0.0-3.0-7.0-4.0-8.0-5.0-6.0-2.0-1.0	98	142804	161368
HG02109#2#JAHEPF010000078.1_16678387_16991144_0	HG02109	161410	163180	8	8	0	0	7	1770	161840	160070	0-3-7-4-8-5-6-2-1	0.0-3.0-7.0-4.0-8.0-5.0-6.0-2.0-1.0	98	161312	163082
HG02109#2#JAHEPF010000078.1_16678387_16991144_0	HG02109	163124	175788	5	78	0	0	76	12664	174504	161840	0-3-7-4-8-5-6-2-1	0.0-3.0-7.0-4.0-8.0-5.0-6.0-2.0-1.0	98	163026	175690
HG02109#2#JAHEPF010000078.1_16678387_16991144_0	HG02109	176172	178916	6	24	0	0	21	2744	177248	174504	0-3-7-4-8-5-6-2-1	0.0-3.0-7.0-4.0-8.0-5.0-6.0-2.0-1.0	98	176074	178818
HG02109#2#JAHEPF010000078.1_16678387_16991144_0	HG02109	179277	210492	2	172	0	0	171	31215	208463	177248	0-3-7-4-8-5-6-2-1	0.0-3.0-7.0-4.0-8.0-5.0-6.0-2.0-1.0	98	179179	210394
HG02109#2#JAHEPF010000078.1_16678387_16991144_0	HG02109	210436	312813	1	612	0	0	606	102377	310840	208463	0-3-7-4-8-5-6-2-1	0.0-3.0-7.0-4.0-8.0-5.0-6.0-2.0-1.0	98	210338	312715
HG02145#1#JAHKSG010000134.1_2102465_2647653_1	HG02145	154	115532	0	671	0	0	670	115378	115378	0	0-3-7-4-8-5-6-2-4-0-3-7-4-8-5-6-2-4-0-3-7-4-8-5-6-2-1	0.0-3.0-7.0-4.0-8.0-5.0-6.0-2.0-4.1-0.0-3.0-7.0-4.0-8.0-5.0-6.0-2.0-4.1-0.0-3.0-7.0-4.0-8.0-5.0-6.0-2.0-1.0	154	0	115378
HG02145#1#JAHKSG010000134.1_2102465_2647653_1	HG02145	115623	138455	3	132	0	0	131	22832	138210	115378	0-3-7-4-8-5-6-2-4-0-3-7-4-8-5-6-2-4-0-3-7-4-8-5-6-2-1	0.0-3.0-7.0-4.0-8.0-5.0-6.0-2.0-4.1-0.0-3.0-7.0-4.0-8.0-5.0-6.0-2.0-4.1-0.0-3.0-7.0-4.0-8.0-5.0-6.0-2.0-1.0	154	115469	138301
HG02145#1#JAHKSG010000134.1_2102465_2647653_1	HG02145	139214	142510	7	17	0	0	16	3296	141506	138210	0-3-7-4-8-5-6-2-4-0-3-7-4-8-5-6-2-4-0-3-7-4-8-5-6-2-1	0.0-3.0-7.0-4.0-8.0-5.0-6.0-2.0-4.1-0.0-3.0-7.0-4.0-8.0-5.0-6.0-2.0-4.1-0.0-3.0-7.0-4.0-8.0-5.0-6.0-2.0-1.0	154	139060	142356
HG02145#1#JAHKSG010000134.1_2102465_2647653_1	HG02145	142958	161528	4	96	0	0	95	18570	160076	141506	0-3-7-4-8-5-6-2-4-0-3-7-4-8-5-6-2-4-0-3-7-4-8-5-6-2-1	0.0-3.0-7.0-4.0-8.0-5.0-6.0-2.0-4.1-0.0-3.0-7.0-4.0-8.0-5.0-6.0-2.0-4.1-0.0-3.0-7.0-4.0-8.0-5.0-6.0-2.0-1.0	154	142804	161374
HG02145#1#JAHKSG010000134.1_2102465_2647653_1	HG02145	161472	163242	8	8	0	0	7	1770	161846	160076	0-3-7-4-8-5-6-2-4-0-3-7-4-8-5-6-2-4-0-3-7-4-8-5-6-2-1	0.0-3.0-7.0-4.0-8.0-5.0-6.0-2.0-4.1-0.0-3.0-7.0-4.0-8.0-5.0-6.0-2.0-4.1-0.0-3.0-7.0-4.0-8.0-5.0-6.0-2.0-1.0	154	161318	163088
HG02145#1#JAHKSG010000134.1_2102465_2647653_1	HG02145	163186	176290	5	78	0	0	77	13104	174950	161846	0-3-7-4-8-5-6-2-4-0-3-7-4-8-5-6-2-4-0-3-7-4-8-5-6-2-1	0.0-3.0-7.0-4.0-8.0-5.0-6.0-2.0-4.1-0.0-3.0-7.0-4.0-8.0-5.0-6.0-2.0-4.1-0.0-3.0-7.0-4.0-8.0-5.0-6.0-2.0-1.0	154	163032	176136
HG02145#1#JAHKSG010000134.1_2102465_2647653_1	HG02145	176234	178978	6	24	0	0	21	2744	177694	174950	0-3-7-4-8-5-6-2-4-0-3-7-4-8-5-6-2-4-0-3-7-4-8-5-6-2-1	0.0-3.0-7.0-4.0-8.0-5.0-6.0-2.0-4.1-0.0-3.0-7.0-4.0-8.0-5.0-6.0-2.0-4.1-0.0-3.0-7.0-4.0-8.0-5.0-6.0-2.0-1.0	154	176080	178824
HG02145#1#JAHKSG010000134.1_2102465_2647653_1	HG02145	179339	210548	2	172	0	0	171	31209	208903	177694	0-3-7-4-8-5-6-2-4-0-3-7-4-8-5-6-2-4-0-3-7-4-8-5-6-2-1	0.0-3.0-7.0-4.0-8.0-5.0-6.0-2.0-4.1-0.0-3.0-7.0-4.0-8.0-5.0-6.0-2.0-4.1-0.0-3.0-7.0-4.0-8.0-5.0-6.0-2.0-1.0	154	179185	210394
HG02145#1#JAHKSG010000134.1_2102465_2647653_1	HG02145	212414	220894	4	96	1	58	22	8480	217383	208903	0-3-7-4-8-5-6-2-4-0-3-7-4-8-5-6-2-4-0-3-7-4-8-5-6-2-1	0.0-3.0-7.0-4.0-8.0-5.0-6.0-2.0-4.1-0.0-3.0-7.0-4.0-8.0-5.0-6.0-2.0-4.1-0.0-3.0-7.0-4.0-8.0-5.0-6.0-2.0-1.0	154	212260	220740
HG02145#1#JAHKSG010000134.1_2102465_2647653_1	HG02145	221071	231279	0	671	0	603	670	10208	227591	217383	0-3-7-4-8-5-6-2-4-0-3-7-4-8-5-6-2-4-0-3-7-4-8-5-6-2-1	0.0-3.0-7.0-4.0-8.0-5.0-6.0-2.0-4.1-0.0-3.0-7.0-4.0-8.0-5.0-6.0-2.0-4.1-0.0-3.0-7.0-4.0-8.0-5.0-6.0-2.0-1.0	154	220917	231125
HG02145#1#JAHKSG010000134.1_2102465_2647653_1	HG02145	231370	254202	3	132	0	0	131	22832	250423	227591	0-3-7-4-8-5-6-2-4-0-3-7-4-8-5-6-2-4-0-3-7-4-8-5-6-2-1	0.0-3.0-7.0-4.0-8.0-5.0-6.0-2.0-4.1-0.0-3.0-7.0-4.0-8.0-5.0-6.0-2.0-4.1-0.0-3.0-7.0-4.0-8.0-5.0-6.0-2.0-1.0	154	231216	254048
HG02145#1#JAHKSG010000134.1_2102465_2647653_1	HG02145	254961	258257	7	17	0	0	16	3296	253719	250423	0-3-7-4-8-5-6-2-4-0-3-7-4-8-5-6-2-4-0-3-7-4-8-5-6-2-1	0.0-3.0-7.0-4.0-8.0-5.0-6.0-2.0-4.1-0.0-3.0-7.0-4.0-8.0-5.0-6.0-2.0-4.1-0.0-3.0-7.0-4.0-8.0-5.0-6.0-2.0-1.0	154	254807	258103
HG02145#1#JAHKSG010000134.1_2102465_2647653_1	HG02145	258705	277275	4	96	0	0	95	18570	272289	253719	0-3-7-4-8-5-6-2-4-0-3-7-4-8-5-6-2-4-0-3-7-4-8-5-6-2-1	0.0-3.0-7.0-4.0-8.0-5.0-6.0-2.0-4.1-0.0-3.0-7.0-4.0-8.0-5.0-6.0-2.0-4.1-0.0-3.0-7.0-4.0-8.0-5.0-6.0-2.0-1.0	154	258551	277121
HG02145#1#JAHKSG010000134.1_2102465_2647653_1	HG02145	277219	278989	8	8	0	0	7	1770	274059	272289	0-3-7-4-8-5-6-2-4-0-3-7-4-8-5-6-2-4-0-3-7-4-8-5-6-2-1	0.0-3.0-7.0-4.0-8.0-5.0-6.0-2.0-4.1-0.0-3.0-7.0-4.0-8.0-5.0-6.0-2.0-4.1-0.0-3.0-7.0-4.0-8.0-5.0-6.0-2.0-1.0	154	277065	278835
HG02145#1#JAHKSG010000134.1_2102465_2647653_1	HG02145	278933	292037	5	78	0	0	77	13104	287163	274059	0-3-7-4-8-5-6-2-4-0-3-7-4-8-5-6-2-4-0-3-7-4-8-5-6-2-1	0.0-3.0-7.0-4.0-8.0-5.0-6.0-2.0-4.1-0.0-3.0-7.0-4.0-8.0-5.0-6.0-2.0-4.1-0.0-3.0-7.0-4.0-8.0-5.0-6.0-2.0-1.0	154	278779	291883
HG02145#1#JAHKSG010000134.1_2102465_2647653_1	HG02145	291981	294725	6	24	0	0	21	2744	289907	287163	0-3-7-4-8-5-6-2-4-0-3-7-4-8-5-6-2-4-0-3-7-4-8-5-6-2-1	0.0-3.0-7.0-4.0-8.0-5.0-6.0-2.0-4.1-0.0-3.0-7.0-4.0-8.0-5.0-6.0-2.0-4.1-0.0-3.0-7.0-4.0-8.0-5.0-6.0-2.0-1.0	154	291827	294571
HG02145#1#JAHKSG010000134.1_2102465_2647653_1	HG02145	295086	326291	2	172	0	0	171	31205	321112	289907	0-3-7-4-8-5-6-2-4-0-3-7-4-8-5-6-2-4-0-3-7-4-8-5-6-2-1	0.0-3.0-7.0-4.0-8.0-5.0-6.0-2.0-4.1-0.0-3.0-7.0-4.0-8.0-5.0-6.0-2.0-4.1-0.0-3.0-7.0-4.0-8.0-5.0-6.0-2.0-1.0	154	294932	326137
HG02145#1#JAHKSG010000134.1_2102465_2647653_1	HG02145	328157	336637	4	96	1	58	22	8480	329592	321112	0-3-7-4-8-5-6-2-4-0-3-7-4-8-5-6-2-4-0-3-7-4-8-5-6-2-1	0.0-3.0-7.0-4.0-8.0-5.0-6.0-2.0-4.1-0.0-3.0-7.0-4.0-8.0-5.0-6.0-2.0-4.1-0.0-3.0-7.0-4.0-8.0-5.0-6.0-2.0-1.0	154	328003	336483
HG02145#1#JAHKSG010000134.1_2102465_2647653_1	HG02145	336814	347024	0	671	0	603	670	10210	339802	329592	0-3-7-4-8-5-6-2-4-0-3-7-4-8-5-6-2-4-0-3-7-4-8-5-6-2-1	0.0-3.0-7.0-4.0-8.0-5.0-6.0-2.0-4.1-0.0-3.0-7.0-4.0-8.0-5.0-6.0-2.0-4.1-0.0-3.0-7.0-4.0-8.0-5.0-6.0-2.0-1.0	154	336660	346870
HG02145#1#JAHKSG010000134.1_2102465_2647653_1	HG02145	347115	369947	3	132	0	0	131	22832	362634	339802	0-3-7-4-8-5-6-2-4-0-3-7-4-8-5-6-2-4-0-3-7-4-8-5-6-2-1	0.0-3.0-7.0-4.0-8.0-5.0-6.0-2.0-4.1-0.0-3.0-7.0-4.0-8.0-5.0-6.0-2.0-4.1-0.0-3.0-7.0-4.0-8.0-5.0-6.0-2.0-1.0	154	346961	369793
HG02145#1#JAHKSG010000134.1_2102465_2647653_1	HG02145	370706	374002	7	17	0	0	16	3296	365930	362634	0-3-7-4-8-5-6-2-4-0-3-7-4-8-5-6-2-4-0-3-7-4-8-5-6-2-1	0.0-3.0-7.0-4.0-8.0-5.0-6.0-2.0-4.1-0.0-3.0-7.0-4.0-8.0-5.0-6.0-2.0-4.1-0.0-3.0-7.0-4.0-8.0-5.0-6.0-2.0-1.0	154	370552	373848
HG02145#1#JAHKSG010000134.1_2102465_2647653_1	HG02145	374450	393020	4	96	0	0	95	18570	384500	365930	0-3-7-4-8-5-6-2-4-0-3-7-4-8-5-6-2-4-0-3-7-4-8-5-6-2-1	0.0-3.0-7.0-4.0-8.0-5.0-6.0-2.0-4.1-0.0-3.0-7.0-4.0-8.0-5.0-6.0-2.0-4.1-0.0-3.0-7.0-4.0-8.0-5.0-6.0-2.0-1.0	154	374296	392866
HG02145#1#JAHKSG010000134.1_2102465_2647653_1	HG02145	392964	394734	8	8	0	0	7	1770	386270	384500	0-3-7-4-8-5-6-2-4-0-3-7-4-8-5-6-2-4-0-3-7-4-8-5-6-2-1	0.0-3.0-7.0-4.0-8.0-5.0-6.0-2.0-4.1-0.0-3.0-7.0-4.0-8.0-5.0-6.0-2.0-4.1-0.0-3.0-7.0-4.0-8.0-5.0-6.0-2.0-1.0	154	392810	394580
HG02145#1#JAHKSG010000134.1_2102465_2647653_1	HG02145	394678	407782	5	78	0	0	77	13104	399374	386270	0-3-7-4-8-5-6-2-4-0-3-7-4-8-5-6-2-4-0-3-7-4-8-5-6-2-1	0.0-3.0-7.0-4.0-8.0-5.0-6.0-2.0-4.1-0.0-3.0-7.0-4.0-8.0-5.0-6.0-2.0-4.1-0.0-3.0-7.0-4.0-8.0-5.0-6.0-2.0-1.0	154	394524	407628
HG02145#1#JAHKSG010000134.1_2102465_2647653_1	HG02145	407726	410470	6	24	0	0	21	2744	402118	399374	0-3-7-4-8-5-6-2-4-0-3-7-4-8-5-6-2-4-0-3-7-4-8-5-6-2-1	0.0-3.0-7.0-4.0-8.0-5.0-6.0-2.0-4.1-0.0-3.0-7.0-4.0-8.0-5.0-6.0-2.0-4.1-0.0-3.0-7.0-4.0-8.0-5.0-6.0-2.0-1.0	154	407572	410316
HG02145#1#JAHKSG010000134.1_2102465_2647653_1	HG02145	410831	442051	2	172	0	0	171	31220	433338	402118	0-3-7-4-8-5-6-2-4-0-3-7-4-8-5-6-2-4-0-3-7-4-8-5-6-2-1	0.0-3.0-7.0-4.0-8.0-5.0-6.0-2.0-4.1-0.0-3.0-7.0-4.0-8.0-5.0-6.0-2.0-4.1-0.0-3.0-7.0-4.0-8.0-5.0-6.0-2.0-1.0	154	410677	441897
HG02145#1#JAHKSG010000134.1_2102465_2647653_1	HG02145	441995	545172	1	612	0	0	611	103177	536515	433338	0-3-7-4-8-5-6-2-4-0-3-7-4-8-5-6-2-4-0-3-7-4-8-5-6-2-1	0.0-3.0-7.0-4.0-8.0-5.0-6.0-2.0-4.1-0.0-3.0-7.0-4.0-8.0-5.0-6.0-2.0-4.1-0.0-3.0-7.0-4.0-8.0-5.0-6.0-2.0-1.0	154	441841	545018
HG02145#2#JAHKSF010000206.1_1005292_1413195_1	HG02145	154	115553	0	671	0	0	670	115399	115399	0	0-3-7-4-8-5-6-2-4-7-2-5-6-2-1	0.0-3.0-7.0-4.0-8.0-5.0-6.0-2.0-4.1-7.1-2.1-5.0-6.0-2.0-1.0	154	0	115399
HG02145#2#JAHKSF010000206.1_1005292_1413195_1	HG02145	115644	138478	3	132	0	0	131	22834	138233	115399	0-3-7-4-8-5-6-2-4-7-2-5-6-2-1	0.0-3.0-7.0-4.0-8.0-5.0-6.0-2.0-4.1-7.1-2.1-5.0-6.0-2.0-1.0	154	115490	138324
HG02145#2#JAHKSF010000206.1_1005292_1413195_1	HG02145	139237	142532	7	17	0	0	16	3295	141528	138233	0-3-7-4-8-5-6-2-4-7-2-5-6-2-1	0.0-3.0-7.0-4.0-8.0-5.0-6.0-2.0-4.1-7.1-2.1-5.0-6.0-2.0-1.0	154	139083	142378
HG02145#2#JAHKSF010000206.1_1005292_1413195_1	HG02145	143597	161553	4	96	0	4	95	17956	159484	141528	0-3-7-4-8-5-6-2-4-7-2-5-6-2-1	0.0-3.0-7.0-4.0-8.0-5.0-6.0-2.0-4.1-7.1-2.1-5.0-6.0-2.0-1.0	154	143443	161399
HG02145#2#JAHKSF010000206.1_1005292_1413195_1	HG02145	161497	163267	8	8	0	0	7	1770	161254	159484	0-3-7-4-8-5-6-2-4-7-2-5-6-2-1	0.0-3.0-7.0-4.0-8.0-5.0-6.0-2.0-4.1-7.1-2.1-5.0-6.0-2.0-1.0	154	161343	163113
HG02145#2#JAHKSF010000206.1_1005292_1413195_1	HG02145	163211	175909	5	78	0	0	76	12698	173952	161254	0-3-7-4-8-5-6-2-4-7-2-5-6-2-1	0.0-3.0-7.0-4.0-8.0-5.0-6.0-2.0-4.1-7.1-2.1-5.0-6.0-2.0-1.0	154	163057	175755
HG02145#2#JAHKSF010000206.1_1005292_1413195_1	HG02145	176516	179043	6	24	0	1	21	2527	176479	173952	0-3-7-4-8-5-6-2-4-7-2-5-6-2-1	0.0-3.0-7.0-4.0-8.0-5.0-6.0-2.0-4.1-7.1-2.1-5.0-6.0-2.0-1.0	154	176362	178889
HG02145#2#JAHKSF010000206.1_1005292_1413195_1	HG02145	179429	210644	2	172	0	0	171	31215	207694	176479	0-3-7-4-8-5-6-2-4-7-2-5-6-2-1	0.0-3.0-7.0-4.0-8.0-5.0-6.0-2.0-4.1-7.1-2.1-5.0-6.0-2.0-1.0	154	179275	210490
HG02145#2#JAHKSF010000206.1_1005292_1413195_1	HG02145	212960	224054	4	96	1	56	4	11094	218788	207694	0-3-7-4-8-5-6-2-4-7-2-5-6-2-1	0.0-3.0-7.0-4.0-8.0-5.0-6.0-2.0-4.1-7.1-2.1-5.0-6.0-2.0-1.0	154	212806	223900
HG02145#2#JAHKSF010000206.1_1005292_1413195_1	HG02145	225117	228412	7	17	1	16	0	3295	222083	218788	0-3-7-4-8-5-6-2-4-7-2-5-6-2-1	0.0-3.0-7.0-4.0-8.0-5.0-6.0-2.0-4.1-7.1-2.1-5.0-6.0-2.0-1.0	154	224963	228258
HG02145#2#JAHKSF010000206.1_1005292_1413195_1	HG02145	229489	257401	2	172	1	171	15	27912	249995	222083	0-3-7-4-8-5-6-2-4-7-2-5-6-2-1	0.0-3.0-7.0-4.0-8.0-5.0-6.0-2.0-4.1-7.1-2.1-5.0-6.0-2.0-1.0	154	229335	257247
HG02145#2#JAHKSF010000206.1_1005292_1413195_1	HG02145	258367	269581	5	78	0	5	74	11214	261209	249995	0-3-7-4-8-5-6-2-4-7-2-5-6-2-1	0.0-3.0-7.0-4.0-8.0-5.0-6.0-2.0-4.1-7.1-2.1-5.0-6.0-2.0-1.0	154	258213	269427
HG02145#2#JAHKSF010000206.1_1005292_1413195_1	HG02145	270662	273189	6	24	0	1	21	2527	263736	261209	0-3-7-4-8-5-6-2-4-7-2-5-6-2-1	0.0-3.0-7.0-4.0-8.0-5.0-6.0-2.0-4.1-7.1-2.1-5.0-6.0-2.0-1.0	154	270508	273035
HG02145#2#JAHKSF010000206.1_1005292_1413195_1	HG02145	273547	304757	2	172	0	0	171	31210	294946	263736	0-3-7-4-8-5-6-2-4-7-2-5-6-2-1	0.0-3.0-7.0-4.0-8.0-5.0-6.0-2.0-4.1-7.1-2.1-5.0-6.0-2.0-1.0	154	273393	304603
HG02145#2#JAHKSF010000206.1_1005292_1413195_1	HG02145	304701	407887	1	612	0	0	611	103186	398132	294946	0-3-7-4-8-5-6-2-4-7-2-5-6-2-1	0.0-3.0-7.0-4.0-8.0-5.0-6.0-2.0-4.1-7.1-2.1-5.0-6.0-2.0-1.0	154	304547	407733
HG02293.verkko_filt_mat.fa:haplotype1-0000039_30204405_30517145_1	HG02293	155	115493	0	671	0	0	670	115338	115338	0	0-3-7-4-8-5-6-2-1	0.0-3.0-7.0-4.0-8.0-5.0-6.0-2.0-1.0	155	0	115338
HG02293.verkko_filt_mat.fa:haplotype1-0000039_30204405_30517145_1	HG02293	115584	138417	3	132	0	0	131	22833	138171	115338	0-3-7-4-8-5-6-2-1	0.0-3.0-7.0-4.0-8.0-5.0-6.0-2.0-1.0	155	115429	138262
HG02293.verkko_filt_mat.fa:haplotype1-0000039_30204405_30517145_1	HG02293	139176	142472	7	17	0	0	16	3296	141467	138171	0-3-7-4-8-5-6-2-1	0.0-3.0-7.0-4.0-8.0-5.0-6.0-2.0-1.0	155	139021	142317
HG02293.verkko_filt_mat.fa:haplotype1-0000039_30204405_30517145_1	HG02293	142920	161481	4	96	0	0	95	18561	160028	141467	0-3-7-4-8-5-6-2-1	0.0-3.0-7.0-4.0-8.0-5.0-6.0-2.0-1.0	155	142765	161326
HG02293.verkko_filt_mat.fa:haplotype1-0000039_30204405_30517145_1	HG02293	161425	163195	8	8	0	0	7	1770	161798	160028	0-3-7-4-8-5-6-2-1	0.0-3.0-7.0-4.0-8.0-5.0-6.0-2.0-1.0	155	161270	163040
HG02293.verkko_filt_mat.fa:haplotype1-0000039_30204405_30517145_1	HG02293	163139	176243	5	78	0	0	77	13104	174902	161798	0-3-7-4-8-5-6-2-1	0.0-3.0-7.0-4.0-8.0-5.0-6.0-2.0-1.0	155	162984	176088
HG02293.verkko_filt_mat.fa:haplotype1-0000039_30204405_30517145_1	HG02293	176187	178931	6	24	0	0	21	2744	177646	174902	0-3-7-4-8-5-6-2-1	0.0-3.0-7.0-4.0-8.0-5.0-6.0-2.0-1.0	155	176032	178776
HG02293.verkko_filt_mat.fa:haplotype1-0000039_30204405_30517145_1	HG02293	179597	210504	2	172	0	1	171	30907	208553	177646	0-3-7-4-8-5-6-2-1	0.0-3.0-7.0-4.0-8.0-5.0-6.0-2.0-1.0	155	179442	210349
HG02293.verkko_filt_mat.fa:haplotype1-0000039_30204405_30517145_1	HG02293	210448	312536	1	612	0	0	604	102088	310641	208553	0-3-7-4-8-5-6-2-1	0.0-3.0-7.0-4.0-8.0-5.0-6.0-2.0-1.0	155	210293	312381
HG02293.verkko_filt_pat.fa:haplotype2-0000836_148310532_148812524_1	HG02293	155	115536	0	671	0	0	670	115381	115381	0	0-3-7-4-8-5-6-2-4-7-2-6-5-2-4-7-2-6-5-2-1	0.0-3.0-7.0-4.0-8.0-5.0-6.0-2.0-4.1-7.1-2.1-6.1-5.1-2.0-4.1-7.1-2.1-6.1-5.1-2.0-1.0	155	0	115381
HG02293.verkko_filt_pat.fa:haplotype2-0000836_148310532_148812524_1	HG02293	115627	138462	3	132	0	0	131	22835	138216	115381	0-3-7-4-8-5-6-2-4-7-2-6-5-2-4-7-2-6-5-2-1	0.0-3.0-7.0-4.0-8.0-5.0-6.0-2.0-4.1-7.1-2.1-6.1-5.1-2.0-4.1-7.1-2.1-6.1-5.1-2.0-1.0	155	115472	138307
HG02293.verkko_filt_pat.fa:haplotype2-0000836_148310532_148812524_1	HG02293	139221	142517	7	17	0	0	16	3296	141512	138216	0-3-7-4-8-5-6-2-4-7-2-6-5-2-4-7-2-6-5-2-1	0.0-3.0-7.0-4.0-8.0-5.0-6.0-2.0-4.1-7.1-2.1-6.1-5.1-2.0-4.1-7.1-2.1-6.1-5.1-2.0-1.0	155	139066	142362
HG02293.verkko_filt_pat.fa:haplotype2-0000836_148310532_148812524_1	HG02293	142965	161524	4	96	0	0	95	18559	160071	141512	0-3-7-4-8-5-6-2-4-7-2-6-5-2-4-7-2-6-5-2-1	0.0-3.0-7.0-4.0-8.0-5.0-6.0-2.0-4.1-7.1-2.1-6.1-5.1-2.0-4.1-7.1-2.1-6.1-5.1-2.0-1.0	155	142810	161369
HG02293.verkko_filt_pat.fa:haplotype2-0000836_148310532_148812524_1	HG02293	161468	163238	8	8	0	0	7	1770	161841	160071	0-3-7-4-8-5-6-2-4-7-2-6-5-2-4-7-2-6-5-2-1	0.0-3.0-7.0-4.0-8.0-5.0-6.0-2.0-4.1-7.1-2.1-6.1-5.1-2.0-4.1-7.1-2.1-6.1-5.1-2.0-1.0	155	161313	163083
HG02293.verkko_filt_pat.fa:haplotype2-0000836_148310532_148812524_1	HG02293	163182	176286	5	78	0	0	77	13104	174945	161841	0-3-7-4-8-5-6-2-4-7-2-6-5-2-4-7-2-6-5-2-1	0.0-3.0-7.0-4.0-8.0-5.0-6.0-2.0-4.1-7.1-2.1-6.1-5.1-2.0-4.1-7.1-2.1-6.1-5.1-2.0-1.0	155	163027	176131
HG02293.verkko_filt_pat.fa:haplotype2-0000836_148310532_148812524_1	HG02293	176230	178974	6	24	0	0	21	2744	177689	174945	0-3-7-4-8-5-6-2-4-7-2-6-5-2-4-7-2-6-5-2-1	0.0-3.0-7.0-4.0-8.0-5.0-6.0-2.0-4.1-7.1-2.1-6.1-5.1-2.0-4.1-7.1-2.1-6.1-5.1-2.0-1.0	155	176075	178819
HG02293.verkko_filt_pat.fa:haplotype2-0000836_148310532_148812524_1	HG02293	179332	210168	2	172	0	0	170	30836	208525	177689	0-3-7-4-8-5-6-2-4-7-2-6-5-2-4-7-2-6-5-2-1	0.0-3.0-7.0-4.0-8.0-5.0-6.0-2.0-4.1-7.1-2.1-6.1-5.1-2.0-4.1-7.1-2.1-6.1-5.1-2.0-1.0	155	179177	210013
HG02293.verkko_filt_pat.fa:haplotype2-0000836_148310532_148812524_1	HG02293	212419	223963	4	96	1	58	4	11544	220069	208525	0-3-7-4-8-5-6-2-4-7-2-6-5-2-4-7-2-6-5-2-1	0.0-3.0-7.0-4.0-8.0-5.0-6.0-2.0-4.1-7.1-2.1-6.1-5.1-2.0-4.1-7.1-2.1-6.1-5.1-2.0-1.0	155	212264	223808
HG02293.verkko_filt_pat.fa:haplotype2-0000836_148310532_148812524_1	HG02293	225028	228323	7	17	1	16	0	3295	223364	220069	0-3-7-4-8-5-6-2-4-7-2-6-5-2-4-7-2-6-5-2-1	0.0-3.0-7.0-4.0-8.0-5.0-6.0-2.0-4.1-7.1-2.1-6.1-5.1-2.0-4.1-7.1-2.1-6.1-5.1-2.0-1.0	155	224873	228168
HG02293.verkko_filt_pat.fa:haplotype2-0000836_148310532_148812524_1	HG02293	229785	260622	2	172	1	170	0	30837	254201	223364	0-3-7-4-8-5-6-2-4-7-2-6-5-2-4-7-2-6-5-2-1	0.0-3.0-7.0-4.0-8.0-5.0-6.0-2.0-4.1-7.1-2.1-6.1-5.1-2.0-4.1-7.1-2.1-6.1-5.1-2.0-1.0	155	229630	260467
HG02293.verkko_filt_pat.fa:haplotype2-0000836_148310532_148812524_1	HG02293	260980	263724	6	24	1	21	0	2744	256945	254201	0-3-7-4-8-5-6-2-4-7-2-6-5-2-4-7-2-6-5-2-1	0.0-3.0-7.0-4.0-8.0-5.0-6.0-2.0-4.1-7.1-2.1-6.1-5.1-2.0-4.1-7.1-2.1-6.1-5.1-2.0-1.0	155	260825	263569
HG02293.verkko_filt_pat.fa:haplotype2-0000836_148310532_148812524_1	HG02293	263668	275796	5	78	1	77	5	12128	269073	256945	0-3-7-4-8-5-6-2-4-7-2-6-5-2-4-7-2-6-5-2-1	0.0-3.0-7.0-4.0-8.0-5.0-6.0-2.0-4.1-7.1-2.1-6.1-5.1-2.0-4.1-7.1-2.1-6.1-5.1-2.0-1.0	155	263513	275641
HG02293.verkko_filt_pat.fa:haplotype2-0000836_148310532_148812524_1	HG02293	276762	303956	2	172	0	15	167	27194	296267	269073	0-3-7-4-8-5-6-2-4-7-2-6-5-2-4-7-2-6-5-2-1	0.0-3.0-7.0-4.0-8.0-5.0-6.0-2.0-4.1-7.1-2.1-6.1-5.1-2.0-4.1-7.1-2.1-6.1-5.1-2.0-1.0	155	276607	303801
HG02293.verkko_filt_pat.fa:haplotype2-0000836_148310532_148812524_1	HG02293	306548	318092	4	96	1	58	4	11544	307811	296267	0-3-7-4-8-5-6-2-4-7-2-6-5-2-4-7-2-6-5-2-1	0.0-3.0-7.0-4.0-8.0-5.0-6.0-2.0-4.1-7.1-2.1-6.1-5.1-2.0-4.1-7.1-2.1-6.1-5.1-2.0-1.0	155	306393	317937
HG02293.verkko_filt_pat.fa:haplotype2-0000836_148310532_148812524_1	HG02293	319159	322454	7	17	1	16	0	3295	311106	307811	0-3-7-4-8-5-6-2-4-7-2-6-5-2-4-7-2-6-5-2-1	0.0-3.0-7.0-4.0-8.0-5.0-6.0-2.0-4.1-7.1-2.1-6.1-5.1-2.0-4.1-7.1-2.1-6.1-5.1-2.0-1.0	155	319004	322299
HG02293.verkko_filt_pat.fa:haplotype2-0000836_148310532_148812524_1	HG02293	323916	354754	2	172	1	170	0	30838	341944	311106	0-3-7-4-8-5-6-2-4-7-2-6-5-2-4-7-2-6-5-2-1	0.0-3.0-7.0-4.0-8.0-5.0-6.0-2.0-4.1-7.1-2.1-6.1-5.1-2.0-4.1-7.1-2.1-6.1-5.1-2.0-1.0	155	323761	354599
HG02293.verkko_filt_pat.fa:haplotype2-0000836_148310532_148812524_1	HG02293	355112	357856	6	24	1	21	0	2744	344688	341944	0-3-7-4-8-5-6-2-4-7-2-6-5-2-4-7-2-6-5-2-1	0.0-3.0-7.0-4.0-8.0-5.0-6.0-2.0-4.1-7.1-2.1-6.1-5.1-2.0-4.1-7.1-2.1-6.1-5.1-2.0-1.0	155	354957	357701
HG02293.verkko_filt_pat.fa:haplotype2-0000836_148310532_148812524_1	HG02293	357800	369928	5	78	1	77	5	12128	356816	344688	0-3-7-4-8-5-6-2-4-7-2-6-5-2-4-7-2-6-5-2-1	0.0-3.0-7.0-4.0-8.0-5.0-6.0-2.0-4.1-7.1-2.1-6.1-5.1-2.0-4.1-7.1-2.1-6.1-5.1-2.0-1.0	155	357645	369773
HG02293.verkko_filt_pat.fa:haplotype2-0000836_148310532_148812524_1	HG02293	370894	398812	2	172	0	15	171	27918	384734	356816	0-3-7-4-8-5-6-2-4-7-2-6-5-2-4-7-2-6-5-2-1	0.0-3.0-7.0-4.0-8.0-5.0-6.0-2.0-4.1-7.1-2.1-6.1-5.1-2.0-4.1-7.1-2.1-6.1-5.1-2.0-1.0	155	370739	398657
HG02293.verkko_filt_pat.fa:haplotype2-0000836_148310532_148812524_1	HG02293	398756	501976	1	612	0	0	611	103220	487954	384734	0-3-7-4-8-5-6-2-4-7-2-6-5-2-4-7-2-6-5-2-1	0.0-3.0-7.0-4.0-8.0-5.0-6.0-2.0-4.1-7.1-2.1-6.1-5.1-2.0-4.1-7.1-2.1-6.1-5.1-2.0-1.0	155	398601	501821
HG02300.verkko_filt_mat.fa:haplotype1-0000028_144052837_144460586_1	HG02300	154	115490	0	671	0	0	670	115336	115336	0	0-3-7-4-8-5-6-2-4-7-2-6-5-2-1	0.0-3.0-7.0-4.0-8.0-5.0-6.0-2.0-4.1-7.1-2.1-6.1-5.1-2.0-1.0	154	0	115336
HG02300.verkko_filt_mat.fa:haplotype1-0000028_144052837_144460586_1	HG02300	115581	138412	3	132	0	0	131	22831	138167	115336	0-3-7-4-8-5-6-2-4-7-2-6-5-2-1	0.0-3.0-7.0-4.0-8.0-5.0-6.0-2.0-4.1-7.1-2.1-6.1-5.1-2.0-1.0	154	115427	138258
HG02300.verkko_filt_mat.fa:haplotype1-0000028_144052837_144460586_1	HG02300	139171	142466	7	17	0	0	16	3295	141462	138167	0-3-7-4-8-5-6-2-4-7-2-6-5-2-1	0.0-3.0-7.0-4.0-8.0-5.0-6.0-2.0-4.1-7.1-2.1-6.1-5.1-2.0-1.0	154	139017	142312
HG02300.verkko_filt_mat.fa:haplotype1-0000028_144052837_144460586_1	HG02300	143257	161466	4	96	0	1	95	18209	159671	141462	0-3-7-4-8-5-6-2-4-7-2-6-5-2-1	0.0-3.0-7.0-4.0-8.0-5.0-6.0-2.0-4.1-7.1-2.1-6.1-5.1-2.0-1.0	154	143103	161312
HG02300.verkko_filt_mat.fa:haplotype1-0000028_144052837_144460586_1	HG02300	161410	163180	8	8	0	0	7	1770	161441	159671	0-3-7-4-8-5-6-2-4-7-2-6-5-2-1	0.0-3.0-7.0-4.0-8.0-5.0-6.0-2.0-4.1-7.1-2.1-6.1-5.1-2.0-1.0	154	161256	163026
HG02300.verkko_filt_mat.fa:haplotype1-0000028_144052837_144460586_1	HG02300	163124	176228	5	78	0	0	77	13104	174545	161441	0-3-7-4-8-5-6-2-4-7-2-6-5-2-1	0.0-3.0-7.0-4.0-8.0-5.0-6.0-2.0-4.1-7.1-2.1-6.1-5.1-2.0-1.0	154	162970	176074
HG02300.verkko_filt_mat.fa:haplotype1-0000028_144052837_144460586_1	HG02300	176172	178916	6	24	0	0	21	2744	177289	174545	0-3-7-4-8-5-6-2-4-7-2-6-5-2-1	0.0-3.0-7.0-4.0-8.0-5.0-6.0-2.0-4.1-7.1-2.1-6.1-5.1-2.0-1.0	154	176018	178762
HG02300.verkko_filt_mat.fa:haplotype1-0000028_144052837_144460586_1	HG02300	179275	210494	2	172	0	0	171	31219	208508	177289	0-3-7-4-8-5-6-2-4-7-2-6-5-2-1	0.0-3.0-7.0-4.0-8.0-5.0-6.0-2.0-4.1-7.1-2.1-6.1-5.1-2.0-1.0	154	179121	210340
HG02300.verkko_filt_mat.fa:haplotype1-0000028_144052837_144460586_1	HG02300	212360	223904	4	96	1	58	4	11544	220052	208508	0-3-7-4-8-5-6-2-4-7-2-6-5-2-1	0.0-3.0-7.0-4.0-8.0-5.0-6.0-2.0-4.1-7.1-2.1-6.1-5.1-2.0-1.0	154	212206	223750
HG02300.verkko_filt_mat.fa:haplotype1-0000028_144052837_144460586_1	HG02300	224967	228262	7	17	1	16	0	3295	223347	220052	0-3-7-4-8-5-6-2-4-7-2-6-5-2-1	0.0-3.0-7.0-4.0-8.0-5.0-6.0-2.0-4.1-7.1-2.1-6.1-5.1-2.0-1.0	154	224813	228108
HG02300.verkko_filt_mat.fa:haplotype1-0000028_144052837_144460586_1	HG02300	229339	260558	2	172	1	171	0	31219	254566	223347	0-3-7-4-8-5-6-2-4-7-2-6-5-2-1	0.0-3.0-7.0-4.0-8.0-5.0-6.0-2.0-4.1-7.1-2.1-6.1-5.1-2.0-1.0	154	229185	260404
HG02300.verkko_filt_mat.fa:haplotype1-0000028_144052837_144460586_1	HG02300	260917	263444	6	24	1	21	1	2527	257093	254566	0-3-7-4-8-5-6-2-4-7-2-6-5-2-1	0.0-3.0-7.0-4.0-8.0-5.0-6.0-2.0-4.1-7.1-2.1-6.1-5.1-2.0-1.0	154	260763	263290
HG02300.verkko_filt_mat.fa:haplotype1-0000028_144052837_144460586_1	HG02300	264051	276266	5	78	1	76	3	12215	269308	257093	0-3-7-4-8-5-6-2-4-7-2-6-5-2-1	0.0-3.0-7.0-4.0-8.0-5.0-6.0-2.0-4.1-7.1-2.1-6.1-5.1-2.0-1.0	154	263897	276112
HG02300.verkko_filt_mat.fa:haplotype1-0000028_144052837_144460586_1	HG02300	276705	304606	2	172	0	15	171	27901	297209	269308	0-3-7-4-8-5-6-2-4-7-2-6-5-2-1	0.0-3.0-7.0-4.0-8.0-5.0-6.0-2.0-4.1-7.1-2.1-6.1-5.1-2.0-1.0	154	276551	304452
HG02300.verkko_filt_mat.fa:haplotype1-0000028_144052837_144460586_1	HG02300	304550	407733	1	612	0	0	611	103183	400392	297209	0-3-7-4-8-5-6-2-4-7-2-6-5-2-1	0.0-3.0-7.0-4.0-8.0-5.0-6.0-2.0-4.1-7.1-2.1-6.1-5.1-2.0-1.0	154	304396	407579
HG02300.verkko_filt_pat.fa:haplotype2-0000620_143362344_143769323_1	HG02300	155	115567	0	671	0	0	670	115412	115412	0	0-3-7-4-8-5-6-2-4-7-2-5-6-2-1	0.0-3.0-7.0-4.0-8.0-5.0-6.0-2.0-4.1-7.1-2.1-5.0-6.0-2.0-1.0	155	0	115412
HG02300.verkko_filt_pat.fa:haplotype2-0000620_143362344_143769323_1	HG02300	115658	138491	3	132	0	0	131	22833	138245	115412	0-3-7-4-8-5-6-2-4-7-2-5-6-2-1	0.0-3.0-7.0-4.0-8.0-5.0-6.0-2.0-4.1-7.1-2.1-5.0-6.0-2.0-1.0	155	115503	138336
HG02300.verkko_filt_pat.fa:haplotype2-0000620_143362344_143769323_1	HG02300	139250	142546	7	17	0	0	16	3296	141541	138245	0-3-7-4-8-5-6-2-4-7-2-5-6-2-1	0.0-3.0-7.0-4.0-8.0-5.0-6.0-2.0-4.1-7.1-2.1-5.0-6.0-2.0-1.0	155	139095	142391
HG02300.verkko_filt_pat.fa:haplotype2-0000620_143362344_143769323_1	HG02300	142994	161549	4	96	0	0	95	18555	160096	141541	0-3-7-4-8-5-6-2-4-7-2-5-6-2-1	0.0-3.0-7.0-4.0-8.0-5.0-6.0-2.0-4.1-7.1-2.1-5.0-6.0-2.0-1.0	155	142839	161394
HG02300.verkko_filt_pat.fa:haplotype2-0000620_143362344_143769323_1	HG02300	161493	163263	8	8	0	0	7	1770	161866	160096	0-3-7-4-8-5-6-2-4-7-2-5-6-2-1	0.0-3.0-7.0-4.0-8.0-5.0-6.0-2.0-4.1-7.1-2.1-5.0-6.0-2.0-1.0	155	161338	163108
HG02300.verkko_filt_pat.fa:haplotype2-0000620_143362344_143769323_1	HG02300	163207	176311	5	78	0	0	77	13104	174970	161866	0-3-7-4-8-5-6-2-4-7-2-5-6-2-1	0.0-3.0-7.0-4.0-8.0-5.0-6.0-2.0-4.1-7.1-2.1-5.0-6.0-2.0-1.0	155	163052	176156
HG02300.verkko_filt_pat.fa:haplotype2-0000620_143362344_143769323_1	HG02300	176255	178999	6	24	0	0	21	2744	177714	174970	0-3-7-4-8-5-6-2-4-7-2-5-6-2-1	0.0-3.0-7.0-4.0-8.0-5.0-6.0-2.0-4.1-7.1-2.1-5.0-6.0-2.0-1.0	155	176100	178844
HG02300.verkko_filt_pat.fa:haplotype2-0000620_143362344_143769323_1	HG02300	179357	209850	2	172	0	0	167	30493	208207	177714	0-3-7-4-8-5-6-2-4-7-2-5-6-2-1	0.0-3.0-7.0-4.0-8.0-5.0-6.0-2.0-4.1-7.1-2.1-5.0-6.0-2.0-1.0	155	179202	209695
HG02300.verkko_filt_pat.fa:haplotype2-0000620_143362344_143769323_1	HG02300	212442	223988	4	96	1	58	4	11546	219753	208207	0-3-7-4-8-5-6-2-4-7-2-5-6-2-1	0.0-3.0-7.0-4.0-8.0-5.0-6.0-2.0-4.1-7.1-2.1-5.0-6.0-2.0-1.0	155	212287	223833
HG02300.verkko_filt_pat.fa:haplotype2-0000620_143362344_143769323_1	HG02300	225053	228348	7	17	1	16	0	3295	223048	219753	0-3-7-4-8-5-6-2-4-7-2-5-6-2-1	0.0-3.0-7.0-4.0-8.0-5.0-6.0-2.0-4.1-7.1-2.1-5.0-6.0-2.0-1.0	155	224898	228193
HG02300.verkko_filt_pat.fa:haplotype2-0000620_143362344_143769323_1	HG02300	229810	257333	2	172	1	170	15	27523	250571	223048	0-3-7-4-8-5-6-2-4-7-2-5-6-2-1	0.0-3.0-7.0-4.0-8.0-5.0-6.0-2.0-4.1-7.1-2.1-5.0-6.0-2.0-1.0	155	229655	257178
HG02300.verkko_filt_pat.fa:haplotype2-0000620_143362344_143769323_1	HG02300	258299	269987	5	78	0	5	76	11688	262259	250571	0-3-7-4-8-5-6-2-4-7-2-5-6-2-1	0.0-3.0-7.0-4.0-8.0-5.0-6.0-2.0-4.1-7.1-2.1-5.0-6.0-2.0-1.0	155	258144	269832
HG02300.verkko_filt_pat.fa:haplotype2-0000620_143362344_143769323_1	HG02300	270594	273121	6	24	0	1	21	2527	264786	262259	0-3-7-4-8-5-6-2-4-7-2-5-6-2-1	0.0-3.0-7.0-4.0-8.0-5.0-6.0-2.0-4.1-7.1-2.1-5.0-6.0-2.0-1.0	155	270439	272966
HG02300.verkko_filt_pat.fa:haplotype2-0000620_143362344_143769323_1	HG02300	273479	304693	2	172	0	0	171	31214	296000	264786	0-3-7-4-8-5-6-2-4-7-2-5-6-2-1	0.0-3.0-7.0-4.0-8.0-5.0-6.0-2.0-4.1-7.1-2.1-5.0-6.0-2.0-1.0	155	273324	304538
HG02300.verkko_filt_pat.fa:haplotype2-0000620_143362344_143769323_1	HG02300	304637	406775	1	612	0	0	604	102138	398138	296000	0-3-7-4-8-5-6-2-4-7-2-5-6-2-1	0.0-3.0-7.0-4.0-8.0-5.0-6.0-2.0-4.1-7.1-2.1-5.0-6.0-2.0-1.0	155	304482	406620
HG02486#1#JAGYVM010000007.1_28868414_29370339_1	HG02486	154	115521	0	671	0	0	670	115367	115367	0	0-3-7-4-8-5-6-2-4-7-2-6-5-2-7-4-2-5-6-2-1	0.0-3.0-7.0-4.0-8.0-5.0-6.0-2.0-4.1-7.1-2.1-6.1-5.1-2.0-7.0-4.0-2.1-5.0-6.0-2.0-1.0	154	0	115367
HG02486#1#JAGYVM010000007.1_28868414_29370339_1	HG02486	115612	138447	3	132	0	0	131	22835	138202	115367	0-3-7-4-8-5-6-2-4-7-2-6-5-2-7-4-2-5-6-2-1	0.0-3.0-7.0-4.0-8.0-5.0-6.0-2.0-4.1-7.1-2.1-6.1-5.1-2.0-7.0-4.0-2.1-5.0-6.0-2.0-1.0	154	115458	138293
HG02486#1#JAGYVM010000007.1_28868414_29370339_1	HG02486	139206	142501	7	17	0	0	16	3295	141497	138202	0-3-7-4-8-5-6-2-4-7-2-6-5-2-7-4-2-5-6-2-1	0.0-3.0-7.0-4.0-8.0-5.0-6.0-2.0-4.1-7.1-2.1-6.1-5.1-2.0-7.0-4.0-2.1-5.0-6.0-2.0-1.0	154	139052	142347
HG02486#1#JAGYVM010000007.1_28868414_29370339_1	HG02486	142949	161521	4	96	0	0	95	18572	160069	141497	0-3-7-4-8-5-6-2-4-7-2-6-5-2-7-4-2-5-6-2-1	0.0-3.0-7.0-4.0-8.0-5.0-6.0-2.0-4.1-7.1-2.1-6.1-5.1-2.0-7.0-4.0-2.1-5.0-6.0-2.0-1.0	154	142795	161367
HG02486#1#JAGYVM010000007.1_28868414_29370339_1	HG02486	161465	163235	8	8	0	0	7	1770	161839	160069	0-3-7-4-8-5-6-2-4-7-2-6-5-2-7-4-2-5-6-2-1	0.0-3.0-7.0-4.0-8.0-5.0-6.0-2.0-4.1-7.1-2.1-6.1-5.1-2.0-7.0-4.0-2.1-5.0-6.0-2.0-1.0	154	161311	163081
HG02486#1#JAGYVM010000007.1_28868414_29370339_1	HG02486	163179	176283	5	78	0	0	77	13104	174943	161839	0-3-7-4-8-5-6-2-4-7-2-6-5-2-7-4-2-5-6-2-1	0.0-3.0-7.0-4.0-8.0-5.0-6.0-2.0-4.1-7.1-2.1-6.1-5.1-2.0-7.0-4.0-2.1-5.0-6.0-2.0-1.0	154	163025	176129
HG02486#1#JAGYVM010000007.1_28868414_29370339_1	HG02486	176227	179387	6	24	0	0	23	3160	178103	174943	0-3-7-4-8-5-6-2-4-7-2-6-5-2-7-4-2-5-6-2-1	0.0-3.0-7.0-4.0-8.0-5.0-6.0-2.0-4.1-7.1-2.1-6.1-5.1-2.0-7.0-4.0-2.1-5.0-6.0-2.0-1.0	154	176073	179233
HG02486#1#JAGYVM010000007.1_28868414_29370339_1	HG02486	179331	210559	2	172	0	0	171	31228	209331	178103	0-3-7-4-8-5-6-2-4-7-2-6-5-2-7-4-2-5-6-2-1	0.0-3.0-7.0-4.0-8.0-5.0-6.0-2.0-4.1-7.1-2.1-6.1-5.1-2.0-7.0-4.0-2.1-5.0-6.0-2.0-1.0	154	179177	210405
HG02486#1#JAGYVM010000007.1_28868414_29370339_1	HG02486	212425	223975	4	96	1	58	4	11550	220881	209331	0-3-7-4-8-5-6-2-4-7-2-6-5-2-7-4-2-5-6-2-1	0.0-3.0-7.0-4.0-8.0-5.0-6.0-2.0-4.1-7.1-2.1-6.1-5.1-2.0-7.0-4.0-2.1-5.0-6.0-2.0-1.0	154	212271	223821
HG02486#1#JAGYVM010000007.1_28868414_29370339_1	HG02486	225040	228335	7	17	1	16	0	3295	224176	220881	0-3-7-4-8-5-6-2-4-7-2-6-5-2-7-4-2-5-6-2-1	0.0-3.0-7.0-4.0-8.0-5.0-6.0-2.0-4.1-7.1-2.1-6.1-5.1-2.0-7.0-4.0-2.1-5.0-6.0-2.0-1.0	154	224886	228181
HG02486#1#JAGYVM010000007.1_28868414_29370339_1	HG02486	229412	260633	2	172	1	171	0	31221	255397	224176	0-3-7-4-8-5-6-2-4-7-2-6-5-2-7-4-2-5-6-2-1	0.0-3.0-7.0-4.0-8.0-5.0-6.0-2.0-4.1-7.1-2.1-6.1-5.1-2.0-7.0-4.0-2.1-5.0-6.0-2.0-1.0	154	229258	260479
HG02486#1#JAGYVM010000007.1_28868414_29370339_1	HG02486	260577	263520	6	24	1	23	1	2943	258340	255397	0-3-7-4-8-5-6-2-4-7-2-6-5-2-7-4-2-5-6-2-1	0.0-3.0-7.0-4.0-8.0-5.0-6.0-2.0-4.1-7.1-2.1-6.1-5.1-2.0-7.0-4.0-2.1-5.0-6.0-2.0-1.0	154	260423	263366
HG02486#1#JAGYVM010000007.1_28868414_29370339_1	HG02486	264601	276341	5	78	1	74	3	11740	270080	258340	0-3-7-4-8-5-6-2-4-7-2-6-5-2-7-4-2-5-6-2-1	0.0-3.0-7.0-4.0-8.0-5.0-6.0-2.0-4.1-7.1-2.1-6.1-5.1-2.0-7.0-4.0-2.1-5.0-6.0-2.0-1.0	154	264447	276187
HG02486#1#JAGYVM010000007.1_28868414_29370339_1	HG02486	276780	304680	2	172	0	15	171	27900	297980	270080	0-3-7-4-8-5-6-2-4-7-2-6-5-2-7-4-2-5-6-2-1	0.0-3.0-7.0-4.0-8.0-5.0-6.0-2.0-4.1-7.1-2.1-6.1-5.1-2.0-7.0-4.0-2.1-5.0-6.0-2.0-1.0	154	276626	304526
HG02486#1#JAGYVM010000007.1_28868414_29370339_1	HG02486	305757	309052	7	17	0	0	16	3295	301275	297980	0-3-7-4-8-5-6-2-4-7-2-6-5-2-7-4-2-5-6-2-1	0.0-3.0-7.0-4.0-8.0-5.0-6.0-2.0-4.1-7.1-2.1-6.1-5.1-2.0-7.0-4.0-2.1-5.0-6.0-2.0-1.0	154	305603	308898
HG02486#1#JAGYVM010000007.1_28868414_29370339_1	HG02486	309500	321662	4	96	0	0	58	12162	313437	301275	0-3-7-4-8-5-6-2-4-7-2-6-5-2-7-4-2-5-6-2-1	0.0-3.0-7.0-4.0-8.0-5.0-6.0-2.0-4.1-7.1-2.1-6.1-5.1-2.0-7.0-4.0-2.1-5.0-6.0-2.0-1.0	154	309346	321508
HG02486#1#JAGYVM010000007.1_28868414_29370339_1	HG02486	323528	351430	2	172	1	171	15	27902	341339	313437	0-3-7-4-8-5-6-2-4-7-2-6-5-2-7-4-2-5-6-2-1	0.0-3.0-7.0-4.0-8.0-5.0-6.0-2.0-4.1-7.1-2.1-6.1-5.1-2.0-7.0-4.0-2.1-5.0-6.0-2.0-1.0	154	323374	351276
HG02486#1#JAGYVM010000007.1_28868414_29370339_1	HG02486	351869	363609	5	78	0	3	74	11740	353079	341339	0-3-7-4-8-5-6-2-4-7-2-6-5-2-7-4-2-5-6-2-1	0.0-3.0-7.0-4.0-8.0-5.0-6.0-2.0-4.1-7.1-2.1-6.1-5.1-2.0-7.0-4.0-2.1-5.0-6.0-2.0-1.0	154	351715	363455
HG02486#1#JAGYVM010000007.1_28868414_29370339_1	HG02486	364690	367633	6	24	0	1	23	2943	356022	353079	0-3-7-4-8-5-6-2-4-7-2-6-5-2-7-4-2-5-6-2-1	0.0-3.0-7.0-4.0-8.0-5.0-6.0-2.0-4.1-7.1-2.1-6.1-5.1-2.0-7.0-4.0-2.1-5.0-6.0-2.0-1.0	154	364536	367479
HG02486#1#JAGYVM010000007.1_28868414_29370339_1	HG02486	367577	398796	2	172	0	0	171	31219	387241	356022	0-3-7-4-8-5-6-2-4-7-2-6-5-2-7-4-2-5-6-2-1	0.0-3.0-7.0-4.0-8.0-5.0-6.0-2.0-4.1-7.1-2.1-6.1-5.1-2.0-7.0-4.0-2.1-5.0-6.0-2.0-1.0	154	367423	398642
HG02486#1#JAGYVM010000007.1_28868414_29370339_1	HG02486	398740	501909	1	612	0	0	611	103169	490410	387241	0-3-7-4-8-5-6-2-4-7-2-6-5-2-7-4-2-5-6-2-1	0.0-3.0-7.0-4.0-8.0-5.0-6.0-2.0-4.1-7.1-2.1-6.1-5.1-2.0-7.0-4.0-2.1-5.0-6.0-2.0-1.0	154	398586	501755
HG02486#2#JAGYVL010000029.1_94163344_94570162_0	HG02486	98	115414	0	671	0	0	670	115316	115316	0	0-3-7-4-8-5-6-2-7-4-2-6-5-2-1	0.0-3.0-7.0-4.0-8.0-5.0-6.0-2.0-7.0-4.0-2.1-6.1-5.1-2.0-1.0	98	0	115316
HG02486#2#JAGYVL010000029.1_94163344_94570162_0	HG02486	115505	138340	3	132	0	0	131	22835	138151	115316	0-3-7-4-8-5-6-2-7-4-2-6-5-2-1	0.0-3.0-7.0-4.0-8.0-5.0-6.0-2.0-7.0-4.0-2.1-6.1-5.1-2.0-1.0	98	115407	138242
HG02486#2#JAGYVL010000029.1_94163344_94570162_0	HG02486	139099	142394	7	17	0	0	16	3295	141446	138151	0-3-7-4-8-5-6-2-7-4-2-6-5-2-1	0.0-3.0-7.0-4.0-8.0-5.0-6.0-2.0-7.0-4.0-2.1-6.1-5.1-2.0-1.0	98	139001	142296
HG02486#2#JAGYVL010000029.1_94163344_94570162_0	HG02486	142842	161414	4	96	0	0	95	18572	160018	141446	0-3-7-4-8-5-6-2-7-4-2-6-5-2-1	0.0-3.0-7.0-4.0-8.0-5.0-6.0-2.0-7.0-4.0-2.1-6.1-5.1-2.0-1.0	98	142744	161316
HG02486#2#JAGYVL010000029.1_94163344_94570162_0	HG02486	161358	163128	8	8	0	0	7	1770	161788	160018	0-3-7-4-8-5-6-2-7-4-2-6-5-2-1	0.0-3.0-7.0-4.0-8.0-5.0-6.0-2.0-7.0-4.0-2.1-6.1-5.1-2.0-1.0	98	161260	163030
HG02486#2#JAGYVL010000029.1_94163344_94570162_0	HG02486	163072	175262	5	78	0	0	74	12190	173978	161788	0-3-7-4-8-5-6-2-7-4-2-6-5-2-1	0.0-3.0-7.0-4.0-8.0-5.0-6.0-2.0-7.0-4.0-2.1-6.1-5.1-2.0-1.0	98	162974	175164
HG02486#2#JAGYVL010000029.1_94163344_94570162_0	HG02486	176343	178870	6	24	0	1	21	2527	176505	173978	0-3-7-4-8-5-6-2-7-4-2-6-5-2-1	0.0-3.0-7.0-4.0-8.0-5.0-6.0-2.0-7.0-4.0-2.1-6.1-5.1-2.0-1.0	98	176245	178772
HG02486#2#JAGYVL010000029.1_94163344_94570162_0	HG02486	179229	210442	2	172	0	0	171	31213	207718	176505	0-3-7-4-8-5-6-2-7-4-2-6-5-2-1	0.0-3.0-7.0-4.0-8.0-5.0-6.0-2.0-7.0-4.0-2.1-6.1-5.1-2.0-1.0	98	179131	210344
HG02486#2#JAGYVL010000029.1_94163344_94570162_0	HG02486	211519	214814	7	17	0	0	16	3295	211013	207718	0-3-7-4-8-5-6-2-7-4-2-6-5-2-1	0.0-3.0-7.0-4.0-8.0-5.0-6.0-2.0-7.0-4.0-2.1-6.1-5.1-2.0-1.0	98	211421	214716
HG02486#2#JAGYVL010000029.1_94163344_94570162_0	HG02486	215879	227429	4	96	0	4	58	11550	222563	211013	0-3-7-4-8-5-6-2-7-4-2-6-5-2-1	0.0-3.0-7.0-4.0-8.0-5.0-6.0-2.0-7.0-4.0-2.1-6.1-5.1-2.0-1.0	98	215781	227331
HG02486#2#JAGYVL010000029.1_94163344_94570162_0	HG02486	229295	260510	2	172	1	171	0	31215	253778	222563	0-3-7-4-8-5-6-2-7-4-2-6-5-2-1	0.0-3.0-7.0-4.0-8.0-5.0-6.0-2.0-7.0-4.0-2.1-6.1-5.1-2.0-1.0	98	229197	260412
HG02486#2#JAGYVL010000029.1_94163344_94570162_0	HG02486	260871	263398	6	24	1	21	1	2527	256305	253778	0-3-7-4-8-5-6-2-7-4-2-6-5-2-1	0.0-3.0-7.0-4.0-8.0-5.0-6.0-2.0-7.0-4.0-2.1-6.1-5.1-2.0-1.0	98	260773	263300
HG02486#2#JAGYVL010000029.1_94163344_94570162_0	HG02486	264005	276220	5	78	1	76	3	12215	268520	256305	0-3-7-4-8-5-6-2-7-4-2-6-5-2-1	0.0-3.0-7.0-4.0-8.0-5.0-6.0-2.0-7.0-4.0-2.1-6.1-5.1-2.0-1.0	98	263907	276122
HG02486#2#JAGYVL010000029.1_94163344_94570162_0	HG02486	276659	304566	2	172	0	15	171	27907	296427	268520	0-3-7-4-8-5-6-2-7-4-2-6-5-2-1	0.0-3.0-7.0-4.0-8.0-5.0-6.0-2.0-7.0-4.0-2.1-6.1-5.1-2.0-1.0	98	276561	304468
HG02486#2#JAGYVL010000029.1_94163344_94570162_0	HG02486	304510	406874	1	612	0	0	606	102364	398791	296427	0-3-7-4-8-5-6-2-7-4-2-6-5-2-1	0.0-3.0-7.0-4.0-8.0-5.0-6.0-2.0-7.0-4.0-2.1-6.1-5.1-2.0-1.0	98	304412	406776
HG02559#1#JAGYVK010000012.1_51505852_51913611_0	HG02559	98	115467	0	671	0	0	670	115369	115369	0	0-3-7-4-8-5-6-2-4-7-2-6-5-2-1	0.0-3.0-7.0-4.0-8.0-5.0-6.0-2.0-4.1-7.1-2.1-6.1-5.1-2.0-1.0	98	0	115369
HG02559#1#JAGYVK010000012.1_51505852_51913611_0	HG02559	115558	138394	3	132	0	0	131	22836	138205	115369	0-3-7-4-8-5-6-2-4-7-2-6-5-2-1	0.0-3.0-7.0-4.0-8.0-5.0-6.0-2.0-4.1-7.1-2.1-6.1-5.1-2.0-1.0	98	115460	138296
HG02559#1#JAGYVK010000012.1_51505852_51913611_0	HG02559	139153	142448	7	17	0	0	16	3295	141500	138205	0-3-7-4-8-5-6-2-4-7-2-6-5-2-1	0.0-3.0-7.0-4.0-8.0-5.0-6.0-2.0-4.1-7.1-2.1-6.1-5.1-2.0-1.0	98	139055	142350
HG02559#1#JAGYVK010000012.1_51505852_51913611_0	HG02559	142896	161454	4	96	0	0	95	18558	160058	141500	0-3-7-4-8-5-6-2-4-7-2-6-5-2-1	0.0-3.0-7.0-4.0-8.0-5.0-6.0-2.0-4.1-7.1-2.1-6.1-5.1-2.0-1.0	98	142798	161356
HG02559#1#JAGYVK010000012.1_51505852_51913611_0	HG02559	161398	163168	8	8	0	0	7	1770	161828	160058	0-3-7-4-8-5-6-2-4-7-2-6-5-2-1	0.0-3.0-7.0-4.0-8.0-5.0-6.0-2.0-4.1-7.1-2.1-6.1-5.1-2.0-1.0	98	161300	163070
HG02559#1#JAGYVK010000012.1_51505852_51913611_0	HG02559	163112	175302	5	78	0	0	74	12190	174018	161828	0-3-7-4-8-5-6-2-4-7-2-6-5-2-1	0.0-3.0-7.0-4.0-8.0-5.0-6.0-2.0-4.1-7.1-2.1-6.1-5.1-2.0-1.0	98	163014	175204
HG02559#1#JAGYVK010000012.1_51505852_51913611_0	HG02559	176383	179326	6	24	0	1	23	2943	176961	174018	0-3-7-4-8-5-6-2-4-7-2-6-5-2-1	0.0-3.0-7.0-4.0-8.0-5.0-6.0-2.0-4.1-7.1-2.1-6.1-5.1-2.0-1.0	98	176285	179228
HG02559#1#JAGYVK010000012.1_51505852_51913611_0	HG02559	179270	210103	2	172	0	0	170	30833	207794	176961	0-3-7-4-8-5-6-2-4-7-2-6-5-2-1	0.0-3.0-7.0-4.0-8.0-5.0-6.0-2.0-4.1-7.1-2.1-6.1-5.1-2.0-1.0	98	179172	210005
HG02559#1#JAGYVK010000012.1_51505852_51913611_0	HG02559	212354	223476	4	96	1	58	6	11122	218916	207794	0-3-7-4-8-5-6-2-4-7-2-6-5-2-1	0.0-3.0-7.0-4.0-8.0-5.0-6.0-2.0-4.1-7.1-2.1-6.1-5.1-2.0-1.0	98	212256	223378
HG02559#1#JAGYVK010000012.1_51505852_51913611_0	HG02559	224963	228258	7	17	1	16	0	3295	222211	218916	0-3-7-4-8-5-6-2-4-7-2-6-5-2-1	0.0-3.0-7.0-4.0-8.0-5.0-6.0-2.0-4.1-7.1-2.1-6.1-5.1-2.0-1.0	98	224865	228160
HG02559#1#JAGYVK010000012.1_51505852_51913611_0	HG02559	229720	260558	2	172	1	170	0	30838	253049	222211	0-3-7-4-8-5-6-2-4-7-2-6-5-2-1	0.0-3.0-7.0-4.0-8.0-5.0-6.0-2.0-4.1-7.1-2.1-6.1-5.1-2.0-1.0	98	229622	260460
HG02559#1#JAGYVK010000012.1_51505852_51913611_0	HG02559	260502	263445	6	24	1	23	1	2943	255992	253049	0-3-7-4-8-5-6-2-4-7-2-6-5-2-1	0.0-3.0-7.0-4.0-8.0-5.0-6.0-2.0-4.1-7.1-2.1-6.1-5.1-2.0-1.0	98	260404	263347
HG02559#1#JAGYVK010000012.1_51505852_51913611_0	HG02559	264526	276266	5	78	1	74	3	11740	267732	255992	0-3-7-4-8-5-6-2-4-7-2-6-5-2-1	0.0-3.0-7.0-4.0-8.0-5.0-6.0-2.0-4.1-7.1-2.1-6.1-5.1-2.0-1.0	98	264428	276168
HG02559#1#JAGYVK010000012.1_51505852_51913611_0	HG02559	276705	304615	2	172	0	15	171	27910	295642	267732	0-3-7-4-8-5-6-2-4-7-2-6-5-2-1	0.0-3.0-7.0-4.0-8.0-5.0-6.0-2.0-4.1-7.1-2.1-6.1-5.1-2.0-1.0	98	276607	304517
HG02559#1#JAGYVK010000012.1_51505852_51913611_0	HG02559	304559	407687	1	612	0	0	611	103128	398770	295642	0-3-7-4-8-5-6-2-4-7-2-6-5-2-1	0.0-3.0-7.0-4.0-8.0-5.0-6.0-2.0-4.1-7.1-2.1-6.1-5.1-2.0-1.0	98	304461	407589
HG02559#2#JAGYVJ010000037.1_52167780_52574597_1	HG02559	154	115474	0	671	0	0	670	115320	115320	0	0-3-7-4-8-5-6-2-4-7-2-6-5-2-1	0.0-3.0-7.0-4.0-8.0-5.0-6.0-2.0-4.1-7.1-2.1-6.1-5.1-2.0-1.0	154	0	115320
HG02559#2#JAGYVJ010000037.1_52167780_52574597_1	HG02559	115987	138396	3	132	0	2	131	22409	137729	115320	0-3-7-4-8-5-6-2-4-7-2-6-5-2-1	0.0-3.0-7.0-4.0-8.0-5.0-6.0-2.0-4.1-7.1-2.1-6.1-5.1-2.0-1.0	154	115833	138242
HG02559#2#JAGYVJ010000037.1_52167780_52574597_1	HG02559	139155	142450	7	17	0	0	16	3295	141024	137729	0-3-7-4-8-5-6-2-4-7-2-6-5-2-1	0.0-3.0-7.0-4.0-8.0-5.0-6.0-2.0-4.1-7.1-2.1-6.1-5.1-2.0-1.0	154	139001	142296
HG02559#2#JAGYVJ010000037.1_52167780_52574597_1	HG02559	143241	161448	4	96	0	1	95	18207	159231	141024	0-3-7-4-8-5-6-2-4-7-2-6-5-2-1	0.0-3.0-7.0-4.0-8.0-5.0-6.0-2.0-4.1-7.1-2.1-6.1-5.1-2.0-1.0	154	143087	161294
HG02559#2#JAGYVJ010000037.1_52167780_52574597_1	HG02559	161392	163162	8	8	0	0	7	1770	161001	159231	0-3-7-4-8-5-6-2-4-7-2-6-5-2-1	0.0-3.0-7.0-4.0-8.0-5.0-6.0-2.0-4.1-7.1-2.1-6.1-5.1-2.0-1.0	154	161238	163008
HG02559#2#JAGYVJ010000037.1_52167780_52574597_1	HG02559	163106	176210	5	78	0	0	77	13104	174105	161001	0-3-7-4-8-5-6-2-4-7-2-6-5-2-1	0.0-3.0-7.0-4.0-8.0-5.0-6.0-2.0-4.1-7.1-2.1-6.1-5.1-2.0-1.0	154	162952	176056
HG02559#2#JAGYVJ010000037.1_52167780_52574597_1	HG02559	176154	178898	6	24	0	0	21	2744	176849	174105	0-3-7-4-8-5-6-2-4-7-2-6-5-2-1	0.0-3.0-7.0-4.0-8.0-5.0-6.0-2.0-4.1-7.1-2.1-6.1-5.1-2.0-1.0	154	176000	178744
HG02559#2#JAGYVJ010000037.1_52167780_52574597_1	HG02559	179257	210525	2	172	0	0	171	31268	208117	176849	0-3-7-4-8-5-6-2-4-7-2-6-5-2-1	0.0-3.0-7.0-4.0-8.0-5.0-6.0-2.0-4.1-7.1-2.1-6.1-5.1-2.0-1.0	154	179103	210371
HG02559#2#JAGYVJ010000037.1_52167780_52574597_1	HG02559	212391	223937	4	96	1	58	4	11546	219663	208117	0-3-7-4-8-5-6-2-4-7-2-6-5-2-1	0.0-3.0-7.0-4.0-8.0-5.0-6.0-2.0-4.1-7.1-2.1-6.1-5.1-2.0-1.0	154	212237	223783
HG02559#2#JAGYVJ010000037.1_52167780_52574597_1	HG02559	225000	228295	7	17	1	16	0	3295	222958	219663	0-3-7-4-8-5-6-2-4-7-2-6-5-2-1	0.0-3.0-7.0-4.0-8.0-5.0-6.0-2.0-4.1-7.1-2.1-6.1-5.1-2.0-1.0	154	224846	228141
HG02559#2#JAGYVJ010000037.1_52167780_52574597_1	HG02559	229372	260567	2	172	1	171	0	31195	254153	222958	0-3-7-4-8-5-6-2-4-7-2-6-5-2-1	0.0-3.0-7.0-4.0-8.0-5.0-6.0-2.0-4.1-7.1-2.1-6.1-5.1-2.0-1.0	154	229218	260413
HG02559#2#JAGYVJ010000037.1_52167780_52574597_1	HG02559	260926	263453	6	24	1	21	1	2527	256680	254153	0-3-7-4-8-5-6-2-4-7-2-6-5-2-1	0.0-3.0-7.0-4.0-8.0-5.0-6.0-2.0-4.1-7.1-2.1-6.1-5.1-2.0-1.0	154	260772	263299
HG02559#2#JAGYVJ010000037.1_52167780_52574597_1	HG02559	264063	276278	5	78	1	76	3	12215	268895	256680	0-3-7-4-8-5-6-2-4-7-2-6-5-2-1	0.0-3.0-7.0-4.0-8.0-5.0-6.0-2.0-4.1-7.1-2.1-6.1-5.1-2.0-1.0	154	263909	276124
HG02559#2#JAGYVJ010000037.1_52167780_52574597_1	HG02559	276717	304622	2	172	0	15	171	27905	296800	268895	0-3-7-4-8-5-6-2-4-7-2-6-5-2-1	0.0-3.0-7.0-4.0-8.0-5.0-6.0-2.0-4.1-7.1-2.1-6.1-5.1-2.0-1.0	154	276563	304468
HG02559#2#JAGYVJ010000037.1_52167780_52574597_1	HG02559	304566	406755	1	612	0	0	605	102189	398989	296800	0-3-7-4-8-5-6-2-4-7-2-6-5-2-1	0.0-3.0-7.0-4.0-8.0-5.0-6.0-2.0-4.1-7.1-2.1-6.1-5.1-2.0-1.0	154	304412	406601
HG02622#1#JAHAOO010000002.1_16673678_17080663_0	HG02622	98	115495	0	671	0	0	670	115397	115397	0	0-3-7-4-8-5-6-2-4-7-2-5-6-2-1	0.0-3.0-7.0-4.0-8.0-5.0-6.0-2.0-4.1-7.1-2.1-5.0-6.0-2.0-1.0	98	0	115397
HG02622#1#JAHAOO010000002.1_16673678_17080663_0	HG02622	115586	138419	3	132	0	0	131	22833	138230	115397	0-3-7-4-8-5-6-2-4-7-2-5-6-2-1	0.0-3.0-7.0-4.0-8.0-5.0-6.0-2.0-4.1-7.1-2.1-5.0-6.0-2.0-1.0	98	115488	138321
HG02622#1#JAHAOO010000002.1_16673678_17080663_0	HG02622	139178	142473	7	17	0	0	16	3295	141525	138230	0-3-7-4-8-5-6-2-4-7-2-5-6-2-1	0.0-3.0-7.0-4.0-8.0-5.0-6.0-2.0-4.1-7.1-2.1-5.0-6.0-2.0-1.0	98	139080	142375
HG02622#1#JAHAOO010000002.1_16673678_17080663_0	HG02622	143538	161508	4	96	0	4	95	17970	159495	141525	0-3-7-4-8-5-6-2-4-7-2-5-6-2-1	0.0-3.0-7.0-4.0-8.0-5.0-6.0-2.0-4.1-7.1-2.1-5.0-6.0-2.0-1.0	98	143440	161410
HG02622#1#JAHAOO010000002.1_16673678_17080663_0	HG02622	161452	163222	8	8	0	0	7	1770	161265	159495	0-3-7-4-8-5-6-2-4-7-2-5-6-2-1	0.0-3.0-7.0-4.0-8.0-5.0-6.0-2.0-4.1-7.1-2.1-5.0-6.0-2.0-1.0	98	161354	163124
HG02622#1#JAHAOO010000002.1_16673678_17080663_0	HG02622	163166	175864	5	78	0	0	76	12698	173963	161265	0-3-7-4-8-5-6-2-4-7-2-5-6-2-1	0.0-3.0-7.0-4.0-8.0-5.0-6.0-2.0-4.1-7.1-2.1-5.0-6.0-2.0-1.0	98	163068	175766
HG02622#1#JAHAOO010000002.1_16673678_17080663_0	HG02622	176471	178998	6	24	0	1	21	2527	176490	173963	0-3-7-4-8-5-6-2-4-7-2-5-6-2-1	0.0-3.0-7.0-4.0-8.0-5.0-6.0-2.0-4.1-7.1-2.1-5.0-6.0-2.0-1.0	98	176373	178900
HG02622#1#JAHAOO010000002.1_16673678_17080663_0	HG02622	179356	210578	2	172	0	0	171	31222	207712	176490	0-3-7-4-8-5-6-2-4-7-2-5-6-2-1	0.0-3.0-7.0-4.0-8.0-5.0-6.0-2.0-4.1-7.1-2.1-5.0-6.0-2.0-1.0	98	179258	210480
HG02622#1#JAHAOO010000002.1_16673678_17080663_0	HG02622	212894	223988	4	96	1	56	4	11094	218806	207712	0-3-7-4-8-5-6-2-4-7-2-5-6-2-1	0.0-3.0-7.0-4.0-8.0-5.0-6.0-2.0-4.1-7.1-2.1-5.0-6.0-2.0-1.0	98	212796	223890
HG02622#1#JAHAOO010000002.1_16673678_17080663_0	HG02622	225053	228348	7	17	1	16	0	3295	222101	218806	0-3-7-4-8-5-6-2-4-7-2-5-6-2-1	0.0-3.0-7.0-4.0-8.0-5.0-6.0-2.0-4.1-7.1-2.1-5.0-6.0-2.0-1.0	98	224955	228250
HG02622#1#JAHAOO010000002.1_16673678_17080663_0	HG02622	229425	256888	2	172	1	171	17	27463	249564	222101	0-3-7-4-8-5-6-2-4-7-2-5-6-2-1	0.0-3.0-7.0-4.0-8.0-5.0-6.0-2.0-4.1-7.1-2.1-5.0-6.0-2.0-1.0	98	229327	256790
HG02622#1#JAHAOO010000002.1_16673678_17080663_0	HG02622	258305	269519	5	78	0	5	74	11214	260778	249564	0-3-7-4-8-5-6-2-4-7-2-5-6-2-1	0.0-3.0-7.0-4.0-8.0-5.0-6.0-2.0-4.1-7.1-2.1-5.0-6.0-2.0-1.0	98	258207	269421
HG02622#1#JAHAOO010000002.1_16673678_17080663_0	HG02622	270600	273127	6	24	0	1	21	2527	263305	260778	0-3-7-4-8-5-6-2-4-7-2-5-6-2-1	0.0-3.0-7.0-4.0-8.0-5.0-6.0-2.0-4.1-7.1-2.1-5.0-6.0-2.0-1.0	98	270502	273029
HG02622#1#JAHAOO010000002.1_16673678_17080663_0	HG02622	273485	304702	2	172	0	0	171	31217	294522	263305	0-3-7-4-8-5-6-2-4-7-2-5-6-2-1	0.0-3.0-7.0-4.0-8.0-5.0-6.0-2.0-4.1-7.1-2.1-5.0-6.0-2.0-1.0	98	273387	304604
HG02622#1#JAHAOO010000002.1_16673678_17080663_0	HG02622	304646	407041	1	612	0	0	606	102395	396917	294522	0-3-7-4-8-5-6-2-4-7-2-5-6-2-1	0.0-3.0-7.0-4.0-8.0-5.0-6.0-2.0-4.1-7.1-2.1-5.0-6.0-2.0-1.0	98	304548	406943
HG02622#2#JAHAON010000012.1_51551779_52031001_0	HG02622	98	115401	0	671	0	0	670	115303	115303	0	0-3-7-4-8-5-6-2-7-4-2-6-5-8-4-7-2-5-6-2-1	0.0-3.0-7.0-4.0-8.0-5.0-6.0-2.0-7.0-4.0-2.1-6.1-5.1-8.1-4.1-7.1-2.1-5.0-6.0-2.0-1.0	98	0	115303
HG02622#2#JAHAON010000012.1_51551779_52031001_0	HG02622	115492	138312	3	132	0	0	131	22820	138123	115303	0-3-7-4-8-5-6-2-7-4-2-6-5-8-4-7-2-5-6-2-1	0.0-3.0-7.0-4.0-8.0-5.0-6.0-2.0-7.0-4.0-2.1-6.1-5.1-8.1-4.1-7.1-2.1-5.0-6.0-2.0-1.0	98	115394	138214
HG02622#2#JAHAON010000012.1_51551779_52031001_0	HG02622	139071	142366	7	17	0	0	16	3295	141418	138123	0-3-7-4-8-5-6-2-7-4-2-6-5-8-4-7-2-5-6-2-1	0.0-3.0-7.0-4.0-8.0-5.0-6.0-2.0-7.0-4.0-2.1-6.1-5.1-8.1-4.1-7.1-2.1-5.0-6.0-2.0-1.0	98	138973	142268
HG02622#2#JAHAON010000012.1_51551779_52031001_0	HG02622	142814	161390	4	96	0	0	95	18576	159994	141418	0-3-7-4-8-5-6-2-7-4-2-6-5-8-4-7-2-5-6-2-1	0.0-3.0-7.0-4.0-8.0-5.0-6.0-2.0-7.0-4.0-2.1-6.1-5.1-8.1-4.1-7.1-2.1-5.0-6.0-2.0-1.0	98	142716	161292
HG02622#2#JAHAON010000012.1_51551779_52031001_0	HG02622	161334	163104	8	8	0	0	7	1770	161764	159994	0-3-7-4-8-5-6-2-7-4-2-6-5-8-4-7-2-5-6-2-1	0.0-3.0-7.0-4.0-8.0-5.0-6.0-2.0-7.0-4.0-2.1-6.1-5.1-8.1-4.1-7.1-2.1-5.0-6.0-2.0-1.0	98	161236	163006
HG02622#2#JAHAON010000012.1_51551779_52031001_0	HG02622	163048	176152	5	78	0	0	77	13104	174868	161764	0-3-7-4-8-5-6-2-7-4-2-6-5-8-4-7-2-5-6-2-1	0.0-3.0-7.0-4.0-8.0-5.0-6.0-2.0-7.0-4.0-2.1-6.1-5.1-8.1-4.1-7.1-2.1-5.0-6.0-2.0-1.0	98	162950	176054
HG02622#2#JAHAON010000012.1_51551779_52031001_0	HG02622	176096	178840	6	24	0	0	21	2744	177612	174868	0-3-7-4-8-5-6-2-7-4-2-6-5-8-4-7-2-5-6-2-1	0.0-3.0-7.0-4.0-8.0-5.0-6.0-2.0-7.0-4.0-2.1-6.1-5.1-8.1-4.1-7.1-2.1-5.0-6.0-2.0-1.0	98	175998	178742
HG02622#2#JAHAON010000012.1_51551779_52031001_0	HG02622	179199	210418	2	172	0	0	171	31219	208831	177612	0-3-7-4-8-5-6-2-7-4-2-6-5-8-4-7-2-5-6-2-1	0.0-3.0-7.0-4.0-8.0-5.0-6.0-2.0-7.0-4.0-2.1-6.1-5.1-8.1-4.1-7.1-2.1-5.0-6.0-2.0-1.0	98	179101	210320
HG02622#2#JAHAON010000012.1_51551779_52031001_0	HG02622	211495	214790	7	17	0	0	16	3295	212126	208831	0-3-7-4-8-5-6-2-7-4-2-6-5-8-4-7-2-5-6-2-1	0.0-3.0-7.0-4.0-8.0-5.0-6.0-2.0-7.0-4.0-2.1-6.1-5.1-8.1-4.1-7.1-2.1-5.0-6.0-2.0-1.0	98	211397	214692
HG02622#2#JAHAON010000012.1_51551779_52031001_0	HG02622	215853	227387	4	96	0	4	58	11534	223660	212126	0-3-7-4-8-5-6-2-7-4-2-6-5-8-4-7-2-5-6-2-1	0.0-3.0-7.0-4.0-8.0-5.0-6.0-2.0-7.0-4.0-2.1-6.1-5.1-8.1-4.1-7.1-2.1-5.0-6.0-2.0-1.0	98	215755	227289
HG02622#2#JAHAON010000012.1_51551779_52031001_0	HG02622	229253	260471	2	172	1	171	0	31218	254878	223660	0-3-7-4-8-5-6-2-7-4-2-6-5-8-4-7-2-5-6-2-1	0.0-3.0-7.0-4.0-8.0-5.0-6.0-2.0-7.0-4.0-2.1-6.1-5.1-8.1-4.1-7.1-2.1-5.0-6.0-2.0-1.0	98	229155	260373
HG02622#2#JAHAON010000012.1_51551779_52031001_0	HG02622	260830	263574	6	24	1	21	0	2744	257622	254878	0-3-7-4-8-5-6-2-7-4-2-6-5-8-4-7-2-5-6-2-1	0.0-3.0-7.0-4.0-8.0-5.0-6.0-2.0-7.0-4.0-2.1-6.1-5.1-8.1-4.1-7.1-2.1-5.0-6.0-2.0-1.0	98	260732	263476
HG02622#2#JAHAON010000012.1_51551779_52031001_0	HG02622	263518	276622	5	78	1	77	0	13104	270726	257622	0-3-7-4-8-5-6-2-7-4-2-6-5-8-4-7-2-5-6-2-1	0.0-3.0-7.0-4.0-8.0-5.0-6.0-2.0-7.0-4.0-2.1-6.1-5.1-8.1-4.1-7.1-2.1-5.0-6.0-2.0-1.0	98	263420	276524
HG02622#2#JAHAON010000012.1_51551779_52031001_0	HG02622	276810	278336	8	8	1	6	0	1526	272252	270726	0-3-7-4-8-5-6-2-7-4-2-6-5-8-4-7-2-5-6-2-1	0.0-3.0-7.0-4.0-8.0-5.0-6.0-2.0-7.0-4.0-2.1-6.1-5.1-8.1-4.1-7.1-2.1-5.0-6.0-2.0-1.0	98	276712	278238
HG02622#2#JAHAON010000012.1_51551779_52031001_0	HG02622	278280	296854	4	96	1	95	0	18574	290826	272252	0-3-7-4-8-5-6-2-7-4-2-6-5-8-4-7-2-5-6-2-1	0.0-3.0-7.0-4.0-8.0-5.0-6.0-2.0-7.0-4.0-2.1-6.1-5.1-8.1-4.1-7.1-2.1-5.0-6.0-2.0-1.0	98	278182	296756
HG02622#2#JAHAON010000012.1_51551779_52031001_0	HG02622	297302	300597	7	17	1	16	0	3295	294121	290826	0-3-7-4-8-5-6-2-7-4-2-6-5-8-4-7-2-5-6-2-1	0.0-3.0-7.0-4.0-8.0-5.0-6.0-2.0-7.0-4.0-2.1-6.1-5.1-8.1-4.1-7.1-2.1-5.0-6.0-2.0-1.0	98	297204	300499
HG02622#2#JAHAON010000012.1_51551779_52031001_0	HG02622	301674	329590	2	172	1	171	15	27916	322037	294121	0-3-7-4-8-5-6-2-7-4-2-6-5-8-4-7-2-5-6-2-1	0.0-3.0-7.0-4.0-8.0-5.0-6.0-2.0-7.0-4.0-2.1-6.1-5.1-8.1-4.1-7.1-2.1-5.0-6.0-2.0-1.0	98	301576	329492
HG02622#2#JAHAON010000012.1_51551779_52031001_0	HG02622	330029	342209	5	78	0	3	76	12180	334217	322037	0-3-7-4-8-5-6-2-7-4-2-6-5-8-4-7-2-5-6-2-1	0.0-3.0-7.0-4.0-8.0-5.0-6.0-2.0-7.0-4.0-2.1-6.1-5.1-8.1-4.1-7.1-2.1-5.0-6.0-2.0-1.0	98	329931	342111
HG02622#2#JAHAON010000012.1_51551779_52031001_0	HG02622	342816	345343	6	24	0	1	21	2527	336744	334217	0-3-7-4-8-5-6-2-7-4-2-6-5-8-4-7-2-5-6-2-1	0.0-3.0-7.0-4.0-8.0-5.0-6.0-2.0-7.0-4.0-2.1-6.1-5.1-8.1-4.1-7.1-2.1-5.0-6.0-2.0-1.0	98	342718	345245
HG02622#2#JAHAON010000012.1_51551779_52031001_0	HG02622	345702	376918	2	172	0	0	171	31216	367960	336744	0-3-7-4-8-5-6-2-7-4-2-6-5-8-4-7-2-5-6-2-1	0.0-3.0-7.0-4.0-8.0-5.0-6.0-2.0-7.0-4.0-2.1-6.1-5.1-8.1-4.1-7.1-2.1-5.0-6.0-2.0-1.0	98	345604	376820
HG02622#2#JAHAON010000012.1_51551779_52031001_0	HG02622	376862	479278	1	612	0	0	606	102416	470376	367960	0-3-7-4-8-5-6-2-7-4-2-6-5-8-4-7-2-5-6-2-1	0.0-3.0-7.0-4.0-8.0-5.0-6.0-2.0-7.0-4.0-2.1-6.1-5.1-8.1-4.1-7.1-2.1-5.0-6.0-2.0-1.0	98	376764	479180
HG02630#1#JAHAOQ010000102.1_16672145_17079089_0	HG02630	98	115456	0	671	0	0	670	115358	115358	0	0-3-7-4-8-5-6-2-4-7-2-5-6-2-1	0.0-3.0-7.0-4.0-8.0-5.0-6.0-2.0-4.1-7.1-2.1-5.0-6.0-2.0-1.0	98	0	115358
HG02630#1#JAHAOQ010000102.1_16672145_17079089_0	HG02630	115547	138380	3	132	0	0	131	22833	138191	115358	0-3-7-4-8-5-6-2-4-7-2-5-6-2-1	0.0-3.0-7.0-4.0-8.0-5.0-6.0-2.0-4.1-7.1-2.1-5.0-6.0-2.0-1.0	98	115449	138282
HG02630#1#JAHAOQ010000102.1_16672145_17079089_0	HG02630	139139	142434	7	17	0	0	16	3295	141486	138191	0-3-7-4-8-5-6-2-4-7-2-5-6-2-1	0.0-3.0-7.0-4.0-8.0-5.0-6.0-2.0-4.1-7.1-2.1-5.0-6.0-2.0-1.0	98	139041	142336
HG02630#1#JAHAOQ010000102.1_16672145_17079089_0	HG02630	143499	161470	4	96	0	4	95	17971	159457	141486	0-3-7-4-8-5-6-2-4-7-2-5-6-2-1	0.0-3.0-7.0-4.0-8.0-5.0-6.0-2.0-4.1-7.1-2.1-5.0-6.0-2.0-1.0	98	143401	161372
HG02630#1#JAHAOQ010000102.1_16672145_17079089_0	HG02630	161414	163184	8	8	0	0	7	1770	161227	159457	0-3-7-4-8-5-6-2-4-7-2-5-6-2-1	0.0-3.0-7.0-4.0-8.0-5.0-6.0-2.0-4.1-7.1-2.1-5.0-6.0-2.0-1.0	98	161316	163086
HG02630#1#JAHAOQ010000102.1_16672145_17079089_0	HG02630	163128	175352	5	78	0	0	74	12224	173451	161227	0-3-7-4-8-5-6-2-4-7-2-5-6-2-1	0.0-3.0-7.0-4.0-8.0-5.0-6.0-2.0-4.1-7.1-2.1-5.0-6.0-2.0-1.0	98	163030	175254
HG02630#1#JAHAOQ010000102.1_16672145_17079089_0	HG02630	176433	178960	6	24	0	1	21	2527	175978	173451	0-3-7-4-8-5-6-2-4-7-2-5-6-2-1	0.0-3.0-7.0-4.0-8.0-5.0-6.0-2.0-4.1-7.1-2.1-5.0-6.0-2.0-1.0	98	176335	178862
HG02630#1#JAHAOQ010000102.1_16672145_17079089_0	HG02630	179344	210562	2	172	0	0	171	31218	207196	175978	0-3-7-4-8-5-6-2-4-7-2-5-6-2-1	0.0-3.0-7.0-4.0-8.0-5.0-6.0-2.0-4.1-7.1-2.1-5.0-6.0-2.0-1.0	98	179246	210464
HG02630#1#JAHAOQ010000102.1_16672145_17079089_0	HG02630	212878	223973	4	96	1	56	4	11095	218291	207196	0-3-7-4-8-5-6-2-4-7-2-5-6-2-1	0.0-3.0-7.0-4.0-8.0-5.0-6.0-2.0-4.1-7.1-2.1-5.0-6.0-2.0-1.0	98	212780	223875
HG02630#1#JAHAOQ010000102.1_16672145_17079089_0	HG02630	225036	228331	7	17	1	16	0	3295	221586	218291	0-3-7-4-8-5-6-2-4-7-2-5-6-2-1	0.0-3.0-7.0-4.0-8.0-5.0-6.0-2.0-4.1-7.1-2.1-5.0-6.0-2.0-1.0	98	224938	228233
HG02630#1#JAHAOQ010000102.1_16672145_17079089_0	HG02630	229408	257316	2	172	1	171	15	27908	249494	221586	0-3-7-4-8-5-6-2-4-7-2-5-6-2-1	0.0-3.0-7.0-4.0-8.0-5.0-6.0-2.0-4.1-7.1-2.1-5.0-6.0-2.0-1.0	98	229310	257218
HG02630#1#JAHAOQ010000102.1_16672145_17079089_0	HG02630	258282	269496	5	78	0	5	74	11214	260708	249494	0-3-7-4-8-5-6-2-4-7-2-5-6-2-1	0.0-3.0-7.0-4.0-8.0-5.0-6.0-2.0-4.1-7.1-2.1-5.0-6.0-2.0-1.0	98	258184	269398
HG02630#1#JAHAOQ010000102.1_16672145_17079089_0	HG02630	270577	273104	6	24	0	1	21	2527	263235	260708	0-3-7-4-8-5-6-2-4-7-2-5-6-2-1	0.0-3.0-7.0-4.0-8.0-5.0-6.0-2.0-4.1-7.1-2.1-5.0-6.0-2.0-1.0	98	270479	273006
HG02630#1#JAHAOQ010000102.1_16672145_17079089_0	HG02630	273463	304666	2	172	0	0	171	31203	294438	263235	0-3-7-4-8-5-6-2-4-7-2-5-6-2-1	0.0-3.0-7.0-4.0-8.0-5.0-6.0-2.0-4.1-7.1-2.1-5.0-6.0-2.0-1.0	98	273365	304568
HG02630#1#JAHAOQ010000102.1_16672145_17079089_0	HG02630	304610	407000	1	612	0	0	606	102390	396828	294438	0-3-7-4-8-5-6-2-4-7-2-5-6-2-1	0.0-3.0-7.0-4.0-8.0-5.0-6.0-2.0-4.1-7.1-2.1-5.0-6.0-2.0-1.0	98	304512	406902
HG02630#2#JAHAOP010000089.1_16669255_17076135_0	HG02630	98	115461	0	671	0	0	670	115363	115363	0	0-3-7-4-8-5-6-2-7-4-2-6-5-2-1	0.0-3.0-7.0-4.0-8.0-5.0-6.0-2.0-7.0-4.0-2.1-6.1-5.1-2.0-1.0	98	0	115363
HG02630#2#JAHAOP010000089.1_16669255_17076135_0	HG02630	115552	138385	3	132	0	0	131	22833	138196	115363	0-3-7-4-8-5-6-2-7-4-2-6-5-2-1	0.0-3.0-7.0-4.0-8.0-5.0-6.0-2.0-7.0-4.0-2.1-6.1-5.1-2.0-1.0	98	115454	138287
HG02630#2#JAHAOP010000089.1_16669255_17076135_0	HG02630	139144	142439	7	17	0	0	16	3295	141491	138196	0-3-7-4-8-5-6-2-7-4-2-6-5-2-1	0.0-3.0-7.0-4.0-8.0-5.0-6.0-2.0-7.0-4.0-2.1-6.1-5.1-2.0-1.0	98	139046	142341
HG02630#2#JAHAOP010000089.1_16669255_17076135_0	HG02630	143233	161454	4	96	0	1	95	18221	159712	141491	0-3-7-4-8-5-6-2-7-4-2-6-5-2-1	0.0-3.0-7.0-4.0-8.0-5.0-6.0-2.0-7.0-4.0-2.1-6.1-5.1-2.0-1.0	98	143135	161356
HG02630#2#JAHAOP010000089.1_16669255_17076135_0	HG02630	161398	163168	8	8	0	0	7	1770	161482	159712	0-3-7-4-8-5-6-2-7-4-2-6-5-2-1	0.0-3.0-7.0-4.0-8.0-5.0-6.0-2.0-7.0-4.0-2.1-6.1-5.1-2.0-1.0	98	161300	163070
HG02630#2#JAHAOP010000089.1_16669255_17076135_0	HG02630	163112	175776	5	78	0	0	76	12664	174146	161482	0-3-7-4-8-5-6-2-7-4-2-6-5-2-1	0.0-3.0-7.0-4.0-8.0-5.0-6.0-2.0-7.0-4.0-2.1-6.1-5.1-2.0-1.0	98	163014	175678
HG02630#2#JAHAOP010000089.1_16669255_17076135_0	HG02630	176383	179326	6	24	0	1	23	2943	177089	174146	0-3-7-4-8-5-6-2-7-4-2-6-5-2-1	0.0-3.0-7.0-4.0-8.0-5.0-6.0-2.0-7.0-4.0-2.1-6.1-5.1-2.0-1.0	98	176285	179228
HG02630#2#JAHAOP010000089.1_16669255_17076135_0	HG02630	179270	210495	2	172	0	0	171	31225	208314	177089	0-3-7-4-8-5-6-2-7-4-2-6-5-2-1	0.0-3.0-7.0-4.0-8.0-5.0-6.0-2.0-7.0-4.0-2.1-6.1-5.1-2.0-1.0	98	179172	210397
HG02630#2#JAHAOP010000089.1_16669255_17076135_0	HG02630	211572	214867	7	17	0	0	16	3295	211609	208314	0-3-7-4-8-5-6-2-7-4-2-6-5-2-1	0.0-3.0-7.0-4.0-8.0-5.0-6.0-2.0-7.0-4.0-2.1-6.1-5.1-2.0-1.0	98	211474	214769
HG02630#2#JAHAOP010000089.1_16669255_17076135_0	HG02630	215934	227489	4	96	0	4	58	11555	223164	211609	0-3-7-4-8-5-6-2-7-4-2-6-5-2-1	0.0-3.0-7.0-4.0-8.0-5.0-6.0-2.0-7.0-4.0-2.1-6.1-5.1-2.0-1.0	98	215836	227391
HG02630#2#JAHAOP010000089.1_16669255_17076135_0	HG02630	229355	260580	2	172	1	171	0	31225	254389	223164	0-3-7-4-8-5-6-2-7-4-2-6-5-2-1	0.0-3.0-7.0-4.0-8.0-5.0-6.0-2.0-7.0-4.0-2.1-6.1-5.1-2.0-1.0	98	229257	260482
HG02630#2#JAHAOP010000089.1_16669255_17076135_0	HG02630	260524	263467	6	24	1	23	1	2943	257332	254389	0-3-7-4-8-5-6-2-7-4-2-6-5-2-1	0.0-3.0-7.0-4.0-8.0-5.0-6.0-2.0-7.0-4.0-2.1-6.1-5.1-2.0-1.0	98	260426	263369
HG02630#2#JAHAOP010000089.1_16669255_17076135_0	HG02630	264074	276290	5	78	1	76	3	12216	269548	257332	0-3-7-4-8-5-6-2-7-4-2-6-5-2-1	0.0-3.0-7.0-4.0-8.0-5.0-6.0-2.0-7.0-4.0-2.1-6.1-5.1-2.0-1.0	98	263976	276192
HG02630#2#JAHAOP010000089.1_16669255_17076135_0	HG02630	276729	304643	2	172	0	15	171	27914	297462	269548	0-3-7-4-8-5-6-2-7-4-2-6-5-2-1	0.0-3.0-7.0-4.0-8.0-5.0-6.0-2.0-7.0-4.0-2.1-6.1-5.1-2.0-1.0	98	276631	304545
HG02630#2#JAHAOP010000089.1_16669255_17076135_0	HG02630	305638	406936	1	612	0	5	606	101298	398760	297462	0-3-7-4-8-5-6-2-7-4-2-6-5-2-1	0.0-3.0-7.0-4.0-8.0-5.0-6.0-2.0-7.0-4.0-2.1-6.1-5.1-2.0-1.0	98	305540	406838
HG02647.verkko_filt_mat.fa:haplotype1-0000002_103892584_104321036_0	HG02647	98	115448	0	671	0	0	670	115350	115350	0	0-3-7-4-8-5-6-2-4-0-3-7-4-8-5-6-2-1	0.0-3.0-7.0-4.0-8.0-5.0-6.0-2.0-4.1-0.0-3.0-7.0-4.0-8.0-5.0-6.0-2.0-1.0	98	0	115350
HG02647.verkko_filt_mat.fa:haplotype1-0000002_103892584_104321036_0	HG02647	115539	138371	3	132	0	0	131	22832	138182	115350	0-3-7-4-8-5-6-2-4-0-3-7-4-8-5-6-2-1	0.0-3.0-7.0-4.0-8.0-5.0-6.0-2.0-4.1-0.0-3.0-7.0-4.0-8.0-5.0-6.0-2.0-1.0	98	115441	138273
HG02647.verkko_filt_mat.fa:haplotype1-0000002_103892584_104321036_0	HG02647	139130	142426	7	17	0	0	16	3296	141478	138182	0-3-7-4-8-5-6-2-4-0-3-7-4-8-5-6-2-1	0.0-3.0-7.0-4.0-8.0-5.0-6.0-2.0-4.1-0.0-3.0-7.0-4.0-8.0-5.0-6.0-2.0-1.0	98	139032	142328
HG02647.verkko_filt_mat.fa:haplotype1-0000002_103892584_104321036_0	HG02647	142874	161445	4	96	0	0	95	18571	160049	141478	0-3-7-4-8-5-6-2-4-0-3-7-4-8-5-6-2-1	0.0-3.0-7.0-4.0-8.0-5.0-6.0-2.0-4.1-0.0-3.0-7.0-4.0-8.0-5.0-6.0-2.0-1.0	98	142776	161347
HG02647.verkko_filt_mat.fa:haplotype1-0000002_103892584_104321036_0	HG02647	161389	163159	8	8	0	0	7	1770	161819	160049	0-3-7-4-8-5-6-2-4-0-3-7-4-8-5-6-2-1	0.0-3.0-7.0-4.0-8.0-5.0-6.0-2.0-4.1-0.0-3.0-7.0-4.0-8.0-5.0-6.0-2.0-1.0	98	161291	163061
HG02647.verkko_filt_mat.fa:haplotype1-0000002_103892584_104321036_0	HG02647	163103	176207	5	78	0	0	77	13104	174923	161819	0-3-7-4-8-5-6-2-4-0-3-7-4-8-5-6-2-1	0.0-3.0-7.0-4.0-8.0-5.0-6.0-2.0-4.1-0.0-3.0-7.0-4.0-8.0-5.0-6.0-2.0-1.0	98	163005	176109
HG02647.verkko_filt_mat.fa:haplotype1-0000002_103892584_104321036_0	HG02647	176151	179311	6	24	0	0	23	3160	178083	174923	0-3-7-4-8-5-6-2-4-0-3-7-4-8-5-6-2-1	0.0-3.0-7.0-4.0-8.0-5.0-6.0-2.0-4.1-0.0-3.0-7.0-4.0-8.0-5.0-6.0-2.0-1.0	98	176053	179213
HG02647.verkko_filt_mat.fa:haplotype1-0000002_103892584_104321036_0	HG02647	179255	210461	2	172	0	0	171	31206	209289	178083	0-3-7-4-8-5-6-2-4-0-3-7-4-8-5-6-2-1	0.0-3.0-7.0-4.0-8.0-5.0-6.0-2.0-4.1-0.0-3.0-7.0-4.0-8.0-5.0-6.0-2.0-1.0	98	179157	210363
HG02647.verkko_filt_mat.fa:haplotype1-0000002_103892584_104321036_0	HG02647	212327	220807	4	96	1	58	22	8480	217769	209289	0-3-7-4-8-5-6-2-4-0-3-7-4-8-5-6-2-1	0.0-3.0-7.0-4.0-8.0-5.0-6.0-2.0-4.1-0.0-3.0-7.0-4.0-8.0-5.0-6.0-2.0-1.0	98	212229	220709
HG02647.verkko_filt_mat.fa:haplotype1-0000002_103892584_104321036_0	HG02647	220984	231191	0	671	0	603	670	10207	227976	217769	0-3-7-4-8-5-6-2-4-0-3-7-4-8-5-6-2-1	0.0-3.0-7.0-4.0-8.0-5.0-6.0-2.0-4.1-0.0-3.0-7.0-4.0-8.0-5.0-6.0-2.0-1.0	98	220886	231093
HG02647.verkko_filt_mat.fa:haplotype1-0000002_103892584_104321036_0	HG02647	231282	254114	3	132	0	0	131	22832	250808	227976	0-3-7-4-8-5-6-2-4-0-3-7-4-8-5-6-2-1	0.0-3.0-7.0-4.0-8.0-5.0-6.0-2.0-4.1-0.0-3.0-7.0-4.0-8.0-5.0-6.0-2.0-1.0	98	231184	254016
HG02647.verkko_filt_mat.fa:haplotype1-0000002_103892584_104321036_0	HG02647	254873	258169	7	17	0	0	16	3296	254104	250808	0-3-7-4-8-5-6-2-4-0-3-7-4-8-5-6-2-1	0.0-3.0-7.0-4.0-8.0-5.0-6.0-2.0-4.1-0.0-3.0-7.0-4.0-8.0-5.0-6.0-2.0-1.0	98	254775	258071
HG02647.verkko_filt_mat.fa:haplotype1-0000002_103892584_104321036_0	HG02647	258617	277182	4	96	0	0	95	18565	272669	254104	0-3-7-4-8-5-6-2-4-0-3-7-4-8-5-6-2-1	0.0-3.0-7.0-4.0-8.0-5.0-6.0-2.0-4.1-0.0-3.0-7.0-4.0-8.0-5.0-6.0-2.0-1.0	98	258519	277084
HG02647.verkko_filt_mat.fa:haplotype1-0000002_103892584_104321036_0	HG02647	277126	278896	8	8	0	0	7	1770	274439	272669	0-3-7-4-8-5-6-2-4-0-3-7-4-8-5-6-2-1	0.0-3.0-7.0-4.0-8.0-5.0-6.0-2.0-4.1-0.0-3.0-7.0-4.0-8.0-5.0-6.0-2.0-1.0	98	277028	278798
HG02647.verkko_filt_mat.fa:haplotype1-0000002_103892584_104321036_0	HG02647	278840	291944	5	78	0	0	77	13104	287543	274439	0-3-7-4-8-5-6-2-4-0-3-7-4-8-5-6-2-1	0.0-3.0-7.0-4.0-8.0-5.0-6.0-2.0-4.1-0.0-3.0-7.0-4.0-8.0-5.0-6.0-2.0-1.0	98	278742	291846
HG02647.verkko_filt_mat.fa:haplotype1-0000002_103892584_104321036_0	HG02647	291888	294632	6	24	0	0	21	2744	290287	287543	0-3-7-4-8-5-6-2-4-0-3-7-4-8-5-6-2-1	0.0-3.0-7.0-4.0-8.0-5.0-6.0-2.0-4.1-0.0-3.0-7.0-4.0-8.0-5.0-6.0-2.0-1.0	98	291790	294534
HG02647.verkko_filt_mat.fa:haplotype1-0000002_103892584_104321036_0	HG02647	294993	326214	2	172	0	0	171	31221	321508	290287	0-3-7-4-8-5-6-2-4-0-3-7-4-8-5-6-2-1	0.0-3.0-7.0-4.0-8.0-5.0-6.0-2.0-4.1-0.0-3.0-7.0-4.0-8.0-5.0-6.0-2.0-1.0	98	294895	326116
HG02647.verkko_filt_mat.fa:haplotype1-0000002_103892584_104321036_0	HG02647	326158	428508	1	612	0	0	606	102350	423858	321508	0-3-7-4-8-5-6-2-4-0-3-7-4-8-5-6-2-1	0.0-3.0-7.0-4.0-8.0-5.0-6.0-2.0-4.1-0.0-3.0-7.0-4.0-8.0-5.0-6.0-2.0-1.0	98	326060	428410
HG02647.verkko_filt_pat.fa:haplotype2-0000857_103738150_104051769_0	HG02647	98	115410	0	671	0	0	670	115312	115312	0	0-3-7-4-8-5-6-2-1	0.0-3.0-7.0-4.0-8.0-5.0-6.0-2.0-1.0	98	0	115312
HG02647.verkko_filt_pat.fa:haplotype2-0000857_103738150_104051769_0	HG02647	115501	138331	3	132	0	0	131	22830	138142	115312	0-3-7-4-8-5-6-2-1	0.0-3.0-7.0-4.0-8.0-5.0-6.0-2.0-1.0	98	115403	138233
HG02647.verkko_filt_pat.fa:haplotype2-0000857_103738150_104051769_0	HG02647	139090	142385	7	17	0	0	16	3295	141437	138142	0-3-7-4-8-5-6-2-1	0.0-3.0-7.0-4.0-8.0-5.0-6.0-2.0-1.0	98	138992	142287
HG02647.verkko_filt_pat.fa:haplotype2-0000857_103738150_104051769_0	HG02647	142833	161392	4	96	0	0	95	18559	159996	141437	0-3-7-4-8-5-6-2-1	0.0-3.0-7.0-4.0-8.0-5.0-6.0-2.0-1.0	98	142735	161294
HG02647.verkko_filt_pat.fa:haplotype2-0000857_103738150_104051769_0	HG02647	161336	163106	8	8	0	0	7	1770	161766	159996	0-3-7-4-8-5-6-2-1	0.0-3.0-7.0-4.0-8.0-5.0-6.0-2.0-1.0	98	161238	163008
HG02647.verkko_filt_pat.fa:haplotype2-0000857_103738150_104051769_0	HG02647	163050	175714	5	78	0	0	76	12664	174430	161766	0-3-7-4-8-5-6-2-1	0.0-3.0-7.0-4.0-8.0-5.0-6.0-2.0-1.0	98	162952	175616
HG02647.verkko_filt_pat.fa:haplotype2-0000857_103738150_104051769_0	HG02647	176321	179264	6	24	0	1	23	2943	177373	174430	0-3-7-4-8-5-6-2-1	0.0-3.0-7.0-4.0-8.0-5.0-6.0-2.0-1.0	98	176223	179166
HG02647.verkko_filt_pat.fa:haplotype2-0000857_103738150_104051769_0	HG02647	179208	210423	2	172	0	0	171	31215	208588	177373	0-3-7-4-8-5-6-2-1	0.0-3.0-7.0-4.0-8.0-5.0-6.0-2.0-1.0	98	179110	210325
HG02647.verkko_filt_pat.fa:haplotype2-0000857_103738150_104051769_0	HG02647	210367	313547	1	612	0	0	611	103180	311768	208588	0-3-7-4-8-5-6-2-1	0.0-3.0-7.0-4.0-8.0-5.0-6.0-2.0-1.0	98	210269	313449
HG02717#1#JAHAOS010000015.1_16660311_17067250_0	HG02717	98	115427	0	671	0	0	670	115329	115329	0	0-3-7-4-8-5-6-2-4-7-2-5-6-2-1	0.0-3.0-7.0-4.0-8.0-5.0-6.0-2.0-4.1-7.1-2.1-5.0-6.0-2.0-1.0	98	0	115329
HG02717#1#JAHAOS010000015.1_16660311_17067250_0	HG02717	115518	138349	3	132	0	0	131	22831	138160	115329	0-3-7-4-8-5-6-2-4-7-2-5-6-2-1	0.0-3.0-7.0-4.0-8.0-5.0-6.0-2.0-4.1-7.1-2.1-5.0-6.0-2.0-1.0	98	115420	138251
HG02717#1#JAHAOS010000015.1_16660311_17067250_0	HG02717	139108	142403	7	17	0	0	16	3295	141455	138160	0-3-7-4-8-5-6-2-4-7-2-5-6-2-1	0.0-3.0-7.0-4.0-8.0-5.0-6.0-2.0-4.1-7.1-2.1-5.0-6.0-2.0-1.0	98	139010	142305
HG02717#1#JAHAOS010000015.1_16660311_17067250_0	HG02717	143466	161418	4	96	0	4	95	17952	159407	141455	0-3-7-4-8-5-6-2-4-7-2-5-6-2-1	0.0-3.0-7.0-4.0-8.0-5.0-6.0-2.0-4.1-7.1-2.1-5.0-6.0-2.0-1.0	98	143368	161320
HG02717#1#JAHAOS010000015.1_16660311_17067250_0	HG02717	161362	163132	8	8	0	0	7	1770	161177	159407	0-3-7-4-8-5-6-2-4-7-2-5-6-2-1	0.0-3.0-7.0-4.0-8.0-5.0-6.0-2.0-4.1-7.1-2.1-5.0-6.0-2.0-1.0	98	161264	163034
HG02717#1#JAHAOS010000015.1_16660311_17067250_0	HG02717	163076	176214	5	78	0	0	77	13138	174315	161177	0-3-7-4-8-5-6-2-4-7-2-5-6-2-1	0.0-3.0-7.0-4.0-8.0-5.0-6.0-2.0-4.1-7.1-2.1-5.0-6.0-2.0-1.0	98	162978	176116
HG02717#1#JAHAOS010000015.1_16660311_17067250_0	HG02717	176158	178902	6	24	0	0	21	2744	177059	174315	0-3-7-4-8-5-6-2-4-7-2-5-6-2-1	0.0-3.0-7.0-4.0-8.0-5.0-6.0-2.0-4.1-7.1-2.1-5.0-6.0-2.0-1.0	98	176060	178804
HG02717#1#JAHAOS010000015.1_16660311_17067250_0	HG02717	179280	210490	2	172	0	0	171	31210	208269	177059	0-3-7-4-8-5-6-2-4-7-2-5-6-2-1	0.0-3.0-7.0-4.0-8.0-5.0-6.0-2.0-4.1-7.1-2.1-5.0-6.0-2.0-1.0	98	179182	210392
HG02717#1#JAHAOS010000015.1_16660311_17067250_0	HG02717	212806	223901	4	96	1	56	4	11095	219364	208269	0-3-7-4-8-5-6-2-4-7-2-5-6-2-1	0.0-3.0-7.0-4.0-8.0-5.0-6.0-2.0-4.1-7.1-2.1-5.0-6.0-2.0-1.0	98	212708	223803
HG02717#1#JAHAOS010000015.1_16660311_17067250_0	HG02717	224964	228259	7	17	1	16	0	3295	222659	219364	0-3-7-4-8-5-6-2-4-7-2-5-6-2-1	0.0-3.0-7.0-4.0-8.0-5.0-6.0-2.0-4.1-7.1-2.1-5.0-6.0-2.0-1.0	98	224866	228161
HG02717#1#JAHAOS010000015.1_16660311_17067250_0	HG02717	229336	257243	2	172	1	171	15	27907	250566	222659	0-3-7-4-8-5-6-2-4-7-2-5-6-2-1	0.0-3.0-7.0-4.0-8.0-5.0-6.0-2.0-4.1-7.1-2.1-5.0-6.0-2.0-1.0	98	229238	257145
HG02717#1#JAHAOS010000015.1_16660311_17067250_0	HG02717	258209	269423	5	78	0	5	74	11214	261780	250566	0-3-7-4-8-5-6-2-4-7-2-5-6-2-1	0.0-3.0-7.0-4.0-8.0-5.0-6.0-2.0-4.1-7.1-2.1-5.0-6.0-2.0-1.0	98	258111	269325
HG02717#1#JAHAOS010000015.1_16660311_17067250_0	HG02717	270504	273031	6	24	0	1	21	2527	264307	261780	0-3-7-4-8-5-6-2-4-7-2-5-6-2-1	0.0-3.0-7.0-4.0-8.0-5.0-6.0-2.0-4.1-7.1-2.1-5.0-6.0-2.0-1.0	98	270406	272933
HG02717#1#JAHAOS010000015.1_16660311_17067250_0	HG02717	273389	304603	2	172	0	0	171	31214	295521	264307	0-3-7-4-8-5-6-2-4-7-2-5-6-2-1	0.0-3.0-7.0-4.0-8.0-5.0-6.0-2.0-4.1-7.1-2.1-5.0-6.0-2.0-1.0	98	273291	304505
HG02717#1#JAHAOS010000015.1_16660311_17067250_0	HG02717	304547	406995	1	612	0	0	606	102448	397969	295521	0-3-7-4-8-5-6-2-4-7-2-5-6-2-1	0.0-3.0-7.0-4.0-8.0-5.0-6.0-2.0-4.1-7.1-2.1-5.0-6.0-2.0-1.0	98	304449	406897
HG02717#2#JAHAOR010000006.1_19663827_20070693_1	HG02717	154	115517	0	671	0	0	670	115363	115363	0	0-3-7-4-8-5-6-2-7-4-2-6-5-2-1	0.0-3.0-7.0-4.0-8.0-5.0-6.0-2.0-7.0-4.0-2.1-6.1-5.1-2.0-1.0	154	0	115363
HG02717#2#JAHAOR010000006.1_19663827_20070693_1	HG02717	115608	138442	3	132	0	0	131	22834	138197	115363	0-3-7-4-8-5-6-2-7-4-2-6-5-2-1	0.0-3.0-7.0-4.0-8.0-5.0-6.0-2.0-7.0-4.0-2.1-6.1-5.1-2.0-1.0	154	115454	138288
HG02717#2#JAHAOR010000006.1_19663827_20070693_1	HG02717	139201	142497	7	17	0	0	16	3296	141493	138197	0-3-7-4-8-5-6-2-7-4-2-6-5-2-1	0.0-3.0-7.0-4.0-8.0-5.0-6.0-2.0-7.0-4.0-2.1-6.1-5.1-2.0-1.0	154	139047	142343
HG02717#2#JAHAOR010000006.1_19663827_20070693_1	HG02717	143560	161512	4	96	0	4	95	17952	159445	141493	0-3-7-4-8-5-6-2-7-4-2-6-5-2-1	0.0-3.0-7.0-4.0-8.0-5.0-6.0-2.0-7.0-4.0-2.1-6.1-5.1-2.0-1.0	154	143406	161358
HG02717#2#JAHAOR010000006.1_19663827_20070693_1	HG02717	161456	163226	8	8	0	0	7	1770	161215	159445	0-3-7-4-8-5-6-2-7-4-2-6-5-2-1	0.0-3.0-7.0-4.0-8.0-5.0-6.0-2.0-7.0-4.0-2.1-6.1-5.1-2.0-1.0	154	161302	163072
HG02717#2#JAHAOR010000006.1_19663827_20070693_1	HG02717	163170	175834	5	78	0	0	76	12664	173879	161215	0-3-7-4-8-5-6-2-7-4-2-6-5-2-1	0.0-3.0-7.0-4.0-8.0-5.0-6.0-2.0-7.0-4.0-2.1-6.1-5.1-2.0-1.0	154	163016	175680
HG02717#2#JAHAOR010000006.1_19663827_20070693_1	HG02717	176441	178968	6	24	0	1	21	2527	176406	173879	0-3-7-4-8-5-6-2-7-4-2-6-5-2-1	0.0-3.0-7.0-4.0-8.0-5.0-6.0-2.0-7.0-4.0-2.1-6.1-5.1-2.0-1.0	154	176287	178814
HG02717#2#JAHAOR010000006.1_19663827_20070693_1	HG02717	179327	210543	2	172	0	0	171	31216	207622	176406	0-3-7-4-8-5-6-2-7-4-2-6-5-2-1	0.0-3.0-7.0-4.0-8.0-5.0-6.0-2.0-7.0-4.0-2.1-6.1-5.1-2.0-1.0	154	179173	210389
HG02717#2#JAHAOR010000006.1_19663827_20070693_1	HG02717	211620	214916	7	17	0	0	16	3296	210918	207622	0-3-7-4-8-5-6-2-7-4-2-6-5-2-1	0.0-3.0-7.0-4.0-8.0-5.0-6.0-2.0-7.0-4.0-2.1-6.1-5.1-2.0-1.0	154	211466	214762
HG02717#2#JAHAOR010000006.1_19663827_20070693_1	HG02717	215979	227525	4	96	0	4	58	11546	222464	210918	0-3-7-4-8-5-6-2-7-4-2-6-5-2-1	0.0-3.0-7.0-4.0-8.0-5.0-6.0-2.0-7.0-4.0-2.1-6.1-5.1-2.0-1.0	154	215825	227371
HG02717#2#JAHAOR010000006.1_19663827_20070693_1	HG02717	229391	260613	2	172	1	171	0	31222	253686	222464	0-3-7-4-8-5-6-2-7-4-2-6-5-2-1	0.0-3.0-7.0-4.0-8.0-5.0-6.0-2.0-7.0-4.0-2.1-6.1-5.1-2.0-1.0	154	229237	260459
HG02717#2#JAHAOR010000006.1_19663827_20070693_1	HG02717	260972	263499	6	24	1	21	1	2527	256213	253686	0-3-7-4-8-5-6-2-7-4-2-6-5-2-1	0.0-3.0-7.0-4.0-8.0-5.0-6.0-2.0-7.0-4.0-2.1-6.1-5.1-2.0-1.0	154	260818	263345
HG02717#2#JAHAOR010000006.1_19663827_20070693_1	HG02717	264106	276321	5	78	1	76	3	12215	268428	256213	0-3-7-4-8-5-6-2-7-4-2-6-5-2-1	0.0-3.0-7.0-4.0-8.0-5.0-6.0-2.0-7.0-4.0-2.1-6.1-5.1-2.0-1.0	154	263952	276167
HG02717#2#JAHAOR010000006.1_19663827_20070693_1	HG02717	276760	304669	2	172	0	15	171	27909	296337	268428	0-3-7-4-8-5-6-2-7-4-2-6-5-2-1	0.0-3.0-7.0-4.0-8.0-5.0-6.0-2.0-7.0-4.0-2.1-6.1-5.1-2.0-1.0	154	276606	304515
HG02717#2#JAHAOR010000006.1_19663827_20070693_1	HG02717	304613	406804	1	612	0	0	605	102191	398528	296337	0-3-7-4-8-5-6-2-7-4-2-6-5-2-1	0.0-3.0-7.0-4.0-8.0-5.0-6.0-2.0-7.0-4.0-2.1-6.1-5.1-2.0-1.0	154	304459	406650
HG02723#2#JAHEOT010000034.1_19776337_20321518_1	HG02723	154	115533	0	671	0	0	670	115379	115379	0	0-3-7-4-2-6-5-8-4-7-3-0-4-8-5-6-2-4-0-3-7-4-8-5-6-2-1	0.0-3.0-7.0-4.0-2.1-6.1-5.1-8.1-4.1-7.1-3.1-0.1-4.0-8.0-5.0-6.0-2.0-4.1-0.0-3.0-7.0-4.0-8.0-5.0-6.0-2.0-1.0	154	0	115379
HG02723#2#JAHEOT010000034.1_19776337_20321518_1	HG02723	115624	138456	3	132	0	0	131	22832	138211	115379	0-3-7-4-2-6-5-8-4-7-3-0-4-8-5-6-2-4-0-3-7-4-8-5-6-2-1	0.0-3.0-7.0-4.0-2.1-6.1-5.1-8.1-4.1-7.1-3.1-0.1-4.0-8.0-5.0-6.0-2.0-4.1-0.0-3.0-7.0-4.0-8.0-5.0-6.0-2.0-1.0	154	115470	138302
HG02723#2#JAHEOT010000034.1_19776337_20321518_1	HG02723	139215	142511	7	17	0	0	16	3296	141507	138211	0-3-7-4-2-6-5-8-4-7-3-0-4-8-5-6-2-4-0-3-7-4-8-5-6-2-1	0.0-3.0-7.0-4.0-2.1-6.1-5.1-8.1-4.1-7.1-3.1-0.1-4.0-8.0-5.0-6.0-2.0-4.1-0.0-3.0-7.0-4.0-8.0-5.0-6.0-2.0-1.0	154	139061	142357
HG02723#2#JAHEOT010000034.1_19776337_20321518_1	HG02723	142959	155118	4	96	0	0	58	12159	153666	141507	0-3-7-4-2-6-5-8-4-7-3-0-4-8-5-6-2-4-0-3-7-4-8-5-6-2-1	0.0-3.0-7.0-4.0-2.1-6.1-5.1-8.1-4.1-7.1-3.1-0.1-4.0-8.0-5.0-6.0-2.0-4.1-0.0-3.0-7.0-4.0-8.0-5.0-6.0-2.0-1.0	154	142805	154964
HG02723#2#JAHEOT010000034.1_19776337_20321518_1	HG02723	156984	188188	2	172	1	171	0	31204	184870	153666	0-3-7-4-2-6-5-8-4-7-3-0-4-8-5-6-2-4-0-3-7-4-8-5-6-2-1	0.0-3.0-7.0-4.0-2.1-6.1-5.1-8.1-4.1-7.1-3.1-0.1-4.0-8.0-5.0-6.0-2.0-4.1-0.0-3.0-7.0-4.0-8.0-5.0-6.0-2.0-1.0	154	156830	188034
HG02723#2#JAHEOT010000034.1_19776337_20321518_1	HG02723	188549	191293	6	24	1	21	0	2744	187614	184870	0-3-7-4-2-6-5-8-4-7-3-0-4-8-5-6-2-4-0-3-7-4-8-5-6-2-1	0.0-3.0-7.0-4.0-2.1-6.1-5.1-8.1-4.1-7.1-3.1-0.1-4.0-8.0-5.0-6.0-2.0-4.1-0.0-3.0-7.0-4.0-8.0-5.0-6.0-2.0-1.0	154	188395	191139
HG02723#2#JAHEOT010000034.1_19776337_20321518_1	HG02723	191237	204341	5	78	1	77	0	13104	200718	187614	0-3-7-4-2-6-5-8-4-7-3-0-4-8-5-6-2-4-0-3-7-4-8-5-6-2-1	0.0-3.0-7.0-4.0-2.1-6.1-5.1-8.1-4.1-7.1-3.1-0.1-4.0-8.0-5.0-6.0-2.0-4.1-0.0-3.0-7.0-4.0-8.0-5.0-6.0-2.0-1.0	154	191083	204187
HG02723#2#JAHEOT010000034.1_19776337_20321518_1	HG02723	204285	206055	8	8	1	7	0	1770	202488	200718	0-3-7-4-2-6-5-8-4-7-3-0-4-8-5-6-2-4-0-3-7-4-8-5-6-2-1	0.0-3.0-7.0-4.0-2.1-6.1-5.1-8.1-4.1-7.1-3.1-0.1-4.0-8.0-5.0-6.0-2.0-4.1-0.0-3.0-7.0-4.0-8.0-5.0-6.0-2.0-1.0	154	204131	205901
HG02723#2#JAHEOT010000034.1_19776337_20321518_1	HG02723	205999	224567	4	96	1	95	0	18568	221056	202488	0-3-7-4-2-6-5-8-4-7-3-0-4-8-5-6-2-4-0-3-7-4-8-5-6-2-1	0.0-3.0-7.0-4.0-2.1-6.1-5.1-8.1-4.1-7.1-3.1-0.1-4.0-8.0-5.0-6.0-2.0-4.1-0.0-3.0-7.0-4.0-8.0-5.0-6.0-2.0-1.0	154	205845	224413
HG02723#2#JAHEOT010000034.1_19776337_20321518_1	HG02723	225015	228311	7	17	1	16	0	3296	224352	221056	0-3-7-4-2-6-5-8-4-7-3-0-4-8-5-6-2-4-0-3-7-4-8-5-6-2-1	0.0-3.0-7.0-4.0-2.1-6.1-5.1-8.1-4.1-7.1-3.1-0.1-4.0-8.0-5.0-6.0-2.0-4.1-0.0-3.0-7.0-4.0-8.0-5.0-6.0-2.0-1.0	154	224861	228157
HG02723#2#JAHEOT010000034.1_19776337_20321518_1	HG02723	229070	251902	3	132	1	131	0	22832	247184	224352	0-3-7-4-2-6-5-8-4-7-3-0-4-8-5-6-2-4-0-3-7-4-8-5-6-2-1	0.0-3.0-7.0-4.0-2.1-6.1-5.1-8.1-4.1-7.1-3.1-0.1-4.0-8.0-5.0-6.0-2.0-4.1-0.0-3.0-7.0-4.0-8.0-5.0-6.0-2.0-1.0	154	228916	251748
HG02723#2#JAHEOT010000034.1_19776337_20321518_1	HG02723	251993	262202	0	671	1	670	603	10209	257393	247184	0-3-7-4-2-6-5-8-4-7-3-0-4-8-5-6-2-4-0-3-7-4-8-5-6-2-1	0.0-3.0-7.0-4.0-2.1-6.1-5.1-8.1-4.1-7.1-3.1-0.1-4.0-8.0-5.0-6.0-2.0-4.1-0.0-3.0-7.0-4.0-8.0-5.0-6.0-2.0-1.0	154	251839	262048
HG02723#2#JAHEOT010000034.1_19776337_20321518_1	HG02723	262379	277271	4	96	0	22	95	14892	272285	257393	0-3-7-4-2-6-5-8-4-7-3-0-4-8-5-6-2-4-0-3-7-4-8-5-6-2-1	0.0-3.0-7.0-4.0-2.1-6.1-5.1-8.1-4.1-7.1-3.1-0.1-4.0-8.0-5.0-6.0-2.0-4.1-0.0-3.0-7.0-4.0-8.0-5.0-6.0-2.0-1.0	154	262225	277117
HG02723#2#JAHEOT010000034.1_19776337_20321518_1	HG02723	277215	278985	8	8	0	0	7	1770	274055	272285	0-3-7-4-2-6-5-8-4-7-3-0-4-8-5-6-2-4-0-3-7-4-8-5-6-2-1	0.0-3.0-7.0-4.0-2.1-6.1-5.1-8.1-4.1-7.1-3.1-0.1-4.0-8.0-5.0-6.0-2.0-4.1-0.0-3.0-7.0-4.0-8.0-5.0-6.0-2.0-1.0	154	277061	278831
HG02723#2#JAHEOT010000034.1_19776337_20321518_1	HG02723	278929	292033	5	78	0	0	77	13104	287159	274055	0-3-7-4-2-6-5-8-4-7-3-0-4-8-5-6-2-4-0-3-7-4-8-5-6-2-1	0.0-3.0-7.0-4.0-2.1-6.1-5.1-8.1-4.1-7.1-3.1-0.1-4.0-8.0-5.0-6.0-2.0-4.1-0.0-3.0-7.0-4.0-8.0-5.0-6.0-2.0-1.0	154	278775	291879
HG02723#2#JAHEOT010000034.1_19776337_20321518_1	HG02723	291977	294721	6	24	0	0	21	2744	289903	287159	0-3-7-4-2-6-5-8-4-7-3-0-4-8-5-6-2-4-0-3-7-4-8-5-6-2-1	0.0-3.0-7.0-4.0-2.1-6.1-5.1-8.1-4.1-7.1-3.1-0.1-4.0-8.0-5.0-6.0-2.0-4.1-0.0-3.0-7.0-4.0-8.0-5.0-6.0-2.0-1.0	154	291823	294567
HG02723#2#JAHEOT010000034.1_19776337_20321518_1	HG02723	295082	326292	2	172	0	0	171	31210	321113	289903	0-3-7-4-2-6-5-8-4-7-3-0-4-8-5-6-2-4-0-3-7-4-8-5-6-2-1	0.0-3.0-7.0-4.0-2.1-6.1-5.1-8.1-4.1-7.1-3.1-0.1-4.0-8.0-5.0-6.0-2.0-4.1-0.0-3.0-7.0-4.0-8.0-5.0-6.0-2.0-1.0	154	294928	326138
HG02723#2#JAHEOT010000034.1_19776337_20321518_1	HG02723	328158	336642	4	96	1	58	22	8484	329597	321113	0-3-7-4-2-6-5-8-4-7-3-0-4-8-5-6-2-4-0-3-7-4-8-5-6-2-1	0.0-3.0-7.0-4.0-2.1-6.1-5.1-8.1-4.1-7.1-3.1-0.1-4.0-8.0-5.0-6.0-2.0-4.1-0.0-3.0-7.0-4.0-8.0-5.0-6.0-2.0-1.0	154	328004	336488
HG02723#2#JAHEOT010000034.1_19776337_20321518_1	HG02723	336819	347028	0	671	0	603	670	10209	339806	329597	0-3-7-4-2-6-5-8-4-7-3-0-4-8-5-6-2-4-0-3-7-4-8-5-6-2-1	0.0-3.0-7.0-4.0-2.1-6.1-5.1-8.1-4.1-7.1-3.1-0.1-4.0-8.0-5.0-6.0-2.0-4.1-0.0-3.0-7.0-4.0-8.0-5.0-6.0-2.0-1.0	154	336665	346874
HG02723#2#JAHEOT010000034.1_19776337_20321518_1	HG02723	347119	369951	3	132	0	0	131	22832	362638	339806	0-3-7-4-2-6-5-8-4-7-3-0-4-8-5-6-2-4-0-3-7-4-8-5-6-2-1	0.0-3.0-7.0-4.0-2.1-6.1-5.1-8.1-4.1-7.1-3.1-0.1-4.0-8.0-5.0-6.0-2.0-4.1-0.0-3.0-7.0-4.0-8.0-5.0-6.0-2.0-1.0	154	346965	369797
HG02723#2#JAHEOT010000034.1_19776337_20321518_1	HG02723	370710	374006	7	17	0	0	16	3296	365934	362638	0-3-7-4-2-6-5-8-4-7-3-0-4-8-5-6-2-4-0-3-7-4-8-5-6-2-1	0.0-3.0-7.0-4.0-2.1-6.1-5.1-8.1-4.1-7.1-3.1-0.1-4.0-8.0-5.0-6.0-2.0-4.1-0.0-3.0-7.0-4.0-8.0-5.0-6.0-2.0-1.0	154	370556	373852
HG02723#2#JAHEOT010000034.1_19776337_20321518_1	HG02723	374454	393022	4	96	0	0	95	18568	384502	365934	0-3-7-4-2-6-5-8-4-7-3-0-4-8-5-6-2-4-0-3-7-4-8-5-6-2-1	0.0-3.0-7.0-4.0-2.1-6.1-5.1-8.1-4.1-7.1-3.1-0.1-4.0-8.0-5.0-6.0-2.0-4.1-0.0-3.0-7.0-4.0-8.0-5.0-6.0-2.0-1.0	154	374300	392868
HG02723#2#JAHEOT010000034.1_19776337_20321518_1	HG02723	392966	394736	8	8	0	0	7	1770	386272	384502	0-3-7-4-2-6-5-8-4-7-3-0-4-8-5-6-2-4-0-3-7-4-8-5-6-2-1	0.0-3.0-7.0-4.0-2.1-6.1-5.1-8.1-4.1-7.1-3.1-0.1-4.0-8.0-5.0-6.0-2.0-4.1-0.0-3.0-7.0-4.0-8.0-5.0-6.0-2.0-1.0	154	392812	394582
HG02723#2#JAHEOT010000034.1_19776337_20321518_1	HG02723	394680	407784	5	78	0	0	77	13104	399376	386272	0-3-7-4-2-6-5-8-4-7-3-0-4-8-5-6-2-4-0-3-7-4-8-5-6-2-1	0.0-3.0-7.0-4.0-2.1-6.1-5.1-8.1-4.1-7.1-3.1-0.1-4.0-8.0-5.0-6.0-2.0-4.1-0.0-3.0-7.0-4.0-8.0-5.0-6.0-2.0-1.0	154	394526	407630
HG02723#2#JAHEOT010000034.1_19776337_20321518_1	HG02723	407728	410472	6	24	0	0	21	2744	402120	399376	0-3-7-4-2-6-5-8-4-7-3-0-4-8-5-6-2-4-0-3-7-4-8-5-6-2-1	0.0-3.0-7.0-4.0-2.1-6.1-5.1-8.1-4.1-7.1-3.1-0.1-4.0-8.0-5.0-6.0-2.0-4.1-0.0-3.0-7.0-4.0-8.0-5.0-6.0-2.0-1.0	154	407574	410318
HG02723#2#JAHEOT010000034.1_19776337_20321518_1	HG02723	410833	442054	2	172	0	0	171	31221	433341	402120	0-3-7-4-2-6-5-8-4-7-3-0-4-8-5-6-2-4-0-3-7-4-8-5-6-2-1	0.0-3.0-7.0-4.0-2.1-6.1-5.1-8.1-4.1-7.1-3.1-0.1-4.0-8.0-5.0-6.0-2.0-4.1-0.0-3.0-7.0-4.0-8.0-5.0-6.0-2.0-1.0	154	410679	441900
HG02723#2#JAHEOT010000034.1_19776337_20321518_1	HG02723	441998	545165	1	612	0	0	611	103167	536508	433341	0-3-7-4-2-6-5-8-4-7-3-0-4-8-5-6-2-4-0-3-7-4-8-5-6-2-1	0.0-3.0-7.0-4.0-2.1-6.1-5.1-8.1-4.1-7.1-3.1-0.1-4.0-8.0-5.0-6.0-2.0-4.1-0.0-3.0-7.0-4.0-8.0-5.0-6.0-2.0-1.0	154	441844	545011
HG02809.verkko_filt_mat.fa:haplotype1-0000023_94161320_94589755_0	HG02809	98	115417	0	671	0	0	670	115319	115319	0	0-3-7-4-8-5-6-2-4-0-3-7-4-8-5-6-2-1	0.0-3.0-7.0-4.0-8.0-5.0-6.0-2.0-4.1-0.0-3.0-7.0-4.0-8.0-5.0-6.0-2.0-1.0	98	0	115319
HG02809.verkko_filt_mat.fa:haplotype1-0000023_94161320_94589755_0	HG02809	115508	138340	3	132	0	0	131	22832	138151	115319	0-3-7-4-8-5-6-2-4-0-3-7-4-8-5-6-2-1	0.0-3.0-7.0-4.0-8.0-5.0-6.0-2.0-4.1-0.0-3.0-7.0-4.0-8.0-5.0-6.0-2.0-1.0	98	115410	138242
HG02809.verkko_filt_mat.fa:haplotype1-0000023_94161320_94589755_0	HG02809	139099	142395	7	17	0	0	16	3296	141447	138151	0-3-7-4-8-5-6-2-4-0-3-7-4-8-5-6-2-1	0.0-3.0-7.0-4.0-8.0-5.0-6.0-2.0-4.1-0.0-3.0-7.0-4.0-8.0-5.0-6.0-2.0-1.0	98	139001	142297
HG02809.verkko_filt_mat.fa:haplotype1-0000023_94161320_94589755_0	HG02809	142843	161415	4	96	0	0	95	18572	160019	141447	0-3-7-4-8-5-6-2-4-0-3-7-4-8-5-6-2-1	0.0-3.0-7.0-4.0-8.0-5.0-6.0-2.0-4.1-0.0-3.0-7.0-4.0-8.0-5.0-6.0-2.0-1.0	98	142745	161317
HG02809.verkko_filt_mat.fa:haplotype1-0000023_94161320_94589755_0	HG02809	161359	163134	8	8	0	0	7	1775	161794	160019	0-3-7-4-8-5-6-2-4-0-3-7-4-8-5-6-2-1	0.0-3.0-7.0-4.0-8.0-5.0-6.0-2.0-4.1-0.0-3.0-7.0-4.0-8.0-5.0-6.0-2.0-1.0	98	161261	163036
HG02809.verkko_filt_mat.fa:haplotype1-0000023_94161320_94589755_0	HG02809	163078	176182	5	78	0	0	77	13104	174898	161794	0-3-7-4-8-5-6-2-4-0-3-7-4-8-5-6-2-1	0.0-3.0-7.0-4.0-8.0-5.0-6.0-2.0-4.1-0.0-3.0-7.0-4.0-8.0-5.0-6.0-2.0-1.0	98	162980	176084
HG02809.verkko_filt_mat.fa:haplotype1-0000023_94161320_94589755_0	HG02809	176126	179286	6	24	0	0	23	3160	178058	174898	0-3-7-4-8-5-6-2-4-0-3-7-4-8-5-6-2-1	0.0-3.0-7.0-4.0-8.0-5.0-6.0-2.0-4.1-0.0-3.0-7.0-4.0-8.0-5.0-6.0-2.0-1.0	98	176028	179188
HG02809.verkko_filt_mat.fa:haplotype1-0000023_94161320_94589755_0	HG02809	179230	210441	2	172	0	0	171	31211	209269	178058	0-3-7-4-8-5-6-2-4-0-3-7-4-8-5-6-2-1	0.0-3.0-7.0-4.0-8.0-5.0-6.0-2.0-4.1-0.0-3.0-7.0-4.0-8.0-5.0-6.0-2.0-1.0	98	179132	210343
HG02809.verkko_filt_mat.fa:haplotype1-0000023_94161320_94589755_0	HG02809	212307	220790	4	96	1	58	22	8483	217752	209269	0-3-7-4-8-5-6-2-4-0-3-7-4-8-5-6-2-1	0.0-3.0-7.0-4.0-8.0-5.0-6.0-2.0-4.1-0.0-3.0-7.0-4.0-8.0-5.0-6.0-2.0-1.0	98	212209	220692
HG02809.verkko_filt_mat.fa:haplotype1-0000023_94161320_94589755_0	HG02809	220967	231178	0	671	0	603	670	10211	227963	217752	0-3-7-4-8-5-6-2-4-0-3-7-4-8-5-6-2-1	0.0-3.0-7.0-4.0-8.0-5.0-6.0-2.0-4.1-0.0-3.0-7.0-4.0-8.0-5.0-6.0-2.0-1.0	98	220869	231080
HG02809.verkko_filt_mat.fa:haplotype1-0000023_94161320_94589755_0	HG02809	231269	254101	3	132	0	0	131	22832	250795	227963	0-3-7-4-8-5-6-2-4-0-3-7-4-8-5-6-2-1	0.0-3.0-7.0-4.0-8.0-5.0-6.0-2.0-4.1-0.0-3.0-7.0-4.0-8.0-5.0-6.0-2.0-1.0	98	231171	254003
HG02809.verkko_filt_mat.fa:haplotype1-0000023_94161320_94589755_0	HG02809	254860	258156	7	17	0	0	16	3296	254091	250795	0-3-7-4-8-5-6-2-4-0-3-7-4-8-5-6-2-1	0.0-3.0-7.0-4.0-8.0-5.0-6.0-2.0-4.1-0.0-3.0-7.0-4.0-8.0-5.0-6.0-2.0-1.0	98	254762	258058
HG02809.verkko_filt_mat.fa:haplotype1-0000023_94161320_94589755_0	HG02809	258604	277168	4	96	0	0	95	18564	272655	254091	0-3-7-4-8-5-6-2-4-0-3-7-4-8-5-6-2-1	0.0-3.0-7.0-4.0-8.0-5.0-6.0-2.0-4.1-0.0-3.0-7.0-4.0-8.0-5.0-6.0-2.0-1.0	98	258506	277070
HG02809.verkko_filt_mat.fa:haplotype1-0000023_94161320_94589755_0	HG02809	277112	278882	8	8	0	0	7	1770	274425	272655	0-3-7-4-8-5-6-2-4-0-3-7-4-8-5-6-2-1	0.0-3.0-7.0-4.0-8.0-5.0-6.0-2.0-4.1-0.0-3.0-7.0-4.0-8.0-5.0-6.0-2.0-1.0	98	277014	278784
HG02809.verkko_filt_mat.fa:haplotype1-0000023_94161320_94589755_0	HG02809	278826	291930	5	78	0	0	77	13104	287529	274425	0-3-7-4-8-5-6-2-4-0-3-7-4-8-5-6-2-1	0.0-3.0-7.0-4.0-8.0-5.0-6.0-2.0-4.1-0.0-3.0-7.0-4.0-8.0-5.0-6.0-2.0-1.0	98	278728	291832
HG02809.verkko_filt_mat.fa:haplotype1-0000023_94161320_94589755_0	HG02809	291874	295034	6	24	0	0	23	3160	290689	287529	0-3-7-4-8-5-6-2-4-0-3-7-4-8-5-6-2-1	0.0-3.0-7.0-4.0-8.0-5.0-6.0-2.0-4.1-0.0-3.0-7.0-4.0-8.0-5.0-6.0-2.0-1.0	98	291776	294936
HG02809.verkko_filt_mat.fa:haplotype1-0000023_94161320_94589755_0	HG02809	294978	326185	2	172	0	0	171	31207	321896	290689	0-3-7-4-8-5-6-2-4-0-3-7-4-8-5-6-2-1	0.0-3.0-7.0-4.0-8.0-5.0-6.0-2.0-4.1-0.0-3.0-7.0-4.0-8.0-5.0-6.0-2.0-1.0	98	294880	326087
HG02809.verkko_filt_mat.fa:haplotype1-0000023_94161320_94589755_0	HG02809	326129	428491	1	612	0	0	606	102362	424258	321896	0-3-7-4-8-5-6-2-4-0-3-7-4-8-5-6-2-1	0.0-3.0-7.0-4.0-8.0-5.0-6.0-2.0-4.1-0.0-3.0-7.0-4.0-8.0-5.0-6.0-2.0-1.0	98	326031	428393
HG02809.verkko_filt_pat.fa:haplotype2-0001251_103421111_103827972_0	HG02809	98	115438	0	671	0	0	670	115340	115340	0	0-3-7-4-8-5-6-2-7-4-2-6-5-2-1	0.0-3.0-7.0-4.0-8.0-5.0-6.0-2.0-7.0-4.0-2.1-6.1-5.1-2.0-1.0	98	0	115340
HG02809.verkko_filt_pat.fa:haplotype2-0001251_103421111_103827972_0	HG02809	115529	138358	3	132	0	0	131	22829	138169	115340	0-3-7-4-8-5-6-2-7-4-2-6-5-2-1	0.0-3.0-7.0-4.0-8.0-5.0-6.0-2.0-7.0-4.0-2.1-6.1-5.1-2.0-1.0	98	115431	138260
HG02809.verkko_filt_pat.fa:haplotype2-0001251_103421111_103827972_0	HG02809	139117	142412	7	17	0	0	16	3295	141464	138169	0-3-7-4-8-5-6-2-7-4-2-6-5-2-1	0.0-3.0-7.0-4.0-8.0-5.0-6.0-2.0-7.0-4.0-2.1-6.1-5.1-2.0-1.0	98	139019	142314
HG02809.verkko_filt_pat.fa:haplotype2-0001251_103421111_103827972_0	HG02809	142860	161021	4	96	0	0	93	18161	159625	141464	0-3-7-4-8-5-6-2-7-4-2-6-5-2-1	0.0-3.0-7.0-4.0-8.0-5.0-6.0-2.0-7.0-4.0-2.1-6.1-5.1-2.0-1.0	98	142762	160923
HG02809.verkko_filt_pat.fa:haplotype2-0001251_103421111_103827972_0	HG02809	161374	163144	8	8	0	0	7	1770	161395	159625	0-3-7-4-8-5-6-2-7-4-2-6-5-2-1	0.0-3.0-7.0-4.0-8.0-5.0-6.0-2.0-7.0-4.0-2.1-6.1-5.1-2.0-1.0	98	161276	163046
HG02809.verkko_filt_pat.fa:haplotype2-0001251_103421111_103827972_0	HG02809	163088	176227	5	78	0	0	77	13139	174534	161395	0-3-7-4-8-5-6-2-7-4-2-6-5-2-1	0.0-3.0-7.0-4.0-8.0-5.0-6.0-2.0-7.0-4.0-2.1-6.1-5.1-2.0-1.0	98	162990	176129
HG02809.verkko_filt_pat.fa:haplotype2-0001251_103421111_103827972_0	HG02809	176171	178915	6	24	0	0	21	2744	177278	174534	0-3-7-4-8-5-6-2-7-4-2-6-5-2-1	0.0-3.0-7.0-4.0-8.0-5.0-6.0-2.0-7.0-4.0-2.1-6.1-5.1-2.0-1.0	98	176073	178817
HG02809.verkko_filt_pat.fa:haplotype2-0001251_103421111_103827972_0	HG02809	179274	210492	2	172	0	0	171	31218	208496	177278	0-3-7-4-8-5-6-2-7-4-2-6-5-2-1	0.0-3.0-7.0-4.0-8.0-5.0-6.0-2.0-7.0-4.0-2.1-6.1-5.1-2.0-1.0	98	179176	210394
HG02809.verkko_filt_pat.fa:haplotype2-0001251_103421111_103827972_0	HG02809	211569	214864	7	17	0	0	16	3295	211791	208496	0-3-7-4-8-5-6-2-7-4-2-6-5-2-1	0.0-3.0-7.0-4.0-8.0-5.0-6.0-2.0-7.0-4.0-2.1-6.1-5.1-2.0-1.0	98	211471	214766
HG02809.verkko_filt_pat.fa:haplotype2-0001251_103421111_103827972_0	HG02809	215927	227473	4	96	0	4	58	11546	223337	211791	0-3-7-4-8-5-6-2-7-4-2-6-5-2-1	0.0-3.0-7.0-4.0-8.0-5.0-6.0-2.0-7.0-4.0-2.1-6.1-5.1-2.0-1.0	98	215829	227375
HG02809.verkko_filt_pat.fa:haplotype2-0001251_103421111_103827972_0	HG02809	229339	260557	2	172	1	171	0	31218	254555	223337	0-3-7-4-8-5-6-2-7-4-2-6-5-2-1	0.0-3.0-7.0-4.0-8.0-5.0-6.0-2.0-7.0-4.0-2.1-6.1-5.1-2.0-1.0	98	229241	260459
HG02809.verkko_filt_pat.fa:haplotype2-0001251_103421111_103827972_0	HG02809	260916	263443	6	24	1	21	1	2527	257082	254555	0-3-7-4-8-5-6-2-7-4-2-6-5-2-1	0.0-3.0-7.0-4.0-8.0-5.0-6.0-2.0-7.0-4.0-2.1-6.1-5.1-2.0-1.0	98	260818	263345
HG02809.verkko_filt_pat.fa:haplotype2-0001251_103421111_103827972_0	HG02809	264050	276265	5	78	1	76	3	12215	269297	257082	0-3-7-4-8-5-6-2-7-4-2-6-5-2-1	0.0-3.0-7.0-4.0-8.0-5.0-6.0-2.0-7.0-4.0-2.1-6.1-5.1-2.0-1.0	98	263952	276167
HG02809.verkko_filt_pat.fa:haplotype2-0001251_103421111_103827972_0	HG02809	276704	304612	2	172	0	15	171	27908	297205	269297	0-3-7-4-8-5-6-2-7-4-2-6-5-2-1	0.0-3.0-7.0-4.0-8.0-5.0-6.0-2.0-7.0-4.0-2.1-6.1-5.1-2.0-1.0	98	276606	304514
HG02809.verkko_filt_pat.fa:haplotype2-0001251_103421111_103827972_0	HG02809	304556	406917	1	612	0	0	606	102361	399566	297205	0-3-7-4-8-5-6-2-7-4-2-6-5-2-1	0.0-3.0-7.0-4.0-8.0-5.0-6.0-2.0-7.0-4.0-2.1-6.1-5.1-2.0-1.0	98	304458	406819
HG02818#1#JAHEOS010000101.1_89626_496613_0	HG02818	98	115486	0	671	0	0	670	115388	115388	0	0-3-7-4-8-5-6-2-4-7-2-5-6-2-1	0.0-3.0-7.0-4.0-8.0-5.0-6.0-2.0-4.1-7.1-2.1-5.0-6.0-2.0-1.0	98	0	115388
HG02818#1#JAHEOS010000101.1_89626_496613_0	HG02818	115577	138410	3	132	0	0	131	22833	138221	115388	0-3-7-4-8-5-6-2-4-7-2-5-6-2-1	0.0-3.0-7.0-4.0-8.0-5.0-6.0-2.0-4.1-7.1-2.1-5.0-6.0-2.0-1.0	98	115479	138312
HG02818#1#JAHEOS010000101.1_89626_496613_0	HG02818	139169	142464	7	17	0	0	16	3295	141516	138221	0-3-7-4-8-5-6-2-4-7-2-5-6-2-1	0.0-3.0-7.0-4.0-8.0-5.0-6.0-2.0-4.1-7.1-2.1-5.0-6.0-2.0-1.0	98	139071	142366
HG02818#1#JAHEOS010000101.1_89626_496613_0	HG02818	143529	161498	4	96	0	4	95	17969	159485	141516	0-3-7-4-8-5-6-2-4-7-2-5-6-2-1	0.0-3.0-7.0-4.0-8.0-5.0-6.0-2.0-4.1-7.1-2.1-5.0-6.0-2.0-1.0	98	143431	161400
HG02818#1#JAHEOS010000101.1_89626_496613_0	HG02818	161442	163212	8	8	0	0	7	1770	161255	159485	0-3-7-4-8-5-6-2-4-7-2-5-6-2-1	0.0-3.0-7.0-4.0-8.0-5.0-6.0-2.0-4.1-7.1-2.1-5.0-6.0-2.0-1.0	98	161344	163114
HG02818#1#JAHEOS010000101.1_89626_496613_0	HG02818	163156	175854	5	78	0	0	76	12698	173953	161255	0-3-7-4-8-5-6-2-4-7-2-5-6-2-1	0.0-3.0-7.0-4.0-8.0-5.0-6.0-2.0-4.1-7.1-2.1-5.0-6.0-2.0-1.0	98	163058	175756
HG02818#1#JAHEOS010000101.1_89626_496613_0	HG02818	176461	178988	6	24	0	1	21	2527	176480	173953	0-3-7-4-8-5-6-2-4-7-2-5-6-2-1	0.0-3.0-7.0-4.0-8.0-5.0-6.0-2.0-4.1-7.1-2.1-5.0-6.0-2.0-1.0	98	176363	178890
HG02818#1#JAHEOS010000101.1_89626_496613_0	HG02818	179373	210591	2	172	0	0	171	31218	207698	176480	0-3-7-4-8-5-6-2-4-7-2-5-6-2-1	0.0-3.0-7.0-4.0-8.0-5.0-6.0-2.0-4.1-7.1-2.1-5.0-6.0-2.0-1.0	98	179275	210493
HG02818#1#JAHEOS010000101.1_89626_496613_0	HG02818	212907	224001	4	96	1	56	4	11094	218792	207698	0-3-7-4-8-5-6-2-4-7-2-5-6-2-1	0.0-3.0-7.0-4.0-8.0-5.0-6.0-2.0-4.1-7.1-2.1-5.0-6.0-2.0-1.0	98	212809	223903
HG02818#1#JAHEOS010000101.1_89626_496613_0	HG02818	225064	228359	7	17	1	16	0	3295	222087	218792	0-3-7-4-8-5-6-2-4-7-2-5-6-2-1	0.0-3.0-7.0-4.0-8.0-5.0-6.0-2.0-4.1-7.1-2.1-5.0-6.0-2.0-1.0	98	224966	228261
HG02818#1#JAHEOS010000101.1_89626_496613_0	HG02818	229436	257349	2	172	1	171	15	27913	250000	222087	0-3-7-4-8-5-6-2-4-7-2-5-6-2-1	0.0-3.0-7.0-4.0-8.0-5.0-6.0-2.0-4.1-7.1-2.1-5.0-6.0-2.0-1.0	98	229338	257251
HG02818#1#JAHEOS010000101.1_89626_496613_0	HG02818	258315	269529	5	78	0	5	74	11214	261214	250000	0-3-7-4-8-5-6-2-4-7-2-5-6-2-1	0.0-3.0-7.0-4.0-8.0-5.0-6.0-2.0-4.1-7.1-2.1-5.0-6.0-2.0-1.0	98	258217	269431
HG02818#1#JAHEOS010000101.1_89626_496613_0	HG02818	270610	273137	6	24	0	1	21	2527	263741	261214	0-3-7-4-8-5-6-2-4-7-2-5-6-2-1	0.0-3.0-7.0-4.0-8.0-5.0-6.0-2.0-4.1-7.1-2.1-5.0-6.0-2.0-1.0	98	270512	273039
HG02818#1#JAHEOS010000101.1_89626_496613_0	HG02818	273495	304706	2	172	0	0	171	31211	294952	263741	0-3-7-4-8-5-6-2-4-7-2-5-6-2-1	0.0-3.0-7.0-4.0-8.0-5.0-6.0-2.0-4.1-7.1-2.1-5.0-6.0-2.0-1.0	98	273397	304608
HG02818#1#JAHEOS010000101.1_89626_496613_0	HG02818	304650	407043	1	612	0	0	606	102393	397345	294952	0-3-7-4-8-5-6-2-4-7-2-5-6-2-1	0.0-3.0-7.0-4.0-8.0-5.0-6.0-2.0-4.1-7.1-2.1-5.0-6.0-2.0-1.0	98	304552	406945
HG02818#2#JAHEOR010000010.1_31775319_32183091_1	HG02818	154	115501	0	671	0	0	670	115347	115347	0	0-3-7-4-8-5-6-2-4-7-2-5-6-2-1	0.0-3.0-7.0-4.0-8.0-5.0-6.0-2.0-4.1-7.1-2.1-5.0-6.0-2.0-1.0	154	0	115347
HG02818#2#JAHEOR010000010.1_31775319_32183091_1	HG02818	115592	138427	3	132	0	0	131	22835	138182	115347	0-3-7-4-8-5-6-2-4-7-2-5-6-2-1	0.0-3.0-7.0-4.0-8.0-5.0-6.0-2.0-4.1-7.1-2.1-5.0-6.0-2.0-1.0	154	115438	138273
HG02818#2#JAHEOR010000010.1_31775319_32183091_1	HG02818	139186	142481	7	17	0	0	16	3295	141477	138182	0-3-7-4-8-5-6-2-4-7-2-5-6-2-1	0.0-3.0-7.0-4.0-8.0-5.0-6.0-2.0-4.1-7.1-2.1-5.0-6.0-2.0-1.0	154	139032	142327
HG02818#2#JAHEOR010000010.1_31775319_32183091_1	HG02818	142929	161490	4	96	0	0	95	18561	160038	141477	0-3-7-4-8-5-6-2-4-7-2-5-6-2-1	0.0-3.0-7.0-4.0-8.0-5.0-6.0-2.0-4.1-7.1-2.1-5.0-6.0-2.0-1.0	154	142775	161336
HG02818#2#JAHEOR010000010.1_31775319_32183091_1	HG02818	161434	163204	8	8	0	0	7	1770	161808	160038	0-3-7-4-8-5-6-2-4-7-2-5-6-2-1	0.0-3.0-7.0-4.0-8.0-5.0-6.0-2.0-4.1-7.1-2.1-5.0-6.0-2.0-1.0	154	161280	163050
HG02818#2#JAHEOR010000010.1_31775319_32183091_1	HG02818	163148	175372	5	78	0	0	74	12224	174032	161808	0-3-7-4-8-5-6-2-4-7-2-5-6-2-1	0.0-3.0-7.0-4.0-8.0-5.0-6.0-2.0-4.1-7.1-2.1-5.0-6.0-2.0-1.0	154	162994	175218
HG02818#2#JAHEOR010000010.1_31775319_32183091_1	HG02818	176453	179396	6	24	0	1	23	2943	176975	174032	0-3-7-4-8-5-6-2-4-7-2-5-6-2-1	0.0-3.0-7.0-4.0-8.0-5.0-6.0-2.0-4.1-7.1-2.1-5.0-6.0-2.0-1.0	154	176299	179242
HG02818#2#JAHEOR010000010.1_31775319_32183091_1	HG02818	179340	210563	2	172	0	0	171	31223	208198	176975	0-3-7-4-8-5-6-2-4-7-2-5-6-2-1	0.0-3.0-7.0-4.0-8.0-5.0-6.0-2.0-4.1-7.1-2.1-5.0-6.0-2.0-1.0	154	179186	210409
HG02818#2#JAHEOR010000010.1_31775319_32183091_1	HG02818	212429	223963	4	96	1	58	4	11534	219732	208198	0-3-7-4-8-5-6-2-4-7-2-5-6-2-1	0.0-3.0-7.0-4.0-8.0-5.0-6.0-2.0-4.1-7.1-2.1-5.0-6.0-2.0-1.0	154	212275	223809
HG02818#2#JAHEOR010000010.1_31775319_32183091_1	HG02818	225028	228323	7	17	1	16	0	3295	223027	219732	0-3-7-4-8-5-6-2-4-7-2-5-6-2-1	0.0-3.0-7.0-4.0-8.0-5.0-6.0-2.0-4.1-7.1-2.1-5.0-6.0-2.0-1.0	154	224874	228169
HG02818#2#JAHEOR010000010.1_31775319_32183091_1	HG02818	229400	257321	2	172	1	171	15	27921	250948	223027	0-3-7-4-8-5-6-2-4-7-2-5-6-2-1	0.0-3.0-7.0-4.0-8.0-5.0-6.0-2.0-4.1-7.1-2.1-5.0-6.0-2.0-1.0	154	229246	257167
HG02818#2#JAHEOR010000010.1_31775319_32183091_1	HG02818	257760	269502	5	78	0	3	74	11742	262690	250948	0-3-7-4-8-5-6-2-4-7-2-5-6-2-1	0.0-3.0-7.0-4.0-8.0-5.0-6.0-2.0-4.1-7.1-2.1-5.0-6.0-2.0-1.0	154	257606	269348
HG02818#2#JAHEOR010000010.1_31775319_32183091_1	HG02818	270583	273526	6	24	0	1	23	2943	265633	262690	0-3-7-4-8-5-6-2-4-7-2-5-6-2-1	0.0-3.0-7.0-4.0-8.0-5.0-6.0-2.0-4.1-7.1-2.1-5.0-6.0-2.0-1.0	154	270429	273372
HG02818#2#JAHEOR010000010.1_31775319_32183091_1	HG02818	273470	304684	2	172	0	0	171	31214	296847	265633	0-3-7-4-8-5-6-2-4-7-2-5-6-2-1	0.0-3.0-7.0-4.0-8.0-5.0-6.0-2.0-4.1-7.1-2.1-5.0-6.0-2.0-1.0	154	273316	304530
HG02818#2#JAHEOR010000010.1_31775319_32183091_1	HG02818	304628	407756	1	612	0	0	611	103128	399975	296847	0-3-7-4-8-5-6-2-4-7-2-5-6-2-1	0.0-3.0-7.0-4.0-8.0-5.0-6.0-2.0-4.1-7.1-2.1-5.0-6.0-2.0-1.0	154	304474	407602
HG02886#1#JAHAOU010000178.1_62411_469262_0	HG02886	98	115446	0	671	0	0	670	115348	115348	0	0-3-7-4-8-5-6-2-4-7-2-6-5-2-1	0.0-3.0-7.0-4.0-8.0-5.0-6.0-2.0-4.1-7.1-2.1-6.1-5.1-2.0-1.0	98	0	115348
HG02886#1#JAHAOU010000178.1_62411_469262_0	HG02886	115537	138373	3	132	0	0	131	22836	138184	115348	0-3-7-4-8-5-6-2-4-7-2-6-5-2-1	0.0-3.0-7.0-4.0-8.0-5.0-6.0-2.0-4.1-7.1-2.1-6.1-5.1-2.0-1.0	98	115439	138275
HG02886#1#JAHAOU010000178.1_62411_469262_0	HG02886	139132	142427	7	17	0	0	16	3295	141479	138184	0-3-7-4-8-5-6-2-4-7-2-6-5-2-1	0.0-3.0-7.0-4.0-8.0-5.0-6.0-2.0-4.1-7.1-2.1-6.1-5.1-2.0-1.0	98	139034	142329
HG02886#1#JAHAOU010000178.1_62411_469262_0	HG02886	142875	161447	4	96	0	0	95	18572	160051	141479	0-3-7-4-8-5-6-2-4-7-2-6-5-2-1	0.0-3.0-7.0-4.0-8.0-5.0-6.0-2.0-4.1-7.1-2.1-6.1-5.1-2.0-1.0	98	142777	161349
HG02886#1#JAHAOU010000178.1_62411_469262_0	HG02886	161391	163161	8	8	0	0	7	1770	161821	160051	0-3-7-4-8-5-6-2-4-7-2-6-5-2-1	0.0-3.0-7.0-4.0-8.0-5.0-6.0-2.0-4.1-7.1-2.1-6.1-5.1-2.0-1.0	98	161293	163063
HG02886#1#JAHAOU010000178.1_62411_469262_0	HG02886	163105	175769	5	78	0	0	76	12664	174485	161821	0-3-7-4-8-5-6-2-4-7-2-6-5-2-1	0.0-3.0-7.0-4.0-8.0-5.0-6.0-2.0-4.1-7.1-2.1-6.1-5.1-2.0-1.0	98	163007	175671
HG02886#1#JAHAOU010000178.1_62411_469262_0	HG02886	176376	179319	6	24	0	1	23	2943	177428	174485	0-3-7-4-8-5-6-2-4-7-2-6-5-2-1	0.0-3.0-7.0-4.0-8.0-5.0-6.0-2.0-4.1-7.1-2.1-6.1-5.1-2.0-1.0	98	176278	179221
HG02886#1#JAHAOU010000178.1_62411_469262_0	HG02886	179263	210472	2	172	0	0	171	31209	208637	177428	0-3-7-4-8-5-6-2-4-7-2-6-5-2-1	0.0-3.0-7.0-4.0-8.0-5.0-6.0-2.0-4.1-7.1-2.1-6.1-5.1-2.0-1.0	98	179165	210374
HG02886#1#JAHAOU010000178.1_62411_469262_0	HG02886	212338	223888	4	96	1	58	4	11550	220187	208637	0-3-7-4-8-5-6-2-4-7-2-6-5-2-1	0.0-3.0-7.0-4.0-8.0-5.0-6.0-2.0-4.1-7.1-2.1-6.1-5.1-2.0-1.0	98	212240	223790
HG02886#1#JAHAOU010000178.1_62411_469262_0	HG02886	224953	228248	7	17	1	16	0	3295	223482	220187	0-3-7-4-8-5-6-2-4-7-2-6-5-2-1	0.0-3.0-7.0-4.0-8.0-5.0-6.0-2.0-4.1-7.1-2.1-6.1-5.1-2.0-1.0	98	224855	228150
HG02886#1#JAHAOU010000178.1_62411_469262_0	HG02886	229325	260540	2	172	1	171	0	31215	254697	223482	0-3-7-4-8-5-6-2-4-7-2-6-5-2-1	0.0-3.0-7.0-4.0-8.0-5.0-6.0-2.0-4.1-7.1-2.1-6.1-5.1-2.0-1.0	98	229227	260442
HG02886#1#JAHAOU010000178.1_62411_469262_0	HG02886	260484	263427	6	24	1	23	1	2943	257640	254697	0-3-7-4-8-5-6-2-4-7-2-6-5-2-1	0.0-3.0-7.0-4.0-8.0-5.0-6.0-2.0-4.1-7.1-2.1-6.1-5.1-2.0-1.0	98	260386	263329
HG02886#1#JAHAOU010000178.1_62411_469262_0	HG02886	264034	276249	5	78	1	76	3	12215	269855	257640	0-3-7-4-8-5-6-2-4-7-2-6-5-2-1	0.0-3.0-7.0-4.0-8.0-5.0-6.0-2.0-4.1-7.1-2.1-6.1-5.1-2.0-1.0	98	263936	276151
HG02886#1#JAHAOU010000178.1_62411_469262_0	HG02886	276688	304599	2	172	0	15	171	27911	297766	269855	0-3-7-4-8-5-6-2-4-7-2-6-5-2-1	0.0-3.0-7.0-4.0-8.0-5.0-6.0-2.0-4.1-7.1-2.1-6.1-5.1-2.0-1.0	98	276590	304501
HG02886#1#JAHAOU010000178.1_62411_469262_0	HG02886	304543	406907	1	612	0	0	606	102364	400130	297766	0-3-7-4-8-5-6-2-4-7-2-6-5-2-1	0.0-3.0-7.0-4.0-8.0-5.0-6.0-2.0-4.1-7.1-2.1-6.1-5.1-2.0-1.0	98	304445	406809
HG02886#2#JAHAOT010000031.1_87393_401061_0	HG02886	98	115457	0	671	0	0	670	115359	115359	0	0-3-7-4-8-5-6-2-1	0.0-3.0-7.0-4.0-8.0-5.0-6.0-2.0-1.0	98	0	115359
HG02886#2#JAHAOT010000031.1_87393_401061_0	HG02886	115548	138379	3	132	0	0	131	22831	138190	115359	0-3-7-4-8-5-6-2-1	0.0-3.0-7.0-4.0-8.0-5.0-6.0-2.0-1.0	98	115450	138281
HG02886#2#JAHAOT010000031.1_87393_401061_0	HG02886	139138	142433	7	17	0	0	16	3295	141485	138190	0-3-7-4-8-5-6-2-1	0.0-3.0-7.0-4.0-8.0-5.0-6.0-2.0-1.0	98	139040	142335
HG02886#2#JAHAOT010000031.1_87393_401061_0	HG02886	143224	161443	4	96	0	1	95	18219	159704	141485	0-3-7-4-8-5-6-2-1	0.0-3.0-7.0-4.0-8.0-5.0-6.0-2.0-1.0	98	143126	161345
HG02886#2#JAHAOT010000031.1_87393_401061_0	HG02886	161387	163157	8	8	0	0	7	1770	161474	159704	0-3-7-4-8-5-6-2-1	0.0-3.0-7.0-4.0-8.0-5.0-6.0-2.0-1.0	98	161289	163059
HG02886#2#JAHAOT010000031.1_87393_401061_0	HG02886	163101	175765	5	78	0	0	76	12664	174138	161474	0-3-7-4-8-5-6-2-1	0.0-3.0-7.0-4.0-8.0-5.0-6.0-2.0-1.0	98	163003	175667
HG02886#2#JAHAOT010000031.1_87393_401061_0	HG02886	176372	178899	6	24	0	1	21	2527	176665	174138	0-3-7-4-8-5-6-2-1	0.0-3.0-7.0-4.0-8.0-5.0-6.0-2.0-1.0	98	176274	178801
HG02886#2#JAHAOT010000031.1_87393_401061_0	HG02886	179258	210477	2	172	0	0	171	31219	207884	176665	0-3-7-4-8-5-6-2-1	0.0-3.0-7.0-4.0-8.0-5.0-6.0-2.0-1.0	98	179160	210379
HG02886#2#JAHAOT010000031.1_87393_401061_0	HG02886	210421	313596	1	612	0	0	611	103175	311059	207884	0-3-7-4-8-5-6-2-1	0.0-3.0-7.0-4.0-8.0-5.0-6.0-2.0-1.0	98	210323	313498
HG03098#1#JAHEPM010000059.1_16676208_17105596_0	HG03098	98	115428	0	671	0	0	670	115330	115330	0	0-3-7-4-8-5-6-2-4-0-3-7-4-8-5-6-2-1	0.0-3.0-7.0-4.0-8.0-5.0-6.0-2.0-4.1-0.0-3.0-7.0-4.0-8.0-5.0-6.0-2.0-1.0	98	0	115330
HG03098#1#JAHEPM010000059.1_16676208_17105596_0	HG03098	115519	138351	3	132	0	0	131	22832	138162	115330	0-3-7-4-8-5-6-2-4-0-3-7-4-8-5-6-2-1	0.0-3.0-7.0-4.0-8.0-5.0-6.0-2.0-4.1-0.0-3.0-7.0-4.0-8.0-5.0-6.0-2.0-1.0	98	115421	138253
HG03098#1#JAHEPM010000059.1_16676208_17105596_0	HG03098	139110	142405	7	17	0	0	16	3295	141457	138162	0-3-7-4-8-5-6-2-4-0-3-7-4-8-5-6-2-1	0.0-3.0-7.0-4.0-8.0-5.0-6.0-2.0-4.1-0.0-3.0-7.0-4.0-8.0-5.0-6.0-2.0-1.0	98	139012	142307
HG03098#1#JAHEPM010000059.1_16676208_17105596_0	HG03098	142853	161423	4	96	0	0	95	18570	160027	141457	0-3-7-4-8-5-6-2-4-0-3-7-4-8-5-6-2-1	0.0-3.0-7.0-4.0-8.0-5.0-6.0-2.0-4.1-0.0-3.0-7.0-4.0-8.0-5.0-6.0-2.0-1.0	98	142755	161325
HG03098#1#JAHEPM010000059.1_16676208_17105596_0	HG03098	161367	163137	8	8	0	0	7	1770	161797	160027	0-3-7-4-8-5-6-2-4-0-3-7-4-8-5-6-2-1	0.0-3.0-7.0-4.0-8.0-5.0-6.0-2.0-4.1-0.0-3.0-7.0-4.0-8.0-5.0-6.0-2.0-1.0	98	161269	163039
HG03098#1#JAHEPM010000059.1_16676208_17105596_0	HG03098	163081	176185	5	78	0	0	77	13104	174901	161797	0-3-7-4-8-5-6-2-4-0-3-7-4-8-5-6-2-1	0.0-3.0-7.0-4.0-8.0-5.0-6.0-2.0-4.1-0.0-3.0-7.0-4.0-8.0-5.0-6.0-2.0-1.0	98	162983	176087
HG03098#1#JAHEPM010000059.1_16676208_17105596_0	HG03098	176129	179289	6	24	0	0	23	3160	178061	174901	0-3-7-4-8-5-6-2-4-0-3-7-4-8-5-6-2-1	0.0-3.0-7.0-4.0-8.0-5.0-6.0-2.0-4.1-0.0-3.0-7.0-4.0-8.0-5.0-6.0-2.0-1.0	98	176031	179191
HG03098#1#JAHEPM010000059.1_16676208_17105596_0	HG03098	179233	210448	2	172	0	0	171	31215	209276	178061	0-3-7-4-8-5-6-2-4-0-3-7-4-8-5-6-2-1	0.0-3.0-7.0-4.0-8.0-5.0-6.0-2.0-4.1-0.0-3.0-7.0-4.0-8.0-5.0-6.0-2.0-1.0	98	179135	210350
HG03098#1#JAHEPM010000059.1_16676208_17105596_0	HG03098	212314	220794	4	96	1	58	22	8480	217756	209276	0-3-7-4-8-5-6-2-4-0-3-7-4-8-5-6-2-1	0.0-3.0-7.0-4.0-8.0-5.0-6.0-2.0-4.1-0.0-3.0-7.0-4.0-8.0-5.0-6.0-2.0-1.0	98	212216	220696
HG03098#1#JAHEPM010000059.1_16676208_17105596_0	HG03098	220971	231178	0	671	0	603	670	10207	227963	217756	0-3-7-4-8-5-6-2-4-0-3-7-4-8-5-6-2-1	0.0-3.0-7.0-4.0-8.0-5.0-6.0-2.0-4.1-0.0-3.0-7.0-4.0-8.0-5.0-6.0-2.0-1.0	98	220873	231080
HG03098#1#JAHEPM010000059.1_16676208_17105596_0	HG03098	231269	254101	3	132	0	0	131	22832	250795	227963	0-3-7-4-8-5-6-2-4-0-3-7-4-8-5-6-2-1	0.0-3.0-7.0-4.0-8.0-5.0-6.0-2.0-4.1-0.0-3.0-7.0-4.0-8.0-5.0-6.0-2.0-1.0	98	231171	254003
HG03098#1#JAHEPM010000059.1_16676208_17105596_0	HG03098	254860	258155	7	17	0	0	16	3295	254090	250795	0-3-7-4-8-5-6-2-4-0-3-7-4-8-5-6-2-1	0.0-3.0-7.0-4.0-8.0-5.0-6.0-2.0-4.1-0.0-3.0-7.0-4.0-8.0-5.0-6.0-2.0-1.0	98	254762	258057
HG03098#1#JAHEPM010000059.1_16676208_17105596_0	HG03098	258603	277173	4	96	0	0	95	18570	272660	254090	0-3-7-4-8-5-6-2-4-0-3-7-4-8-5-6-2-1	0.0-3.0-7.0-4.0-8.0-5.0-6.0-2.0-4.1-0.0-3.0-7.0-4.0-8.0-5.0-6.0-2.0-1.0	98	258505	277075
HG03098#1#JAHEPM010000059.1_16676208_17105596_0	HG03098	277117	278887	8	8	0	0	7	1770	274430	272660	0-3-7-4-8-5-6-2-4-0-3-7-4-8-5-6-2-1	0.0-3.0-7.0-4.0-8.0-5.0-6.0-2.0-4.1-0.0-3.0-7.0-4.0-8.0-5.0-6.0-2.0-1.0	98	277019	278789
HG03098#1#JAHEPM010000059.1_16676208_17105596_0	HG03098	278831	291935	5	78	0	0	77	13104	287534	274430	0-3-7-4-8-5-6-2-4-0-3-7-4-8-5-6-2-1	0.0-3.0-7.0-4.0-8.0-5.0-6.0-2.0-4.1-0.0-3.0-7.0-4.0-8.0-5.0-6.0-2.0-1.0	98	278733	291837
HG03098#1#JAHEPM010000059.1_16676208_17105596_0	HG03098	291879	295039	6	24	0	0	23	3160	290694	287534	0-3-7-4-8-5-6-2-4-0-3-7-4-8-5-6-2-1	0.0-3.0-7.0-4.0-8.0-5.0-6.0-2.0-4.1-0.0-3.0-7.0-4.0-8.0-5.0-6.0-2.0-1.0	98	291781	294941
HG03098#1#JAHEPM010000059.1_16676208_17105596_0	HG03098	294983	326208	2	172	0	0	171	31225	321919	290694	0-3-7-4-8-5-6-2-4-0-3-7-4-8-5-6-2-1	0.0-3.0-7.0-4.0-8.0-5.0-6.0-2.0-4.1-0.0-3.0-7.0-4.0-8.0-5.0-6.0-2.0-1.0	98	294885	326110
HG03098#1#JAHEPM010000059.1_16676208_17105596_0	HG03098	326152	429316	1	612	0	0	611	103164	425083	321919	0-3-7-4-8-5-6-2-4-0-3-7-4-8-5-6-2-1	0.0-3.0-7.0-4.0-8.0-5.0-6.0-2.0-4.1-0.0-3.0-7.0-4.0-8.0-5.0-6.0-2.0-1.0	98	326054	429218
HG03098#2#JAHEPL010000003.1_93803759_94117426_0	HG03098	98	115463	0	671	0	0	670	115365	115365	0	0-3-7-4-8-5-6-2-1	0.0-3.0-7.0-4.0-8.0-5.0-6.0-2.0-1.0	98	0	115365
HG03098#2#JAHEPL010000003.1_93803759_94117426_0	HG03098	115554	138389	3	132	0	0	131	22835	138200	115365	0-3-7-4-8-5-6-2-1	0.0-3.0-7.0-4.0-8.0-5.0-6.0-2.0-1.0	98	115456	138291
HG03098#2#JAHEPL010000003.1_93803759_94117426_0	HG03098	139148	142443	7	17	0	0	16	3295	141495	138200	0-3-7-4-8-5-6-2-1	0.0-3.0-7.0-4.0-8.0-5.0-6.0-2.0-1.0	98	139050	142345
HG03098#2#JAHEPL010000003.1_93803759_94117426_0	HG03098	142891	161450	4	96	0	0	95	18559	160054	141495	0-3-7-4-8-5-6-2-1	0.0-3.0-7.0-4.0-8.0-5.0-6.0-2.0-1.0	98	142793	161352
HG03098#2#JAHEPL010000003.1_93803759_94117426_0	HG03098	161394	163164	8	8	0	0	7	1770	161824	160054	0-3-7-4-8-5-6-2-1	0.0-3.0-7.0-4.0-8.0-5.0-6.0-2.0-1.0	98	161296	163066
HG03098#2#JAHEPL010000003.1_93803759_94117426_0	HG03098	163108	175332	5	78	0	0	74	12224	174048	161824	0-3-7-4-8-5-6-2-1	0.0-3.0-7.0-4.0-8.0-5.0-6.0-2.0-1.0	98	163010	175234
HG03098#2#JAHEPL010000003.1_93803759_94117426_0	HG03098	176413	179356	6	24	0	1	23	2943	176991	174048	0-3-7-4-8-5-6-2-1	0.0-3.0-7.0-4.0-8.0-5.0-6.0-2.0-1.0	98	176315	179258
HG03098#2#JAHEPL010000003.1_93803759_94117426_0	HG03098	179300	210521	2	172	0	0	171	31221	208212	176991	0-3-7-4-8-5-6-2-1	0.0-3.0-7.0-4.0-8.0-5.0-6.0-2.0-1.0	98	179202	210423
HG03098#2#JAHEPL010000003.1_93803759_94117426_0	HG03098	210465	313595	1	612	0	0	611	103130	311342	208212	0-3-7-4-8-5-6-2-1	0.0-3.0-7.0-4.0-8.0-5.0-6.0-2.0-1.0	98	210367	313497
HG03453#1#JAGYVW010000157.1_2105722_2585000_1	HG03453	154	115487	0	671	0	0	670	115333	115333	0	0-3-7-4-8-5-6-2-7-4-8-5-6-2-7-4-2-5-6-2-1	0.0-3.0-7.0-4.0-8.0-5.0-6.0-2.0-7.0-4.0-8.0-5.0-6.0-2.0-7.0-4.0-2.1-5.0-6.0-2.0-1.0	154	0	115333
HG03453#1#JAGYVW010000157.1_2105722_2585000_1	HG03453	115578	138404	3	132	0	0	131	22826	138159	115333	0-3-7-4-8-5-6-2-7-4-8-5-6-2-7-4-2-5-6-2-1	0.0-3.0-7.0-4.0-8.0-5.0-6.0-2.0-7.0-4.0-8.0-5.0-6.0-2.0-7.0-4.0-2.1-5.0-6.0-2.0-1.0	154	115424	138250
HG03453#1#JAGYVW010000157.1_2105722_2585000_1	HG03453	139163	142458	7	17	0	0	16	3295	141454	138159	0-3-7-4-8-5-6-2-7-4-8-5-6-2-7-4-2-5-6-2-1	0.0-3.0-7.0-4.0-8.0-5.0-6.0-2.0-7.0-4.0-8.0-5.0-6.0-2.0-7.0-4.0-2.1-5.0-6.0-2.0-1.0	154	139009	142304
HG03453#1#JAGYVW010000157.1_2105722_2585000_1	HG03453	143521	161473	4	96	0	4	95	17952	159406	141454	0-3-7-4-8-5-6-2-7-4-8-5-6-2-7-4-2-5-6-2-1	0.0-3.0-7.0-4.0-8.0-5.0-6.0-2.0-7.0-4.0-8.0-5.0-6.0-2.0-7.0-4.0-2.1-5.0-6.0-2.0-1.0	154	143367	161319
HG03453#1#JAGYVW010000157.1_2105722_2585000_1	HG03453	161417	163187	8	8	0	0	7	1770	161176	159406	0-3-7-4-8-5-6-2-7-4-8-5-6-2-7-4-2-5-6-2-1	0.0-3.0-7.0-4.0-8.0-5.0-6.0-2.0-7.0-4.0-8.0-5.0-6.0-2.0-7.0-4.0-2.1-5.0-6.0-2.0-1.0	154	161263	163033
HG03453#1#JAGYVW010000157.1_2105722_2585000_1	HG03453	163131	175795	5	78	0	0	76	12664	173840	161176	0-3-7-4-8-5-6-2-7-4-8-5-6-2-7-4-2-5-6-2-1	0.0-3.0-7.0-4.0-8.0-5.0-6.0-2.0-7.0-4.0-8.0-5.0-6.0-2.0-7.0-4.0-2.1-5.0-6.0-2.0-1.0	154	162977	175641
HG03453#1#JAGYVW010000157.1_2105722_2585000_1	HG03453	176402	178929	6	24	0	1	21	2527	176367	173840	0-3-7-4-8-5-6-2-7-4-8-5-6-2-7-4-2-5-6-2-1	0.0-3.0-7.0-4.0-8.0-5.0-6.0-2.0-7.0-4.0-8.0-5.0-6.0-2.0-7.0-4.0-2.1-5.0-6.0-2.0-1.0	154	176248	178775
HG03453#1#JAGYVW010000157.1_2105722_2585000_1	HG03453	179288	210507	2	172	0	0	171	31219	207586	176367	0-3-7-4-8-5-6-2-7-4-8-5-6-2-7-4-2-5-6-2-1	0.0-3.0-7.0-4.0-8.0-5.0-6.0-2.0-7.0-4.0-8.0-5.0-6.0-2.0-7.0-4.0-2.1-5.0-6.0-2.0-1.0	154	179134	210353
HG03453#1#JAGYVW010000157.1_2105722_2585000_1	HG03453	211584	214879	7	17	0	0	16	3295	210881	207586	0-3-7-4-8-5-6-2-7-4-8-5-6-2-7-4-2-5-6-2-1	0.0-3.0-7.0-4.0-8.0-5.0-6.0-2.0-7.0-4.0-8.0-5.0-6.0-2.0-7.0-4.0-2.1-5.0-6.0-2.0-1.0	154	211430	214725
HG03453#1#JAGYVW010000157.1_2105722_2585000_1	HG03453	215942	233895	4	96	0	4	95	17953	228834	210881	0-3-7-4-8-5-6-2-7-4-8-5-6-2-7-4-2-5-6-2-1	0.0-3.0-7.0-4.0-8.0-5.0-6.0-2.0-7.0-4.0-8.0-5.0-6.0-2.0-7.0-4.0-2.1-5.0-6.0-2.0-1.0	154	215788	233741
HG03453#1#JAGYVW010000157.1_2105722_2585000_1	HG03453	233839	235609	8	8	0	0	7	1770	230604	228834	0-3-7-4-8-5-6-2-7-4-8-5-6-2-7-4-2-5-6-2-1	0.0-3.0-7.0-4.0-8.0-5.0-6.0-2.0-7.0-4.0-8.0-5.0-6.0-2.0-7.0-4.0-2.1-5.0-6.0-2.0-1.0	154	233685	235455
HG03453#1#JAGYVW010000157.1_2105722_2585000_1	HG03453	235553	248217	5	78	0	0	76	12664	243268	230604	0-3-7-4-8-5-6-2-7-4-8-5-6-2-7-4-2-5-6-2-1	0.0-3.0-7.0-4.0-8.0-5.0-6.0-2.0-7.0-4.0-8.0-5.0-6.0-2.0-7.0-4.0-2.1-5.0-6.0-2.0-1.0	154	235399	248063
HG03453#1#JAGYVW010000157.1_2105722_2585000_1	HG03453	248824	251351	6	24	0	1	21	2527	245795	243268	0-3-7-4-8-5-6-2-7-4-8-5-6-2-7-4-2-5-6-2-1	0.0-3.0-7.0-4.0-8.0-5.0-6.0-2.0-7.0-4.0-8.0-5.0-6.0-2.0-7.0-4.0-2.1-5.0-6.0-2.0-1.0	154	248670	251197
HG03453#1#JAGYVW010000157.1_2105722_2585000_1	HG03453	251710	282930	2	172	0	0	171	31220	277015	245795	0-3-7-4-8-5-6-2-7-4-8-5-6-2-7-4-2-5-6-2-1	0.0-3.0-7.0-4.0-8.0-5.0-6.0-2.0-7.0-4.0-8.0-5.0-6.0-2.0-7.0-4.0-2.1-5.0-6.0-2.0-1.0	154	251556	282776
HG03453#1#JAGYVW010000157.1_2105722_2585000_1	HG03453	284007	287302	7	17	0	0	16	3295	280310	277015	0-3-7-4-8-5-6-2-7-4-8-5-6-2-7-4-2-5-6-2-1	0.0-3.0-7.0-4.0-8.0-5.0-6.0-2.0-7.0-4.0-8.0-5.0-6.0-2.0-7.0-4.0-2.1-5.0-6.0-2.0-1.0	154	283853	287148
HG03453#1#JAGYVW010000157.1_2105722_2585000_1	HG03453	288365	299910	4	96	0	4	58	11545	291855	280310	0-3-7-4-8-5-6-2-7-4-8-5-6-2-7-4-2-5-6-2-1	0.0-3.0-7.0-4.0-8.0-5.0-6.0-2.0-7.0-4.0-8.0-5.0-6.0-2.0-7.0-4.0-2.1-5.0-6.0-2.0-1.0	154	288211	299756
HG03453#1#JAGYVW010000157.1_2105722_2585000_1	HG03453	302161	329697	2	172	1	170	15	27536	319391	291855	0-3-7-4-8-5-6-2-7-4-8-5-6-2-7-4-2-5-6-2-1	0.0-3.0-7.0-4.0-8.0-5.0-6.0-2.0-7.0-4.0-8.0-5.0-6.0-2.0-7.0-4.0-2.1-5.0-6.0-2.0-1.0	154	302007	329543
HG03453#1#JAGYVW010000157.1_2105722_2585000_1	HG03453	330136	342351	5	78	0	3	76	12215	331606	319391	0-3-7-4-8-5-6-2-7-4-8-5-6-2-7-4-2-5-6-2-1	0.0-3.0-7.0-4.0-8.0-5.0-6.0-2.0-7.0-4.0-8.0-5.0-6.0-2.0-7.0-4.0-2.1-5.0-6.0-2.0-1.0	154	329982	342197
HG03453#1#JAGYVW010000157.1_2105722_2585000_1	HG03453	342958	345485	6	24	0	1	21	2527	334133	331606	0-3-7-4-8-5-6-2-7-4-8-5-6-2-7-4-2-5-6-2-1	0.0-3.0-7.0-4.0-8.0-5.0-6.0-2.0-7.0-4.0-8.0-5.0-6.0-2.0-7.0-4.0-2.1-5.0-6.0-2.0-1.0	154	342804	345331
HG03453#1#JAGYVW010000157.1_2105722_2585000_1	HG03453	345844	377061	2	172	0	0	171	31217	365350	334133	0-3-7-4-8-5-6-2-7-4-8-5-6-2-7-4-2-5-6-2-1	0.0-3.0-7.0-4.0-8.0-5.0-6.0-2.0-7.0-4.0-8.0-5.0-6.0-2.0-7.0-4.0-2.1-5.0-6.0-2.0-1.0	154	345690	376907
HG03453#1#JAGYVW010000157.1_2105722_2585000_1	HG03453	377005	479216	1	612	0	0	605	102211	467561	365350	0-3-7-4-8-5-6-2-7-4-8-5-6-2-7-4-2-5-6-2-1	0.0-3.0-7.0-4.0-8.0-5.0-6.0-2.0-7.0-4.0-8.0-5.0-6.0-2.0-7.0-4.0-2.1-5.0-6.0-2.0-1.0	154	376851	479062
HG03453#2#JAGYVV010000088.1_22597550_23005370_1	HG03453	154	115518	0	671	0	0	670	115364	115364	0	0-3-7-4-8-5-6-2-7-4-2-6-5-2-1	0.0-3.0-7.0-4.0-8.0-5.0-6.0-2.0-7.0-4.0-2.1-6.1-5.1-2.0-1.0	154	0	115364
HG03453#2#JAGYVV010000088.1_22597550_23005370_1	HG03453	115609	138443	3	132	0	0	131	22834	138198	115364	0-3-7-4-8-5-6-2-7-4-2-6-5-2-1	0.0-3.0-7.0-4.0-8.0-5.0-6.0-2.0-7.0-4.0-2.1-6.1-5.1-2.0-1.0	154	115455	138289
HG03453#2#JAGYVV010000088.1_22597550_23005370_1	HG03453	139202	142498	7	17	0	0	16	3296	141494	138198	0-3-7-4-8-5-6-2-7-4-2-6-5-2-1	0.0-3.0-7.0-4.0-8.0-5.0-6.0-2.0-7.0-4.0-2.1-6.1-5.1-2.0-1.0	154	139048	142344
HG03453#2#JAGYVV010000088.1_22597550_23005370_1	HG03453	142946	161501	4	96	0	0	95	18555	160049	141494	0-3-7-4-8-5-6-2-7-4-2-6-5-2-1	0.0-3.0-7.0-4.0-8.0-5.0-6.0-2.0-7.0-4.0-2.1-6.1-5.1-2.0-1.0	154	142792	161347
HG03453#2#JAGYVV010000088.1_22597550_23005370_1	HG03453	161445	163215	8	8	0	0	7	1770	161819	160049	0-3-7-4-8-5-6-2-7-4-2-6-5-2-1	0.0-3.0-7.0-4.0-8.0-5.0-6.0-2.0-7.0-4.0-2.1-6.1-5.1-2.0-1.0	154	161291	163061
HG03453#2#JAGYVV010000088.1_22597550_23005370_1	HG03453	163159	176263	5	78	0	0	77	13104	174923	161819	0-3-7-4-8-5-6-2-7-4-2-6-5-2-1	0.0-3.0-7.0-4.0-8.0-5.0-6.0-2.0-7.0-4.0-2.1-6.1-5.1-2.0-1.0	154	163005	176109
HG03453#2#JAGYVV010000088.1_22597550_23005370_1	HG03453	176207	178951	6	24	0	0	21	2744	177667	174923	0-3-7-4-8-5-6-2-7-4-2-6-5-2-1	0.0-3.0-7.0-4.0-8.0-5.0-6.0-2.0-7.0-4.0-2.1-6.1-5.1-2.0-1.0	154	176053	178797
HG03453#2#JAGYVV010000088.1_22597550_23005370_1	HG03453	179309	210152	2	172	0	0	170	30843	208510	177667	0-3-7-4-8-5-6-2-7-4-2-6-5-2-1	0.0-3.0-7.0-4.0-8.0-5.0-6.0-2.0-7.0-4.0-2.1-6.1-5.1-2.0-1.0	154	179155	209998
HG03453#2#JAGYVV010000088.1_22597550_23005370_1	HG03453	211614	214909	7	17	0	0	16	3295	211805	208510	0-3-7-4-8-5-6-2-7-4-2-6-5-2-1	0.0-3.0-7.0-4.0-8.0-5.0-6.0-2.0-7.0-4.0-2.1-6.1-5.1-2.0-1.0	154	211460	214755
HG03453#2#JAGYVV010000088.1_22597550_23005370_1	HG03453	215974	227522	4	96	0	4	58	11548	223353	211805	0-3-7-4-8-5-6-2-7-4-2-6-5-2-1	0.0-3.0-7.0-4.0-8.0-5.0-6.0-2.0-7.0-4.0-2.1-6.1-5.1-2.0-1.0	154	215820	227368
HG03453#2#JAGYVV010000088.1_22597550_23005370_1	HG03453	229773	260608	2	172	1	170	0	30835	254188	223353	0-3-7-4-8-5-6-2-7-4-2-6-5-2-1	0.0-3.0-7.0-4.0-8.0-5.0-6.0-2.0-7.0-4.0-2.1-6.1-5.1-2.0-1.0	154	229619	260454
HG03453#2#JAGYVV010000088.1_22597550_23005370_1	HG03453	260966	263493	6	24	1	21	1	2527	256715	254188	0-3-7-4-8-5-6-2-7-4-2-6-5-2-1	0.0-3.0-7.0-4.0-8.0-5.0-6.0-2.0-7.0-4.0-2.1-6.1-5.1-2.0-1.0	154	260812	263339
HG03453#2#JAGYVV010000088.1_22597550_23005370_1	HG03453	264100	275788	5	78	1	76	5	11688	268403	256715	0-3-7-4-8-5-6-2-7-4-2-6-5-2-1	0.0-3.0-7.0-4.0-8.0-5.0-6.0-2.0-7.0-4.0-2.1-6.1-5.1-2.0-1.0	154	263946	275634
HG03453#2#JAGYVV010000088.1_22597550_23005370_1	HG03453	276754	304665	2	172	0	15	171	27911	296314	268403	0-3-7-4-8-5-6-2-7-4-2-6-5-2-1	0.0-3.0-7.0-4.0-8.0-5.0-6.0-2.0-7.0-4.0-2.1-6.1-5.1-2.0-1.0	154	276600	304511
HG03453#2#JAGYVV010000088.1_22597550_23005370_1	HG03453	304609	407804	1	612	0	0	611	103195	399509	296314	0-3-7-4-8-5-6-2-7-4-2-6-5-2-1	0.0-3.0-7.0-4.0-8.0-5.0-6.0-2.0-7.0-4.0-2.1-6.1-5.1-2.0-1.0	154	304455	407650
HG03486#1#JAHEOQ010000123.1_16677696_17085575_0	HG03486	99	115494	0	671	0	0	670	115395	115395	0	0-3-7-4-8-5-6-2-4-7-2-5-6-2-1	0.0-3.0-7.0-4.0-8.0-5.0-6.0-2.0-4.1-7.1-2.1-5.0-6.0-2.0-1.0	99	0	115395
HG03486#1#JAHEOQ010000123.1_16677696_17085575_0	HG03486	115585	138420	3	132	0	0	131	22835	138230	115395	0-3-7-4-8-5-6-2-4-7-2-5-6-2-1	0.0-3.0-7.0-4.0-8.0-5.0-6.0-2.0-4.1-7.1-2.1-5.0-6.0-2.0-1.0	99	115486	138321
HG03486#1#JAHEOQ010000123.1_16677696_17085575_0	HG03486	139179	142475	7	17	0	0	16	3296	141526	138230	0-3-7-4-8-5-6-2-4-7-2-5-6-2-1	0.0-3.0-7.0-4.0-8.0-5.0-6.0-2.0-4.1-7.1-2.1-5.0-6.0-2.0-1.0	99	139080	142376
HG03486#1#JAHEOQ010000123.1_16677696_17085575_0	HG03486	142923	161476	4	96	0	0	95	18553	160079	141526	0-3-7-4-8-5-6-2-4-7-2-5-6-2-1	0.0-3.0-7.0-4.0-8.0-5.0-6.0-2.0-4.1-7.1-2.1-5.0-6.0-2.0-1.0	99	142824	161377
HG03486#1#JAHEOQ010000123.1_16677696_17085575_0	HG03486	161420	163190	8	8	0	0	7	1770	161849	160079	0-3-7-4-8-5-6-2-4-7-2-5-6-2-1	0.0-3.0-7.0-4.0-8.0-5.0-6.0-2.0-4.1-7.1-2.1-5.0-6.0-2.0-1.0	99	161321	163091
HG03486#1#JAHEOQ010000123.1_16677696_17085575_0	HG03486	163134	176238	5	78	0	0	77	13104	174953	161849	0-3-7-4-8-5-6-2-4-7-2-5-6-2-1	0.0-3.0-7.0-4.0-8.0-5.0-6.0-2.0-4.1-7.1-2.1-5.0-6.0-2.0-1.0	99	163035	176139
HG03486#1#JAHEOQ010000123.1_16677696_17085575_0	HG03486	176182	178926	6	24	0	0	21	2744	177697	174953	0-3-7-4-8-5-6-2-4-7-2-5-6-2-1	0.0-3.0-7.0-4.0-8.0-5.0-6.0-2.0-4.1-7.1-2.1-5.0-6.0-2.0-1.0	99	176083	178827
HG03486#1#JAHEOQ010000123.1_16677696_17085575_0	HG03486	179284	209778	2	172	0	0	167	30494	208191	177697	0-3-7-4-8-5-6-2-4-7-2-5-6-2-1	0.0-3.0-7.0-4.0-8.0-5.0-6.0-2.0-4.1-7.1-2.1-5.0-6.0-2.0-1.0	99	179185	209679
HG03486#1#JAHEOQ010000123.1_16677696_17085575_0	HG03486	212370	223915	4	96	1	58	4	11545	219736	208191	0-3-7-4-8-5-6-2-4-7-2-5-6-2-1	0.0-3.0-7.0-4.0-8.0-5.0-6.0-2.0-4.1-7.1-2.1-5.0-6.0-2.0-1.0	99	212271	223816
HG03486#1#JAHEOQ010000123.1_16677696_17085575_0	HG03486	224982	228277	7	17	1	16	0	3295	223031	219736	0-3-7-4-8-5-6-2-4-7-2-5-6-2-1	0.0-3.0-7.0-4.0-8.0-5.0-6.0-2.0-4.1-7.1-2.1-5.0-6.0-2.0-1.0	99	224883	228178
HG03486#1#JAHEOQ010000123.1_16677696_17085575_0	HG03486	229739	257267	2	172	1	170	15	27528	250559	223031	0-3-7-4-8-5-6-2-4-7-2-5-6-2-1	0.0-3.0-7.0-4.0-8.0-5.0-6.0-2.0-4.1-7.1-2.1-5.0-6.0-2.0-1.0	99	229640	257168
HG03486#1#JAHEOQ010000123.1_16677696_17085575_0	HG03486	258233	269921	5	78	0	5	76	11688	262247	250559	0-3-7-4-8-5-6-2-4-7-2-5-6-2-1	0.0-3.0-7.0-4.0-8.0-5.0-6.0-2.0-4.1-7.1-2.1-5.0-6.0-2.0-1.0	99	258134	269822
HG03486#1#JAHEOQ010000123.1_16677696_17085575_0	HG03486	270528	273055	6	24	0	1	21	2527	264774	262247	0-3-7-4-8-5-6-2-4-7-2-5-6-2-1	0.0-3.0-7.0-4.0-8.0-5.0-6.0-2.0-4.1-7.1-2.1-5.0-6.0-2.0-1.0	99	270429	272956
HG03486#1#JAHEOQ010000123.1_16677696_17085575_0	HG03486	273413	304631	2	172	0	0	171	31218	295992	264774	0-3-7-4-8-5-6-2-4-7-2-5-6-2-1	0.0-3.0-7.0-4.0-8.0-5.0-6.0-2.0-4.1-7.1-2.1-5.0-6.0-2.0-1.0	99	273314	304532
HG03486#1#JAHEOQ010000123.1_16677696_17085575_0	HG03486	304575	407807	1	612	0	0	611	103232	399224	295992	0-3-7-4-8-5-6-2-4-7-2-5-6-2-1	0.0-3.0-7.0-4.0-8.0-5.0-6.0-2.0-4.1-7.1-2.1-5.0-6.0-2.0-1.0	99	304476	407708
HG03486#2#JAHEOP010000248.1_2105565_2584784_1	HG03486	154	115473	0	671	0	0	670	115319	115319	0	0-3-7-4-8-5-6-2-7-4-8-5-6-2-7-4-2-6-5-2-1	0.0-3.0-7.0-4.0-8.0-5.0-6.0-2.0-7.0-4.0-8.0-5.0-6.0-2.0-7.0-4.0-2.1-6.1-5.1-2.0-1.0	154	0	115319
HG03486#2#JAHEOP010000248.1_2105565_2584784_1	HG03486	115564	138393	3	132	0	0	131	22829	138148	115319	0-3-7-4-8-5-6-2-7-4-8-5-6-2-7-4-2-6-5-2-1	0.0-3.0-7.0-4.0-8.0-5.0-6.0-2.0-7.0-4.0-8.0-5.0-6.0-2.0-7.0-4.0-2.1-6.1-5.1-2.0-1.0	154	115410	138239
HG03486#2#JAHEOP010000248.1_2105565_2584784_1	HG03486	139152	142447	7	17	0	0	16	3295	141443	138148	0-3-7-4-8-5-6-2-7-4-8-5-6-2-7-4-2-6-5-2-1	0.0-3.0-7.0-4.0-8.0-5.0-6.0-2.0-7.0-4.0-8.0-5.0-6.0-2.0-7.0-4.0-2.1-6.1-5.1-2.0-1.0	154	138998	142293
HG03486#2#JAHEOP010000248.1_2105565_2584784_1	HG03486	142895	161462	4	96	0	0	95	18567	160010	141443	0-3-7-4-8-5-6-2-7-4-8-5-6-2-7-4-2-6-5-2-1	0.0-3.0-7.0-4.0-8.0-5.0-6.0-2.0-7.0-4.0-8.0-5.0-6.0-2.0-7.0-4.0-2.1-6.1-5.1-2.0-1.0	154	142741	161308
HG03486#2#JAHEOP010000248.1_2105565_2584784_1	HG03486	161406	163176	8	8	0	0	7	1770	161780	160010	0-3-7-4-8-5-6-2-7-4-8-5-6-2-7-4-2-6-5-2-1	0.0-3.0-7.0-4.0-8.0-5.0-6.0-2.0-7.0-4.0-8.0-5.0-6.0-2.0-7.0-4.0-2.1-6.1-5.1-2.0-1.0	154	161252	163022
HG03486#2#JAHEOP010000248.1_2105565_2584784_1	HG03486	163120	176224	5	78	0	0	77	13104	174884	161780	0-3-7-4-8-5-6-2-7-4-8-5-6-2-7-4-2-6-5-2-1	0.0-3.0-7.0-4.0-8.0-5.0-6.0-2.0-7.0-4.0-8.0-5.0-6.0-2.0-7.0-4.0-2.1-6.1-5.1-2.0-1.0	154	162966	176070
HG03486#2#JAHEOP010000248.1_2105565_2584784_1	HG03486	176168	178912	6	24	0	0	21	2744	177628	174884	0-3-7-4-8-5-6-2-7-4-8-5-6-2-7-4-2-6-5-2-1	0.0-3.0-7.0-4.0-8.0-5.0-6.0-2.0-7.0-4.0-8.0-5.0-6.0-2.0-7.0-4.0-2.1-6.1-5.1-2.0-1.0	154	176014	178758
HG03486#2#JAHEOP010000248.1_2105565_2584784_1	HG03486	179271	210493	2	172	0	0	171	31222	208850	177628	0-3-7-4-8-5-6-2-7-4-8-5-6-2-7-4-2-6-5-2-1	0.0-3.0-7.0-4.0-8.0-5.0-6.0-2.0-7.0-4.0-8.0-5.0-6.0-2.0-7.0-4.0-2.1-6.1-5.1-2.0-1.0	154	179117	210339
HG03486#2#JAHEOP010000248.1_2105565_2584784_1	HG03486	211570	214865	7	17	0	0	16	3295	212145	208850	0-3-7-4-8-5-6-2-7-4-8-5-6-2-7-4-2-6-5-2-1	0.0-3.0-7.0-4.0-8.0-5.0-6.0-2.0-7.0-4.0-8.0-5.0-6.0-2.0-7.0-4.0-2.1-6.1-5.1-2.0-1.0	154	211416	214711
HG03486#2#JAHEOP010000248.1_2105565_2584784_1	HG03486	215313	233880	4	96	0	0	95	18567	230712	212145	0-3-7-4-8-5-6-2-7-4-8-5-6-2-7-4-2-6-5-2-1	0.0-3.0-7.0-4.0-8.0-5.0-6.0-2.0-7.0-4.0-8.0-5.0-6.0-2.0-7.0-4.0-2.1-6.1-5.1-2.0-1.0	154	215159	233726
HG03486#2#JAHEOP010000248.1_2105565_2584784_1	HG03486	233824	235594	8	8	0	0	7	1770	232482	230712	0-3-7-4-8-5-6-2-7-4-8-5-6-2-7-4-2-6-5-2-1	0.0-3.0-7.0-4.0-8.0-5.0-6.0-2.0-7.0-4.0-8.0-5.0-6.0-2.0-7.0-4.0-2.1-6.1-5.1-2.0-1.0	154	233670	235440
HG03486#2#JAHEOP010000248.1_2105565_2584784_1	HG03486	235538	248642	5	78	0	0	77	13104	245586	232482	0-3-7-4-8-5-6-2-7-4-8-5-6-2-7-4-2-6-5-2-1	0.0-3.0-7.0-4.0-8.0-5.0-6.0-2.0-7.0-4.0-8.0-5.0-6.0-2.0-7.0-4.0-2.1-6.1-5.1-2.0-1.0	154	235384	248488
HG03486#2#JAHEOP010000248.1_2105565_2584784_1	HG03486	248586	251330	6	24	0	0	21	2744	248330	245586	0-3-7-4-8-5-6-2-7-4-8-5-6-2-7-4-2-6-5-2-1	0.0-3.0-7.0-4.0-8.0-5.0-6.0-2.0-7.0-4.0-8.0-5.0-6.0-2.0-7.0-4.0-2.1-6.1-5.1-2.0-1.0	154	248432	251176
HG03486#2#JAHEOP010000248.1_2105565_2584784_1	HG03486	251689	282903	2	172	0	0	171	31214	279544	248330	0-3-7-4-8-5-6-2-7-4-8-5-6-2-7-4-2-6-5-2-1	0.0-3.0-7.0-4.0-8.0-5.0-6.0-2.0-7.0-4.0-8.0-5.0-6.0-2.0-7.0-4.0-2.1-6.1-5.1-2.0-1.0	154	251535	282749
HG03486#2#JAHEOP010000248.1_2105565_2584784_1	HG03486	283980	287275	7	17	0	0	16	3295	282839	279544	0-3-7-4-8-5-6-2-7-4-8-5-6-2-7-4-2-6-5-2-1	0.0-3.0-7.0-4.0-8.0-5.0-6.0-2.0-7.0-4.0-8.0-5.0-6.0-2.0-7.0-4.0-2.1-6.1-5.1-2.0-1.0	154	283826	287121
HG03486#2#JAHEOP010000248.1_2105565_2584784_1	HG03486	288338	299885	4	96	0	4	58	11547	294386	282839	0-3-7-4-8-5-6-2-7-4-8-5-6-2-7-4-2-6-5-2-1	0.0-3.0-7.0-4.0-8.0-5.0-6.0-2.0-7.0-4.0-8.0-5.0-6.0-2.0-7.0-4.0-2.1-6.1-5.1-2.0-1.0	154	288184	299731
HG03486#2#JAHEOP010000248.1_2105565_2584784_1	HG03486	301751	332964	2	172	1	171	0	31213	325599	294386	0-3-7-4-8-5-6-2-7-4-8-5-6-2-7-4-2-6-5-2-1	0.0-3.0-7.0-4.0-8.0-5.0-6.0-2.0-7.0-4.0-8.0-5.0-6.0-2.0-7.0-4.0-2.1-6.1-5.1-2.0-1.0	154	301597	332810
HG03486#2#JAHEOP010000248.1_2105565_2584784_1	HG03486	333323	335850	6	24	1	21	1	2527	328126	325599	0-3-7-4-8-5-6-2-7-4-8-5-6-2-7-4-2-6-5-2-1	0.0-3.0-7.0-4.0-8.0-5.0-6.0-2.0-7.0-4.0-8.0-5.0-6.0-2.0-7.0-4.0-2.1-6.1-5.1-2.0-1.0	154	333169	335696
HG03486#2#JAHEOP010000248.1_2105565_2584784_1	HG03486	336457	348672	5	78	1	76	3	12215	340341	328126	0-3-7-4-8-5-6-2-7-4-8-5-6-2-7-4-2-6-5-2-1	0.0-3.0-7.0-4.0-8.0-5.0-6.0-2.0-7.0-4.0-8.0-5.0-6.0-2.0-7.0-4.0-2.1-6.1-5.1-2.0-1.0	154	336303	348518
HG03486#2#JAHEOP010000248.1_2105565_2584784_1	HG03486	349111	377019	2	172	0	15	171	27908	368249	340341	0-3-7-4-8-5-6-2-7-4-8-5-6-2-7-4-2-6-5-2-1	0.0-3.0-7.0-4.0-8.0-5.0-6.0-2.0-7.0-4.0-8.0-5.0-6.0-2.0-7.0-4.0-2.1-6.1-5.1-2.0-1.0	154	348957	376865
HG03486#2#JAHEOP010000248.1_2105565_2584784_1	HG03486	376963	479157	1	612	0	0	605	102194	470443	368249	0-3-7-4-8-5-6-2-7-4-8-5-6-2-7-4-2-6-5-2-1	0.0-3.0-7.0-4.0-8.0-5.0-6.0-2.0-7.0-4.0-8.0-5.0-6.0-2.0-7.0-4.0-2.1-6.1-5.1-2.0-1.0	154	376809	479003
HG03492#1#JAHEPI010000180.1_2103395_2543326_1	HG03492	154	115516	0	671	0	0	670	115362	115362	0	0-3-7-4-8-5-6-2-7-4-8-5-6-2-4-2-6-5-2-1	0.0-3.0-7.0-4.0-8.0-5.0-6.0-2.0-7.0-4.0-8.0-5.0-6.0-2.0-4.0-2.1-6.1-5.1-2.0-1.0	154	0	115362
HG03492#1#JAHEPI010000180.1_2103395_2543326_1	HG03492	115607	138441	3	132	0	0	131	22834	138196	115362	0-3-7-4-8-5-6-2-7-4-8-5-6-2-4-2-6-5-2-1	0.0-3.0-7.0-4.0-8.0-5.0-6.0-2.0-7.0-4.0-8.0-5.0-6.0-2.0-4.0-2.1-6.1-5.1-2.0-1.0	154	115453	138287
HG03492#1#JAHEPI010000180.1_2103395_2543326_1	HG03492	139200	142496	7	17	0	0	16	3296	141492	138196	0-3-7-4-8-5-6-2-7-4-8-5-6-2-4-2-6-5-2-1	0.0-3.0-7.0-4.0-8.0-5.0-6.0-2.0-7.0-4.0-8.0-5.0-6.0-2.0-4.0-2.1-6.1-5.1-2.0-1.0	154	139046	142342
HG03492#1#JAHEPI010000180.1_2103395_2543326_1	HG03492	142944	161502	4	96	0	0	95	18558	160050	141492	0-3-7-4-8-5-6-2-7-4-8-5-6-2-4-2-6-5-2-1	0.0-3.0-7.0-4.0-8.0-5.0-6.0-2.0-7.0-4.0-8.0-5.0-6.0-2.0-4.0-2.1-6.1-5.1-2.0-1.0	154	142790	161348
HG03492#1#JAHEPI010000180.1_2103395_2543326_1	HG03492	161446	163216	8	8	0	0	7	1770	161820	160050	0-3-7-4-8-5-6-2-7-4-8-5-6-2-4-2-6-5-2-1	0.0-3.0-7.0-4.0-8.0-5.0-6.0-2.0-7.0-4.0-8.0-5.0-6.0-2.0-4.0-2.1-6.1-5.1-2.0-1.0	154	161292	163062
HG03492#1#JAHEPI010000180.1_2103395_2543326_1	HG03492	163160	175824	5	78	0	0	76	12664	174484	161820	0-3-7-4-8-5-6-2-7-4-8-5-6-2-4-2-6-5-2-1	0.0-3.0-7.0-4.0-8.0-5.0-6.0-2.0-7.0-4.0-8.0-5.0-6.0-2.0-4.0-2.1-6.1-5.1-2.0-1.0	154	163006	175670
HG03492#1#JAHEPI010000180.1_2103395_2543326_1	HG03492	176434	178961	6	24	0	1	21	2527	177011	174484	0-3-7-4-8-5-6-2-7-4-8-5-6-2-4-2-6-5-2-1	0.0-3.0-7.0-4.0-8.0-5.0-6.0-2.0-7.0-4.0-8.0-5.0-6.0-2.0-4.0-2.1-6.1-5.1-2.0-1.0	154	176280	178807
HG03492#1#JAHEPI010000180.1_2103395_2543326_1	HG03492	179320	210540	2	172	0	0	171	31220	208231	177011	0-3-7-4-8-5-6-2-7-4-8-5-6-2-4-2-6-5-2-1	0.0-3.0-7.0-4.0-8.0-5.0-6.0-2.0-7.0-4.0-8.0-5.0-6.0-2.0-4.0-2.1-6.1-5.1-2.0-1.0	154	179166	210386
HG03492#1#JAHEPI010000180.1_2103395_2543326_1	HG03492	211617	214913	7	17	0	0	16	3296	211527	208231	0-3-7-4-8-5-6-2-7-4-8-5-6-2-4-2-6-5-2-1	0.0-3.0-7.0-4.0-8.0-5.0-6.0-2.0-7.0-4.0-8.0-5.0-6.0-2.0-4.0-2.1-6.1-5.1-2.0-1.0	154	211463	214759
HG03492#1#JAHEPI010000180.1_2103395_2543326_1	HG03492	215976	233923	4	96	0	4	95	17947	229474	211527	0-3-7-4-8-5-6-2-7-4-8-5-6-2-4-2-6-5-2-1	0.0-3.0-7.0-4.0-8.0-5.0-6.0-2.0-7.0-4.0-8.0-5.0-6.0-2.0-4.0-2.1-6.1-5.1-2.0-1.0	154	215822	233769
HG03492#1#JAHEPI010000180.1_2103395_2543326_1	HG03492	233867	235637	8	8	0	0	7	1770	231244	229474	0-3-7-4-8-5-6-2-7-4-8-5-6-2-4-2-6-5-2-1	0.0-3.0-7.0-4.0-8.0-5.0-6.0-2.0-7.0-4.0-8.0-5.0-6.0-2.0-4.0-2.1-6.1-5.1-2.0-1.0	154	233713	235483
HG03492#1#JAHEPI010000180.1_2103395_2543326_1	HG03492	235581	248245	5	78	0	0	76	12664	243908	231244	0-3-7-4-8-5-6-2-7-4-8-5-6-2-4-2-6-5-2-1	0.0-3.0-7.0-4.0-8.0-5.0-6.0-2.0-7.0-4.0-8.0-5.0-6.0-2.0-4.0-2.1-6.1-5.1-2.0-1.0	154	235427	248091
HG03492#1#JAHEPI010000180.1_2103395_2543326_1	HG03492	248855	251798	6	24	0	1	23	2943	246851	243908	0-3-7-4-8-5-6-2-7-4-8-5-6-2-4-2-6-5-2-1	0.0-3.0-7.0-4.0-8.0-5.0-6.0-2.0-7.0-4.0-8.0-5.0-6.0-2.0-4.0-2.1-6.1-5.1-2.0-1.0	154	248701	251644
HG03492#1#JAHEPI010000180.1_2103395_2543326_1	HG03492	251742	256956	2	172	0	0	25	5214	252065	246851	0-3-7-4-8-5-6-2-7-4-8-5-6-2-4-2-6-5-2-1	0.0-3.0-7.0-4.0-8.0-5.0-6.0-2.0-7.0-4.0-8.0-5.0-6.0-2.0-4.0-2.1-6.1-5.1-2.0-1.0	154	251588	256802
HG03492#1#JAHEPI010000180.1_2103395_2543326_1	HG03492	257179	259446	4	96	0	47	57	2267	254332	252065	0-3-7-4-8-5-6-2-7-4-8-5-6-2-4-2-6-5-2-1	0.0-3.0-7.0-4.0-8.0-5.0-6.0-2.0-7.0-4.0-8.0-5.0-6.0-2.0-4.0-2.1-6.1-5.1-2.0-1.0	154	257025	259292
HG03492#1#JAHEPI010000180.1_2103395_2543326_1	HG03492	261538	292756	2	172	1	171	0	31218	285550	254332	0-3-7-4-8-5-6-2-7-4-8-5-6-2-4-2-6-5-2-1	0.0-3.0-7.0-4.0-8.0-5.0-6.0-2.0-7.0-4.0-8.0-5.0-6.0-2.0-4.0-2.1-6.1-5.1-2.0-1.0	154	261384	292602
HG03492#1#JAHEPI010000180.1_2103395_2543326_1	HG03492	292700	295643	6	24	1	23	1	2943	288493	285550	0-3-7-4-8-5-6-2-7-4-8-5-6-2-4-2-6-5-2-1	0.0-3.0-7.0-4.0-8.0-5.0-6.0-2.0-7.0-4.0-8.0-5.0-6.0-2.0-4.0-2.1-6.1-5.1-2.0-1.0	154	292546	295489
HG03492#1#JAHEPI010000180.1_2103395_2543326_1	HG03492	296250	308465	5	78	1	76	3	12215	300708	288493	0-3-7-4-8-5-6-2-7-4-8-5-6-2-4-2-6-5-2-1	0.0-3.0-7.0-4.0-8.0-5.0-6.0-2.0-7.0-4.0-8.0-5.0-6.0-2.0-4.0-2.1-6.1-5.1-2.0-1.0	154	296096	308311
HG03492#1#JAHEPI010000180.1_2103395_2543326_1	HG03492	308904	336818	2	172	0	15	171	27914	328622	300708	0-3-7-4-8-5-6-2-7-4-8-5-6-2-4-2-6-5-2-1	0.0-3.0-7.0-4.0-8.0-5.0-6.0-2.0-7.0-4.0-8.0-5.0-6.0-2.0-4.0-2.1-6.1-5.1-2.0-1.0	154	308750	336664
HG03492#1#JAHEPI010000180.1_2103395_2543326_1	HG03492	336762	439915	1	612	0	0	611	103153	431775	328622	0-3-7-4-8-5-6-2-7-4-8-5-6-2-4-2-6-5-2-1	0.0-3.0-7.0-4.0-8.0-5.0-6.0-2.0-7.0-4.0-8.0-5.0-6.0-2.0-4.0-2.1-6.1-5.1-2.0-1.0	154	336608	439761
HG03492#2#JAHEPH010000288.1_2098270_2432686_1	HG03492	154	115514	0	671	0	0	670	115360	115360	0	0-3-7-4-2-6-5-2-1	0.0-3.0-7.0-4.0-2.1-6.1-5.1-2.0-1.0	154	0	115360
HG03492#2#JAHEPH010000288.1_2098270_2432686_1	HG03492	115605	138440	3	132	0	0	131	22835	138195	115360	0-3-7-4-2-6-5-2-1	0.0-3.0-7.0-4.0-2.1-6.1-5.1-2.0-1.0	154	115451	138286
HG03492#2#JAHEPH010000288.1_2098270_2432686_1	HG03492	139199	142495	7	17	0	0	16	3296	141491	138195	0-3-7-4-2-6-5-2-1	0.0-3.0-7.0-4.0-2.1-6.1-5.1-2.0-1.0	154	139045	142341
HG03492#2#JAHEPH010000288.1_2098270_2432686_1	HG03492	142943	155100	4	96	0	0	58	12157	153648	141491	0-3-7-4-2-6-5-2-1	0.0-3.0-7.0-4.0-2.1-6.1-5.1-2.0-1.0	154	142789	154946
HG03492#2#JAHEPH010000288.1_2098270_2432686_1	HG03492	156966	188184	2	172	1	171	0	31218	184866	153648	0-3-7-4-2-6-5-2-1	0.0-3.0-7.0-4.0-2.1-6.1-5.1-2.0-1.0	154	156812	188030
HG03492#2#JAHEPH010000288.1_2098270_2432686_1	HG03492	188545	191072	6	24	1	21	1	2527	187393	184866	0-3-7-4-2-6-5-2-1	0.0-3.0-7.0-4.0-2.1-6.1-5.1-2.0-1.0	154	188391	190918
HG03492#2#JAHEPH010000288.1_2098270_2432686_1	HG03492	191679	203894	5	78	1	76	3	12215	199608	187393	0-3-7-4-2-6-5-2-1	0.0-3.0-7.0-4.0-2.1-6.1-5.1-2.0-1.0	154	191525	203740
HG03492#2#JAHEPH010000288.1_2098270_2432686_1	HG03492	204333	231862	2	172	0	15	170	27529	227137	199608	0-3-7-4-2-6-5-2-1	0.0-3.0-7.0-4.0-2.1-6.1-5.1-2.0-1.0	154	204179	231708
HG03492#2#JAHEPH010000288.1_2098270_2432686_1	HG03492	232286	334354	1	612	0	1	605	102068	329205	227137	0-3-7-4-2-6-5-2-1	0.0-3.0-7.0-4.0-2.1-6.1-5.1-2.0-1.0	154	232132	334200
HG03516#1#JAGYYT010000012.1_24170958_24578778_1	HG03516	154	115552	0	671	0	0	670	115398	115398	0	0-3-7-4-8-5-6-2-7-4-2-6-5-2-1	0.0-3.0-7.0-4.0-8.0-5.0-6.0-2.0-7.0-4.0-2.1-6.1-5.1-2.0-1.0	154	0	115398
HG03516#1#JAGYYT010000012.1_24170958_24578778_1	HG03516	115643	138474	3	132	0	0	131	22831	138229	115398	0-3-7-4-8-5-6-2-7-4-2-6-5-2-1	0.0-3.0-7.0-4.0-8.0-5.0-6.0-2.0-7.0-4.0-2.1-6.1-5.1-2.0-1.0	154	115489	138320
HG03516#1#JAGYYT010000012.1_24170958_24578778_1	HG03516	139233	142528	7	17	0	0	16	3295	141524	138229	0-3-7-4-8-5-6-2-7-4-2-6-5-2-1	0.0-3.0-7.0-4.0-8.0-5.0-6.0-2.0-7.0-4.0-2.1-6.1-5.1-2.0-1.0	154	139079	142374
HG03516#1#JAGYYT010000012.1_24170958_24578778_1	HG03516	143319	161527	4	96	0	1	95	18208	159732	141524	0-3-7-4-8-5-6-2-7-4-2-6-5-2-1	0.0-3.0-7.0-4.0-8.0-5.0-6.0-2.0-7.0-4.0-2.1-6.1-5.1-2.0-1.0	154	143165	161373
HG03516#1#JAGYYT010000012.1_24170958_24578778_1	HG03516	161471	163241	8	8	0	0	7	1770	161502	159732	0-3-7-4-8-5-6-2-7-4-2-6-5-2-1	0.0-3.0-7.0-4.0-8.0-5.0-6.0-2.0-7.0-4.0-2.1-6.1-5.1-2.0-1.0	154	161317	163087
HG03516#1#JAGYYT010000012.1_24170958_24578778_1	HG03516	163185	175849	5	78	0	0	76	12664	174166	161502	0-3-7-4-8-5-6-2-7-4-2-6-5-2-1	0.0-3.0-7.0-4.0-8.0-5.0-6.0-2.0-7.0-4.0-2.1-6.1-5.1-2.0-1.0	154	163031	175695
HG03516#1#JAGYYT010000012.1_24170958_24578778_1	HG03516	176233	178977	6	24	0	0	21	2744	176910	174166	0-3-7-4-8-5-6-2-7-4-2-6-5-2-1	0.0-3.0-7.0-4.0-8.0-5.0-6.0-2.0-7.0-4.0-2.1-6.1-5.1-2.0-1.0	154	176079	178823
HG03516#1#JAGYYT010000012.1_24170958_24578778_1	HG03516	179336	210553	2	172	0	0	171	31217	208127	176910	0-3-7-4-8-5-6-2-7-4-2-6-5-2-1	0.0-3.0-7.0-4.0-8.0-5.0-6.0-2.0-7.0-4.0-2.1-6.1-5.1-2.0-1.0	154	179182	210399
HG03516#1#JAGYYT010000012.1_24170958_24578778_1	HG03516	211630	214925	7	17	0	0	16	3295	211422	208127	0-3-7-4-8-5-6-2-7-4-2-6-5-2-1	0.0-3.0-7.0-4.0-8.0-5.0-6.0-2.0-7.0-4.0-2.1-6.1-5.1-2.0-1.0	154	211476	214771
HG03516#1#JAGYYT010000012.1_24170958_24578778_1	HG03516	215988	227531	4	96	0	4	58	11543	222965	211422	0-3-7-4-8-5-6-2-7-4-2-6-5-2-1	0.0-3.0-7.0-4.0-8.0-5.0-6.0-2.0-7.0-4.0-2.1-6.1-5.1-2.0-1.0	154	215834	227377
HG03516#1#JAGYYT010000012.1_24170958_24578778_1	HG03516	229397	260610	2	172	1	171	0	31213	254178	222965	0-3-7-4-8-5-6-2-7-4-2-6-5-2-1	0.0-3.0-7.0-4.0-8.0-5.0-6.0-2.0-7.0-4.0-2.1-6.1-5.1-2.0-1.0	154	229243	260456
HG03516#1#JAGYYT010000012.1_24170958_24578778_1	HG03516	260969	263496	6	24	1	21	1	2527	256705	254178	0-3-7-4-8-5-6-2-7-4-2-6-5-2-1	0.0-3.0-7.0-4.0-8.0-5.0-6.0-2.0-7.0-4.0-2.1-6.1-5.1-2.0-1.0	154	260815	263342
HG03516#1#JAGYYT010000012.1_24170958_24578778_1	HG03516	264103	276318	5	78	1	76	3	12215	268920	256705	0-3-7-4-8-5-6-2-7-4-2-6-5-2-1	0.0-3.0-7.0-4.0-8.0-5.0-6.0-2.0-7.0-4.0-2.1-6.1-5.1-2.0-1.0	154	263949	276164
HG03516#1#JAGYYT010000012.1_24170958_24578778_1	HG03516	276757	304675	2	172	0	15	171	27918	296838	268920	0-3-7-4-8-5-6-2-7-4-2-6-5-2-1	0.0-3.0-7.0-4.0-8.0-5.0-6.0-2.0-7.0-4.0-2.1-6.1-5.1-2.0-1.0	154	276603	304521
HG03516#1#JAGYYT010000012.1_24170958_24578778_1	HG03516	304619	407804	1	612	0	0	611	103185	400023	296838	0-3-7-4-8-5-6-2-7-4-2-6-5-2-1	0.0-3.0-7.0-4.0-8.0-5.0-6.0-2.0-7.0-4.0-2.1-6.1-5.1-2.0-1.0	154	304465	407650
HG03516#2#JAGYYS010000004.1_24452130_24859892_1	HG03516	154	115524	0	671	0	0	670	115370	115370	0	0-3-7-4-8-5-6-2-4-7-2-6-5-2-1	0.0-3.0-7.0-4.0-8.0-5.0-6.0-2.0-4.1-7.1-2.1-6.1-5.1-2.0-1.0	154	0	115370
HG03516#2#JAGYYS010000004.1_24452130_24859892_1	HG03516	115615	138449	3	132	0	0	131	22834	138204	115370	0-3-7-4-8-5-6-2-4-7-2-6-5-2-1	0.0-3.0-7.0-4.0-8.0-5.0-6.0-2.0-4.1-7.1-2.1-6.1-5.1-2.0-1.0	154	115461	138295
HG03516#2#JAGYYS010000004.1_24452130_24859892_1	HG03516	139208	142503	7	17	0	0	16	3295	141499	138204	0-3-7-4-8-5-6-2-4-7-2-6-5-2-1	0.0-3.0-7.0-4.0-8.0-5.0-6.0-2.0-4.1-7.1-2.1-6.1-5.1-2.0-1.0	154	139054	142349
HG03516#2#JAGYYS010000004.1_24452130_24859892_1	HG03516	142951	161510	4	96	0	0	95	18559	160058	141499	0-3-7-4-8-5-6-2-4-7-2-6-5-2-1	0.0-3.0-7.0-4.0-8.0-5.0-6.0-2.0-4.1-7.1-2.1-6.1-5.1-2.0-1.0	154	142797	161356
HG03516#2#JAGYYS010000004.1_24452130_24859892_1	HG03516	161454	163224	8	8	0	0	7	1770	161828	160058	0-3-7-4-8-5-6-2-4-7-2-6-5-2-1	0.0-3.0-7.0-4.0-8.0-5.0-6.0-2.0-4.1-7.1-2.1-6.1-5.1-2.0-1.0	154	161300	163070
HG03516#2#JAGYYS010000004.1_24452130_24859892_1	HG03516	163168	175358	5	78	0	0	74	12190	174018	161828	0-3-7-4-8-5-6-2-4-7-2-6-5-2-1	0.0-3.0-7.0-4.0-8.0-5.0-6.0-2.0-4.1-7.1-2.1-6.1-5.1-2.0-1.0	154	163014	175204
HG03516#2#JAGYYS010000004.1_24452130_24859892_1	HG03516	176439	179382	6	24	0	1	23	2943	176961	174018	0-3-7-4-8-5-6-2-4-7-2-6-5-2-1	0.0-3.0-7.0-4.0-8.0-5.0-6.0-2.0-4.1-7.1-2.1-6.1-5.1-2.0-1.0	154	176285	179228
HG03516#2#JAGYYS010000004.1_24452130_24859892_1	HG03516	179326	210545	2	172	0	0	171	31219	208180	176961	0-3-7-4-8-5-6-2-4-7-2-6-5-2-1	0.0-3.0-7.0-4.0-8.0-5.0-6.0-2.0-4.1-7.1-2.1-6.1-5.1-2.0-1.0	154	179172	210391
HG03516#2#JAGYYS010000004.1_24452130_24859892_1	HG03516	212411	223532	4	96	1	58	6	11121	219301	208180	0-3-7-4-8-5-6-2-4-7-2-6-5-2-1	0.0-3.0-7.0-4.0-8.0-5.0-6.0-2.0-4.1-7.1-2.1-6.1-5.1-2.0-1.0	154	212257	223378
HG03516#2#JAGYYS010000004.1_24452130_24859892_1	HG03516	225019	228314	7	17	1	16	0	3295	222596	219301	0-3-7-4-8-5-6-2-4-7-2-6-5-2-1	0.0-3.0-7.0-4.0-8.0-5.0-6.0-2.0-4.1-7.1-2.1-6.1-5.1-2.0-1.0	154	224865	228160
HG03516#2#JAGYYS010000004.1_24452130_24859892_1	HG03516	229776	260610	2	172	1	170	0	30834	253430	222596	0-3-7-4-8-5-6-2-4-7-2-6-5-2-1	0.0-3.0-7.0-4.0-8.0-5.0-6.0-2.0-4.1-7.1-2.1-6.1-5.1-2.0-1.0	154	229622	260456
HG03516#2#JAGYYS010000004.1_24452130_24859892_1	HG03516	260554	263497	6	24	1	23	1	2943	256373	253430	0-3-7-4-8-5-6-2-4-7-2-6-5-2-1	0.0-3.0-7.0-4.0-8.0-5.0-6.0-2.0-4.1-7.1-2.1-6.1-5.1-2.0-1.0	154	260400	263343
HG03516#2#JAGYYS010000004.1_24452130_24859892_1	HG03516	264578	276318	5	78	1	74	3	11740	268113	256373	0-3-7-4-8-5-6-2-4-7-2-6-5-2-1	0.0-3.0-7.0-4.0-8.0-5.0-6.0-2.0-4.1-7.1-2.1-6.1-5.1-2.0-1.0	154	264424	276164
HG03516#2#JAGYYS010000004.1_24452130_24859892_1	HG03516	276757	304666	2	172	0	15	171	27909	296022	268113	0-3-7-4-8-5-6-2-4-7-2-6-5-2-1	0.0-3.0-7.0-4.0-8.0-5.0-6.0-2.0-4.1-7.1-2.1-6.1-5.1-2.0-1.0	154	276603	304512
HG03516#2#JAGYYS010000004.1_24452130_24859892_1	HG03516	304610	407746	1	612	0	0	611	103136	399158	296022	0-3-7-4-8-5-6-2-4-7-2-6-5-2-1	0.0-3.0-7.0-4.0-8.0-5.0-6.0-2.0-4.1-7.1-2.1-6.1-5.1-2.0-1.0	154	304456	407592
HG03540#1#JAGYVY010000208.1_95187_596142_0	HG03540	98	115434	0	671	0	0	670	115336	115336	0	0-3-7-4-8-5-6-2-4-7-2-5-6-2-4-7-2-6-5-2-1	0.0-3.0-7.0-4.0-8.0-5.0-6.0-2.0-4.1-7.1-2.1-5.0-6.0-2.0-4.1-7.1-2.1-6.1-5.1-2.0-1.0	98	0	115336
HG03540#1#JAGYVY010000208.1_95187_596142_0	HG03540	115525	138360	3	132	0	0	131	22835	138171	115336	0-3-7-4-8-5-6-2-4-7-2-5-6-2-4-7-2-6-5-2-1	0.0-3.0-7.0-4.0-8.0-5.0-6.0-2.0-4.1-7.1-2.1-5.0-6.0-2.0-4.1-7.1-2.1-6.1-5.1-2.0-1.0	98	115427	138262
HG03540#1#JAGYVY010000208.1_95187_596142_0	HG03540	139119	142414	7	17	0	0	16	3295	141466	138171	0-3-7-4-8-5-6-2-4-7-2-5-6-2-4-7-2-6-5-2-1	0.0-3.0-7.0-4.0-8.0-5.0-6.0-2.0-4.1-7.1-2.1-5.0-6.0-2.0-4.1-7.1-2.1-6.1-5.1-2.0-1.0	98	139021	142316
HG03540#1#JAGYVY010000208.1_95187_596142_0	HG03540	142862	161422	4	96	0	0	95	18560	160026	141466	0-3-7-4-8-5-6-2-4-7-2-5-6-2-4-7-2-6-5-2-1	0.0-3.0-7.0-4.0-8.0-5.0-6.0-2.0-4.1-7.1-2.1-5.0-6.0-2.0-4.1-7.1-2.1-6.1-5.1-2.0-1.0	98	142764	161324
HG03540#1#JAGYVY010000208.1_95187_596142_0	HG03540	161366	163136	8	8	0	0	7	1770	161796	160026	0-3-7-4-8-5-6-2-4-7-2-5-6-2-4-7-2-6-5-2-1	0.0-3.0-7.0-4.0-8.0-5.0-6.0-2.0-4.1-7.1-2.1-5.0-6.0-2.0-4.1-7.1-2.1-6.1-5.1-2.0-1.0	98	161268	163038
HG03540#1#JAGYVY010000208.1_95187_596142_0	HG03540	163080	175270	5	78	0	0	74	12190	173986	161796	0-3-7-4-8-5-6-2-4-7-2-5-6-2-4-7-2-6-5-2-1	0.0-3.0-7.0-4.0-8.0-5.0-6.0-2.0-4.1-7.1-2.1-5.0-6.0-2.0-4.1-7.1-2.1-6.1-5.1-2.0-1.0	98	162982	175172
HG03540#1#JAGYVY010000208.1_95187_596142_0	HG03540	176351	179294	6	24	0	1	23	2943	176929	173986	0-3-7-4-8-5-6-2-4-7-2-5-6-2-4-7-2-6-5-2-1	0.0-3.0-7.0-4.0-8.0-5.0-6.0-2.0-4.1-7.1-2.1-5.0-6.0-2.0-4.1-7.1-2.1-6.1-5.1-2.0-1.0	98	176253	179196
HG03540#1#JAGYVY010000208.1_95187_596142_0	HG03540	179238	210462	2	172	0	0	171	31224	208153	176929	0-3-7-4-8-5-6-2-4-7-2-5-6-2-4-7-2-6-5-2-1	0.0-3.0-7.0-4.0-8.0-5.0-6.0-2.0-4.1-7.1-2.1-5.0-6.0-2.0-4.1-7.1-2.1-6.1-5.1-2.0-1.0	98	179140	210364
HG03540#1#JAGYVY010000208.1_95187_596142_0	HG03540	212328	223874	4	96	1	58	4	11546	219699	208153	0-3-7-4-8-5-6-2-4-7-2-5-6-2-4-7-2-6-5-2-1	0.0-3.0-7.0-4.0-8.0-5.0-6.0-2.0-4.1-7.1-2.1-5.0-6.0-2.0-4.1-7.1-2.1-6.1-5.1-2.0-1.0	98	212230	223776
HG03540#1#JAGYVY010000208.1_95187_596142_0	HG03540	224939	228234	7	17	1	16	0	3295	222994	219699	0-3-7-4-8-5-6-2-4-7-2-5-6-2-4-7-2-6-5-2-1	0.0-3.0-7.0-4.0-8.0-5.0-6.0-2.0-4.1-7.1-2.1-5.0-6.0-2.0-4.1-7.1-2.1-6.1-5.1-2.0-1.0	98	224841	228136
HG03540#1#JAGYVY010000208.1_95187_596142_0	HG03540	229311	257232	2	172	1	171	15	27921	250915	222994	0-3-7-4-8-5-6-2-4-7-2-5-6-2-4-7-2-6-5-2-1	0.0-3.0-7.0-4.0-8.0-5.0-6.0-2.0-4.1-7.1-2.1-5.0-6.0-2.0-4.1-7.1-2.1-6.1-5.1-2.0-1.0	98	229213	257134
HG03540#1#JAGYVY010000208.1_95187_596142_0	HG03540	257671	269413	5	78	0	3	74	11742	262657	250915	0-3-7-4-8-5-6-2-4-7-2-5-6-2-4-7-2-6-5-2-1	0.0-3.0-7.0-4.0-8.0-5.0-6.0-2.0-4.1-7.1-2.1-5.0-6.0-2.0-4.1-7.1-2.1-6.1-5.1-2.0-1.0	98	257573	269315
HG03540#1#JAGYVY010000208.1_95187_596142_0	HG03540	270494	273437	6	24	0	1	23	2943	265600	262657	0-3-7-4-8-5-6-2-4-7-2-5-6-2-4-7-2-6-5-2-1	0.0-3.0-7.0-4.0-8.0-5.0-6.0-2.0-4.1-7.1-2.1-5.0-6.0-2.0-4.1-7.1-2.1-6.1-5.1-2.0-1.0	98	270396	273339
HG03540#1#JAGYVY010000208.1_95187_596142_0	HG03540	273381	304599	2	172	0	0	171	31218	296818	265600	0-3-7-4-8-5-6-2-4-7-2-5-6-2-4-7-2-6-5-2-1	0.0-3.0-7.0-4.0-8.0-5.0-6.0-2.0-4.1-7.1-2.1-5.0-6.0-2.0-4.1-7.1-2.1-6.1-5.1-2.0-1.0	98	273283	304501
HG03540#1#JAGYVY010000208.1_95187_596142_0	HG03540	306465	317587	4	96	1	58	6	11122	307940	296818	0-3-7-4-8-5-6-2-4-7-2-5-6-2-4-7-2-6-5-2-1	0.0-3.0-7.0-4.0-8.0-5.0-6.0-2.0-4.1-7.1-2.1-5.0-6.0-2.0-4.1-7.1-2.1-6.1-5.1-2.0-1.0	98	306367	317489
HG03540#1#JAGYVY010000208.1_95187_596142_0	HG03540	319074	322369	7	17	1	16	0	3295	311235	307940	0-3-7-4-8-5-6-2-4-7-2-5-6-2-4-7-2-6-5-2-1	0.0-3.0-7.0-4.0-8.0-5.0-6.0-2.0-4.1-7.1-2.1-5.0-6.0-2.0-4.1-7.1-2.1-6.1-5.1-2.0-1.0	98	318976	322271
HG03540#1#JAGYVY010000208.1_95187_596142_0	HG03540	323831	354669	2	172	1	170	0	30838	342073	311235	0-3-7-4-8-5-6-2-4-7-2-5-6-2-4-7-2-6-5-2-1	0.0-3.0-7.0-4.0-8.0-5.0-6.0-2.0-4.1-7.1-2.1-5.0-6.0-2.0-4.1-7.1-2.1-6.1-5.1-2.0-1.0	98	323733	354571
HG03540#1#JAGYVY010000208.1_95187_596142_0	HG03540	354613	357556	6	24	1	23	1	2943	345016	342073	0-3-7-4-8-5-6-2-4-7-2-5-6-2-4-7-2-6-5-2-1	0.0-3.0-7.0-4.0-8.0-5.0-6.0-2.0-4.1-7.1-2.1-5.0-6.0-2.0-4.1-7.1-2.1-6.1-5.1-2.0-1.0	98	354515	357458
HG03540#1#JAGYVY010000208.1_95187_596142_0	HG03540	358637	370377	5	78	1	74	3	11740	356756	345016	0-3-7-4-8-5-6-2-4-7-2-5-6-2-4-7-2-6-5-2-1	0.0-3.0-7.0-4.0-8.0-5.0-6.0-2.0-4.1-7.1-2.1-5.0-6.0-2.0-4.1-7.1-2.1-6.1-5.1-2.0-1.0	98	358539	370279
HG03540#1#JAGYVY010000208.1_95187_596142_0	HG03540	370816	398725	2	172	0	15	171	27909	384665	356756	0-3-7-4-8-5-6-2-4-7-2-5-6-2-4-7-2-6-5-2-1	0.0-3.0-7.0-4.0-8.0-5.0-6.0-2.0-4.1-7.1-2.1-5.0-6.0-2.0-4.1-7.1-2.1-6.1-5.1-2.0-1.0	98	370718	398627
HG03540#1#JAGYVY010000208.1_95187_596142_0	HG03540	398669	501011	1	612	0	0	606	102342	487007	384665	0-3-7-4-8-5-6-2-4-7-2-5-6-2-4-7-2-6-5-2-1	0.0-3.0-7.0-4.0-8.0-5.0-6.0-2.0-4.1-7.1-2.1-5.0-6.0-2.0-4.1-7.1-2.1-6.1-5.1-2.0-1.0	98	398571	500913
HG03540#2#JAGYVX010000148.1_1368955_1877115_0	HG03540	98	115513	0	671	0	0	670	115415	115415	0	0-3-7-4-8-5-6-2-4-4-2-5-6-2-4-4-2-6-5-2-1	0.0-3.0-7.0-4.0-8.0-5.0-6.0-2.0-4.1-4.0-2.1-5.0-6.0-2.0-4.1-4.0-2.1-6.1-5.1-2.0-1.0	98	0	115415
HG03540#2#JAGYVX010000148.1_1368955_1877115_0	HG03540	115604	138437	3	132	0	0	131	22833	138248	115415	0-3-7-4-8-5-6-2-4-4-2-5-6-2-4-4-2-6-5-2-1	0.0-3.0-7.0-4.0-8.0-5.0-6.0-2.0-4.1-4.0-2.1-5.0-6.0-2.0-4.1-4.0-2.1-6.1-5.1-2.0-1.0	98	115506	138339
HG03540#2#JAGYVX010000148.1_1368955_1877115_0	HG03540	139196	142491	7	17	0	0	16	3295	141543	138248	0-3-7-4-8-5-6-2-4-4-2-5-6-2-4-4-2-6-5-2-1	0.0-3.0-7.0-4.0-8.0-5.0-6.0-2.0-4.1-4.0-2.1-5.0-6.0-2.0-4.1-4.0-2.1-6.1-5.1-2.0-1.0	98	139098	142393
HG03540#2#JAGYVX010000148.1_1368955_1877115_0	HG03540	142939	161848	4	96	0	0	95	18909	160452	141543	0-3-7-4-8-5-6-2-4-4-2-5-6-2-4-4-2-6-5-2-1	0.0-3.0-7.0-4.0-8.0-5.0-6.0-2.0-4.1-4.0-2.1-5.0-6.0-2.0-4.1-4.0-2.1-6.1-5.1-2.0-1.0	98	142841	161750
HG03540#2#JAGYVX010000148.1_1368955_1877115_0	HG03540	161792	163562	8	8	0	0	7	1770	162222	160452	0-3-7-4-8-5-6-2-4-4-2-5-6-2-4-4-2-6-5-2-1	0.0-3.0-7.0-4.0-8.0-5.0-6.0-2.0-4.1-4.0-2.1-5.0-6.0-2.0-4.1-4.0-2.1-6.1-5.1-2.0-1.0	98	161694	163464
HG03540#2#JAGYVX010000148.1_1368955_1877115_0	HG03540	163506	176610	5	78	0	0	77	13104	175326	162222	0-3-7-4-8-5-6-2-4-4-2-5-6-2-4-4-2-6-5-2-1	0.0-3.0-7.0-4.0-8.0-5.0-6.0-2.0-4.1-4.0-2.1-5.0-6.0-2.0-4.1-4.0-2.1-6.1-5.1-2.0-1.0	98	163408	176512
HG03540#2#JAGYVX010000148.1_1368955_1877115_0	HG03540	176554	179714	6	24	0	0	23	3160	178486	175326	0-3-7-4-8-5-6-2-4-4-2-5-6-2-4-4-2-6-5-2-1	0.0-3.0-7.0-4.0-8.0-5.0-6.0-2.0-4.1-4.0-2.1-5.0-6.0-2.0-4.1-4.0-2.1-6.1-5.1-2.0-1.0	98	176456	179616
HG03540#2#JAGYVX010000148.1_1368955_1877115_0	HG03540	179658	210882	2	172	0	0	171	31224	209710	178486	0-3-7-4-8-5-6-2-4-4-2-5-6-2-4-4-2-6-5-2-1	0.0-3.0-7.0-4.0-8.0-5.0-6.0-2.0-4.1-4.0-2.1-5.0-6.0-2.0-4.1-4.0-2.1-6.1-5.1-2.0-1.0	98	179560	210784
HG03540#2#JAGYVX010000148.1_1368955_1877115_0	HG03540	213199	221968	4	96	1	56	20	8769	218479	209710	0-3-7-4-8-5-6-2-4-4-2-5-6-2-4-4-2-6-5-2-1	0.0-3.0-7.0-4.0-8.0-5.0-6.0-2.0-4.1-4.0-2.1-5.0-6.0-2.0-4.1-4.0-2.1-6.1-5.1-2.0-1.0	98	213101	221870
HG03540#2#JAGYVX010000148.1_1368955_1877115_0	HG03540	222276	230756	4	96	0	22	58	8480	226959	218479	0-3-7-4-8-5-6-2-4-4-2-5-6-2-4-4-2-6-5-2-1	0.0-3.0-7.0-4.0-8.0-5.0-6.0-2.0-4.1-4.0-2.1-5.0-6.0-2.0-4.1-4.0-2.1-6.1-5.1-2.0-1.0	98	222178	230658
HG03540#2#JAGYVX010000148.1_1368955_1877115_0	HG03540	232622	260526	2	172	1	171	15	27904	254863	226959	0-3-7-4-8-5-6-2-4-4-2-5-6-2-4-4-2-6-5-2-1	0.0-3.0-7.0-4.0-8.0-5.0-6.0-2.0-4.1-4.0-2.1-5.0-6.0-2.0-4.1-4.0-2.1-6.1-5.1-2.0-1.0	98	232524	260428
HG03540#2#JAGYVX010000148.1_1368955_1877115_0	HG03540	260965	273620	5	78	0	3	77	12655	267518	254863	0-3-7-4-8-5-6-2-4-4-2-5-6-2-4-4-2-6-5-2-1	0.0-3.0-7.0-4.0-8.0-5.0-6.0-2.0-4.1-4.0-2.1-5.0-6.0-2.0-4.1-4.0-2.1-6.1-5.1-2.0-1.0	98	260867	273522
HG03540#2#JAGYVX010000148.1_1368955_1877115_0	HG03540	273564	276724	6	24	0	0	23	3160	270678	267518	0-3-7-4-8-5-6-2-4-4-2-5-6-2-4-4-2-6-5-2-1	0.0-3.0-7.0-4.0-8.0-5.0-6.0-2.0-4.1-4.0-2.1-5.0-6.0-2.0-4.1-4.0-2.1-6.1-5.1-2.0-1.0	98	273466	276626
HG03540#2#JAGYVX010000148.1_1368955_1877115_0	HG03540	276668	307471	2	172	0	0	169	30803	301481	270678	0-3-7-4-8-5-6-2-4-4-2-5-6-2-4-4-2-6-5-2-1	0.0-3.0-7.0-4.0-8.0-5.0-6.0-2.0-4.1-4.0-2.1-5.0-6.0-2.0-4.1-4.0-2.1-6.1-5.1-2.0-1.0	98	276570	307373
HG03540#2#JAGYVX010000148.1_1368955_1877115_0	HG03540	309761	318238	4	96	1	58	22	8477	309958	301481	0-3-7-4-8-5-6-2-4-4-2-5-6-2-4-4-2-6-5-2-1	0.0-3.0-7.0-4.0-8.0-5.0-6.0-2.0-4.1-4.0-2.1-5.0-6.0-2.0-4.1-4.0-2.1-6.1-5.1-2.0-1.0	98	309663	318140
HG03540#2#JAGYVX010000148.1_1368955_1877115_0	HG03540	318546	327775	4	96	0	20	58	9229	319187	309958	0-3-7-4-8-5-6-2-4-4-2-5-6-2-4-4-2-6-5-2-1	0.0-3.0-7.0-4.0-8.0-5.0-6.0-2.0-4.1-4.0-2.1-5.0-6.0-2.0-4.1-4.0-2.1-6.1-5.1-2.0-1.0	98	318448	327677
HG03540#2#JAGYVX010000148.1_1368955_1877115_0	HG03540	329641	360856	2	172	1	171	0	31215	350402	319187	0-3-7-4-8-5-6-2-4-4-2-5-6-2-4-4-2-6-5-2-1	0.0-3.0-7.0-4.0-8.0-5.0-6.0-2.0-4.1-4.0-2.1-5.0-6.0-2.0-4.1-4.0-2.1-6.1-5.1-2.0-1.0	98	329543	360758
HG03540#2#JAGYVX010000148.1_1368955_1877115_0	HG03540	361217	363961	6	24	1	21	0	2744	353146	350402	0-3-7-4-8-5-6-2-4-4-2-5-6-2-4-4-2-6-5-2-1	0.0-3.0-7.0-4.0-8.0-5.0-6.0-2.0-4.1-4.0-2.1-5.0-6.0-2.0-4.1-4.0-2.1-6.1-5.1-2.0-1.0	98	361119	363863
HG03540#2#JAGYVX010000148.1_1368955_1877115_0	HG03540	363905	376560	5	78	1	77	3	12655	365801	353146	0-3-7-4-8-5-6-2-4-4-2-5-6-2-4-4-2-6-5-2-1	0.0-3.0-7.0-4.0-8.0-5.0-6.0-2.0-4.1-4.0-2.1-5.0-6.0-2.0-4.1-4.0-2.1-6.1-5.1-2.0-1.0	98	363807	376462
HG03540#2#JAGYVX010000148.1_1368955_1877115_0	HG03540	376999	404924	2	172	0	15	171	27925	393726	365801	0-3-7-4-8-5-6-2-4-4-2-5-6-2-4-4-2-6-5-2-1	0.0-3.0-7.0-4.0-8.0-5.0-6.0-2.0-4.1-4.0-2.1-5.0-6.0-2.0-4.1-4.0-2.1-6.1-5.1-2.0-1.0	98	376901	404826
HG03540#2#JAGYVX010000148.1_1368955_1877115_0	HG03540	404868	508088	1	612	0	0	611	103220	496946	393726	0-3-7-4-8-5-6-2-4-4-2-5-6-2-4-4-2-6-5-2-1	0.0-3.0-7.0-4.0-8.0-5.0-6.0-2.0-4.1-4.0-2.1-5.0-6.0-2.0-4.1-4.0-2.1-6.1-5.1-2.0-1.0	98	404770	507990
HG03579#1#JAGYVU010000029.1_91404_499180_0	HG03579	98	115483	0	671	0	0	670	115385	115385	0	0-3-7-4-8-5-6-2-7-4-2-6-5-2-1	0.0-3.0-7.0-4.0-8.0-5.0-6.0-2.0-7.0-4.0-2.1-6.1-5.1-2.0-1.0	98	0	115385
HG03579#1#JAGYVU010000029.1_91404_499180_0	HG03579	115574	138407	3	132	0	0	131	22833	138218	115385	0-3-7-4-8-5-6-2-7-4-2-6-5-2-1	0.0-3.0-7.0-4.0-8.0-5.0-6.0-2.0-7.0-4.0-2.1-6.1-5.1-2.0-1.0	98	115476	138309
HG03579#1#JAGYVU010000029.1_91404_499180_0	HG03579	139166	142461	7	17	0	0	16	3295	141513	138218	0-3-7-4-8-5-6-2-7-4-2-6-5-2-1	0.0-3.0-7.0-4.0-8.0-5.0-6.0-2.0-7.0-4.0-2.1-6.1-5.1-2.0-1.0	98	139068	142363
HG03579#1#JAGYVU010000029.1_91404_499180_0	HG03579	142909	161467	4	96	0	0	95	18558	160071	141513	0-3-7-4-8-5-6-2-7-4-2-6-5-2-1	0.0-3.0-7.0-4.0-8.0-5.0-6.0-2.0-7.0-4.0-2.1-6.1-5.1-2.0-1.0	98	142811	161369
HG03579#1#JAGYVU010000029.1_91404_499180_0	HG03579	161411	163181	8	8	0	0	7	1770	161841	160071	0-3-7-4-8-5-6-2-7-4-2-6-5-2-1	0.0-3.0-7.0-4.0-8.0-5.0-6.0-2.0-7.0-4.0-2.1-6.1-5.1-2.0-1.0	98	161313	163083
HG03579#1#JAGYVU010000029.1_91404_499180_0	HG03579	163125	175315	5	78	0	0	74	12190	174031	161841	0-3-7-4-8-5-6-2-7-4-2-6-5-2-1	0.0-3.0-7.0-4.0-8.0-5.0-6.0-2.0-7.0-4.0-2.1-6.1-5.1-2.0-1.0	98	163027	175217
HG03579#1#JAGYVU010000029.1_91404_499180_0	HG03579	176396	179339	6	24	0	1	23	2943	176974	174031	0-3-7-4-8-5-6-2-7-4-2-6-5-2-1	0.0-3.0-7.0-4.0-8.0-5.0-6.0-2.0-7.0-4.0-2.1-6.1-5.1-2.0-1.0	98	176298	179241
HG03579#1#JAGYVU010000029.1_91404_499180_0	HG03579	179283	210115	2	172	0	0	170	30832	207806	176974	0-3-7-4-8-5-6-2-7-4-2-6-5-2-1	0.0-3.0-7.0-4.0-8.0-5.0-6.0-2.0-7.0-4.0-2.1-6.1-5.1-2.0-1.0	98	179185	210017
HG03579#1#JAGYVU010000029.1_91404_499180_0	HG03579	211577	214872	7	17	0	0	16	3295	211101	207806	0-3-7-4-8-5-6-2-7-4-2-6-5-2-1	0.0-3.0-7.0-4.0-8.0-5.0-6.0-2.0-7.0-4.0-2.1-6.1-5.1-2.0-1.0	98	211479	214774
HG03579#1#JAGYVU010000029.1_91404_499180_0	HG03579	216359	227482	4	96	0	6	58	11123	222224	211101	0-3-7-4-8-5-6-2-7-4-2-6-5-2-1	0.0-3.0-7.0-4.0-8.0-5.0-6.0-2.0-7.0-4.0-2.1-6.1-5.1-2.0-1.0	98	216261	227384
HG03579#1#JAGYVU010000029.1_91404_499180_0	HG03579	229348	260571	2	172	1	171	0	31223	253447	222224	0-3-7-4-8-5-6-2-7-4-2-6-5-2-1	0.0-3.0-7.0-4.0-8.0-5.0-6.0-2.0-7.0-4.0-2.1-6.1-5.1-2.0-1.0	98	229250	260473
HG03579#1#JAGYVU010000029.1_91404_499180_0	HG03579	260515	263458	6	24	1	23	1	2943	256390	253447	0-3-7-4-8-5-6-2-7-4-2-6-5-2-1	0.0-3.0-7.0-4.0-8.0-5.0-6.0-2.0-7.0-4.0-2.1-6.1-5.1-2.0-1.0	98	260417	263360
HG03579#1#JAGYVU010000029.1_91404_499180_0	HG03579	264539	276281	5	78	1	74	3	11742	268132	256390	0-3-7-4-8-5-6-2-7-4-2-6-5-2-1	0.0-3.0-7.0-4.0-8.0-5.0-6.0-2.0-7.0-4.0-2.1-6.1-5.1-2.0-1.0	98	264441	276183
HG03579#1#JAGYVU010000029.1_91404_499180_0	HG03579	276720	304631	2	172	0	15	171	27911	296043	268132	0-3-7-4-8-5-6-2-7-4-2-6-5-2-1	0.0-3.0-7.0-4.0-8.0-5.0-6.0-2.0-7.0-4.0-2.1-6.1-5.1-2.0-1.0	98	276622	304533
HG03579#1#JAGYVU010000029.1_91404_499180_0	HG03579	304575	407704	1	612	0	0	611	103129	399172	296043	0-3-7-4-8-5-6-2-7-4-2-6-5-2-1	0.0-3.0-7.0-4.0-8.0-5.0-6.0-2.0-7.0-4.0-2.1-6.1-5.1-2.0-1.0	98	304477	407606
HG03579#2#JAGYVT010000094.1_51581892_51895531_0	HG03579	98	115428	0	671	0	0	670	115330	115330	0	0-3-7-4-8-5-6-2-1	0.0-3.0-7.0-4.0-8.0-5.0-6.0-2.0-1.0	98	0	115330
HG03579#2#JAGYVT010000094.1_51581892_51895531_0	HG03579	115519	138349	3	132	0	0	131	22830	138160	115330	0-3-7-4-8-5-6-2-1	0.0-3.0-7.0-4.0-8.0-5.0-6.0-2.0-1.0	98	115421	138251
HG03579#2#JAGYVT010000094.1_51581892_51895531_0	HG03579	139108	142403	7	17	0	0	16	3295	141455	138160	0-3-7-4-8-5-6-2-1	0.0-3.0-7.0-4.0-8.0-5.0-6.0-2.0-1.0	98	139010	142305
HG03579#2#JAGYVT010000094.1_51581892_51895531_0	HG03579	142851	161412	4	96	0	0	95	18561	160016	141455	0-3-7-4-8-5-6-2-1	0.0-3.0-7.0-4.0-8.0-5.0-6.0-2.0-1.0	98	142753	161314
HG03579#2#JAGYVT010000094.1_51581892_51895531_0	HG03579	161356	163126	8	8	0	0	7	1770	161786	160016	0-3-7-4-8-5-6-2-1	0.0-3.0-7.0-4.0-8.0-5.0-6.0-2.0-1.0	98	161258	163028
HG03579#2#JAGYVT010000094.1_51581892_51895531_0	HG03579	163070	175734	5	78	0	0	76	12664	174450	161786	0-3-7-4-8-5-6-2-1	0.0-3.0-7.0-4.0-8.0-5.0-6.0-2.0-1.0	98	162972	175636
HG03579#2#JAGYVT010000094.1_51581892_51895531_0	HG03579	176341	179284	6	24	0	1	23	2943	177393	174450	0-3-7-4-8-5-6-2-1	0.0-3.0-7.0-4.0-8.0-5.0-6.0-2.0-1.0	98	176243	179186
HG03579#2#JAGYVT010000094.1_51581892_51895531_0	HG03579	179228	210443	2	172	0	0	171	31215	208608	177393	0-3-7-4-8-5-6-2-1	0.0-3.0-7.0-4.0-8.0-5.0-6.0-2.0-1.0	98	179130	210345
HG03579#2#JAGYVT010000094.1_51581892_51895531_0	HG03579	210387	313567	1	612	0	0	611	103180	311788	208608	0-3-7-4-8-5-6-2-1	0.0-3.0-7.0-4.0-8.0-5.0-6.0-2.0-1.0	98	210289	313469
HG03710.verkko_filt_mat.fa:haplotype1-0000029_102593394_102907063_0	HG03710	98	115428	0	671	0	0	670	115330	115330	0	0-3-7-4-8-5-6-2-1	0.0-3.0-7.0-4.0-8.0-5.0-6.0-2.0-1.0	98	0	115330
HG03710.verkko_filt_mat.fa:haplotype1-0000029_102593394_102907063_0	HG03710	115519	138352	3	132	0	0	131	22833	138163	115330	0-3-7-4-8-5-6-2-1	0.0-3.0-7.0-4.0-8.0-5.0-6.0-2.0-1.0	98	115421	138254
HG03710.verkko_filt_mat.fa:haplotype1-0000029_102593394_102907063_0	HG03710	139111	142406	7	17	0	0	16	3295	141458	138163	0-3-7-4-8-5-6-2-1	0.0-3.0-7.0-4.0-8.0-5.0-6.0-2.0-1.0	98	139013	142308
HG03710.verkko_filt_mat.fa:haplotype1-0000029_102593394_102907063_0	HG03710	142854	161417	4	96	0	0	95	18563	160021	141458	0-3-7-4-8-5-6-2-1	0.0-3.0-7.0-4.0-8.0-5.0-6.0-2.0-1.0	98	142756	161319
HG03710.verkko_filt_mat.fa:haplotype1-0000029_102593394_102907063_0	HG03710	161361	163131	8	8	0	0	7	1770	161791	160021	0-3-7-4-8-5-6-2-1	0.0-3.0-7.0-4.0-8.0-5.0-6.0-2.0-1.0	98	161263	163033
HG03710.verkko_filt_mat.fa:haplotype1-0000029_102593394_102907063_0	HG03710	163075	175739	5	78	0	0	76	12664	174455	161791	0-3-7-4-8-5-6-2-1	0.0-3.0-7.0-4.0-8.0-5.0-6.0-2.0-1.0	98	162977	175641
HG03710.verkko_filt_mat.fa:haplotype1-0000029_102593394_102907063_0	HG03710	176123	178867	6	24	0	0	21	2744	177199	174455	0-3-7-4-8-5-6-2-1	0.0-3.0-7.0-4.0-8.0-5.0-6.0-2.0-1.0	98	176025	178769
HG03710.verkko_filt_mat.fa:haplotype1-0000029_102593394_102907063_0	HG03710	179226	210445	2	172	0	0	171	31219	208418	177199	0-3-7-4-8-5-6-2-1	0.0-3.0-7.0-4.0-8.0-5.0-6.0-2.0-1.0	98	179128	210347
HG03710.verkko_filt_mat.fa:haplotype1-0000029_102593394_102907063_0	HG03710	210389	313597	1	612	0	0	611	103208	311626	208418	0-3-7-4-8-5-6-2-1	0.0-3.0-7.0-4.0-8.0-5.0-6.0-2.0-1.0	98	210291	313499
HG03710.verkko_filt_pat.fa:haplotype2-0000488_101614437_102218208_0	HG03710	98	115400	0	671	0	0	670	115302	115302	0	0-3-7-4-8-5-6-2-4-4-2-5-6-2-4-4-2-6-5-2-4-4-2-5-6-2-1	0.0-3.0-7.0-4.0-8.0-5.0-6.0-2.0-4.1-4.0-2.1-5.0-6.0-2.0-4.1-4.0-2.1-6.1-5.1-2.0-4.1-4.0-2.1-5.0-6.0-2.0-1.0	98	0	115302
HG03710.verkko_filt_pat.fa:haplotype2-0000488_101614437_102218208_0	HG03710	115491	138325	3	132	0	0	131	22834	138136	115302	0-3-7-4-8-5-6-2-4-4-2-5-6-2-4-4-2-6-5-2-4-4-2-5-6-2-1	0.0-3.0-7.0-4.0-8.0-5.0-6.0-2.0-4.1-4.0-2.1-5.0-6.0-2.0-4.1-4.0-2.1-6.1-5.1-2.0-4.1-4.0-2.1-5.0-6.0-2.0-1.0	98	115393	138227
HG03710.verkko_filt_pat.fa:haplotype2-0000488_101614437_102218208_0	HG03710	139084	142379	7	17	0	0	16	3295	141431	138136	0-3-7-4-8-5-6-2-4-4-2-5-6-2-4-4-2-6-5-2-4-4-2-5-6-2-1	0.0-3.0-7.0-4.0-8.0-5.0-6.0-2.0-4.1-4.0-2.1-5.0-6.0-2.0-4.1-4.0-2.1-6.1-5.1-2.0-4.1-4.0-2.1-5.0-6.0-2.0-1.0	98	138986	142281
HG03710.verkko_filt_pat.fa:haplotype2-0000488_101614437_102218208_0	HG03710	142827	161396	4	96	0	0	95	18569	160000	141431	0-3-7-4-8-5-6-2-4-4-2-5-6-2-4-4-2-6-5-2-4-4-2-5-6-2-1	0.0-3.0-7.0-4.0-8.0-5.0-6.0-2.0-4.1-4.0-2.1-5.0-6.0-2.0-4.1-4.0-2.1-6.1-5.1-2.0-4.1-4.0-2.1-5.0-6.0-2.0-1.0	98	142729	161298
HG03710.verkko_filt_pat.fa:haplotype2-0000488_101614437_102218208_0	HG03710	161340	163110	8	8	0	0	7	1770	161770	160000	0-3-7-4-8-5-6-2-4-4-2-5-6-2-4-4-2-6-5-2-4-4-2-5-6-2-1	0.0-3.0-7.0-4.0-8.0-5.0-6.0-2.0-4.1-4.0-2.1-5.0-6.0-2.0-4.1-4.0-2.1-6.1-5.1-2.0-4.1-4.0-2.1-5.0-6.0-2.0-1.0	98	161242	163012
HG03710.verkko_filt_pat.fa:haplotype2-0000488_101614437_102218208_0	HG03710	163054	176158	5	78	0	0	77	13104	174874	161770	0-3-7-4-8-5-6-2-4-4-2-5-6-2-4-4-2-6-5-2-4-4-2-5-6-2-1	0.0-3.0-7.0-4.0-8.0-5.0-6.0-2.0-4.1-4.0-2.1-5.0-6.0-2.0-4.1-4.0-2.1-6.1-5.1-2.0-4.1-4.0-2.1-5.0-6.0-2.0-1.0	98	162956	176060
HG03710.verkko_filt_pat.fa:haplotype2-0000488_101614437_102218208_0	HG03710	176102	179262	6	24	0	0	23	3160	178034	174874	0-3-7-4-8-5-6-2-4-4-2-5-6-2-4-4-2-6-5-2-4-4-2-5-6-2-1	0.0-3.0-7.0-4.0-8.0-5.0-6.0-2.0-4.1-4.0-2.1-5.0-6.0-2.0-4.1-4.0-2.1-6.1-5.1-2.0-4.1-4.0-2.1-5.0-6.0-2.0-1.0	98	176004	179164
HG03710.verkko_filt_pat.fa:haplotype2-0000488_101614437_102218208_0	HG03710	179206	210430	2	172	0	0	171	31224	209258	178034	0-3-7-4-8-5-6-2-4-4-2-5-6-2-4-4-2-6-5-2-4-4-2-5-6-2-1	0.0-3.0-7.0-4.0-8.0-5.0-6.0-2.0-4.1-4.0-2.1-5.0-6.0-2.0-4.1-4.0-2.1-6.1-5.1-2.0-4.1-4.0-2.1-5.0-6.0-2.0-1.0	98	179108	210332
HG03710.verkko_filt_pat.fa:haplotype2-0000488_101614437_102218208_0	HG03710	212747	221525	4	96	1	56	20	8778	218036	209258	0-3-7-4-8-5-6-2-4-4-2-5-6-2-4-4-2-6-5-2-4-4-2-5-6-2-1	0.0-3.0-7.0-4.0-8.0-5.0-6.0-2.0-4.1-4.0-2.1-5.0-6.0-2.0-4.1-4.0-2.1-6.1-5.1-2.0-4.1-4.0-2.1-5.0-6.0-2.0-1.0	98	212649	221427
HG03710.verkko_filt_pat.fa:haplotype2-0000488_101614437_102218208_0	HG03710	221833	230312	4	96	0	22	58	8479	226515	218036	0-3-7-4-8-5-6-2-4-4-2-5-6-2-4-4-2-6-5-2-4-4-2-5-6-2-1	0.0-3.0-7.0-4.0-8.0-5.0-6.0-2.0-4.1-4.0-2.1-5.0-6.0-2.0-4.1-4.0-2.1-6.1-5.1-2.0-4.1-4.0-2.1-5.0-6.0-2.0-1.0	98	221735	230214
HG03710.verkko_filt_pat.fa:haplotype2-0000488_101614437_102218208_0	HG03710	232178	260083	2	172	1	171	15	27905	254420	226515	0-3-7-4-8-5-6-2-4-4-2-5-6-2-4-4-2-6-5-2-4-4-2-5-6-2-1	0.0-3.0-7.0-4.0-8.0-5.0-6.0-2.0-4.1-4.0-2.1-5.0-6.0-2.0-4.1-4.0-2.1-6.1-5.1-2.0-4.1-4.0-2.1-5.0-6.0-2.0-1.0	98	232080	259985
HG03710.verkko_filt_pat.fa:haplotype2-0000488_101614437_102218208_0	HG03710	260522	272737	5	78	0	3	76	12215	266635	254420	0-3-7-4-8-5-6-2-4-4-2-5-6-2-4-4-2-6-5-2-4-4-2-5-6-2-1	0.0-3.0-7.0-4.0-8.0-5.0-6.0-2.0-4.1-4.0-2.1-5.0-6.0-2.0-4.1-4.0-2.1-6.1-5.1-2.0-4.1-4.0-2.1-5.0-6.0-2.0-1.0	98	260424	272639
HG03710.verkko_filt_pat.fa:haplotype2-0000488_101614437_102218208_0	HG03710	273344	276287	6	24	0	1	23	2943	269578	266635	0-3-7-4-8-5-6-2-4-4-2-5-6-2-4-4-2-6-5-2-4-4-2-5-6-2-1	0.0-3.0-7.0-4.0-8.0-5.0-6.0-2.0-4.1-4.0-2.1-5.0-6.0-2.0-4.1-4.0-2.1-6.1-5.1-2.0-4.1-4.0-2.1-5.0-6.0-2.0-1.0	98	273246	276189
HG03710.verkko_filt_pat.fa:haplotype2-0000488_101614437_102218208_0	HG03710	276231	307459	2	172	0	0	171	31228	300806	269578	0-3-7-4-8-5-6-2-4-4-2-5-6-2-4-4-2-6-5-2-4-4-2-5-6-2-1	0.0-3.0-7.0-4.0-8.0-5.0-6.0-2.0-4.1-4.0-2.1-5.0-6.0-2.0-4.1-4.0-2.1-6.1-5.1-2.0-4.1-4.0-2.1-5.0-6.0-2.0-1.0	98	276133	307361
HG03710.verkko_filt_pat.fa:haplotype2-0000488_101614437_102218208_0	HG03710	309776	318556	4	96	1	56	20	8780	309586	300806	0-3-7-4-8-5-6-2-4-4-2-5-6-2-4-4-2-6-5-2-4-4-2-5-6-2-1	0.0-3.0-7.0-4.0-8.0-5.0-6.0-2.0-4.1-4.0-2.1-5.0-6.0-2.0-4.1-4.0-2.1-6.1-5.1-2.0-4.1-4.0-2.1-5.0-6.0-2.0-1.0	98	309678	318458
HG03710.verkko_filt_pat.fa:haplotype2-0000488_101614437_102218208_0	HG03710	318864	326891	4	96	0	22	56	8027	317613	309586	0-3-7-4-8-5-6-2-4-4-2-5-6-2-4-4-2-6-5-2-4-4-2-5-6-2-1	0.0-3.0-7.0-4.0-8.0-5.0-6.0-2.0-4.1-4.0-2.1-5.0-6.0-2.0-4.1-4.0-2.1-6.1-5.1-2.0-4.1-4.0-2.1-5.0-6.0-2.0-1.0	98	318766	326793
HG03710.verkko_filt_pat.fa:haplotype2-0000488_101614437_102218208_0	HG03710	329208	360427	2	172	1	171	0	31219	348832	317613	0-3-7-4-8-5-6-2-4-4-2-5-6-2-4-4-2-6-5-2-4-4-2-5-6-2-1	0.0-3.0-7.0-4.0-8.0-5.0-6.0-2.0-4.1-4.0-2.1-5.0-6.0-2.0-4.1-4.0-2.1-6.1-5.1-2.0-4.1-4.0-2.1-5.0-6.0-2.0-1.0	98	329110	360329
HG03710.verkko_filt_pat.fa:haplotype2-0000488_101614437_102218208_0	HG03710	360371	363314	6	24	1	23	1	2943	351775	348832	0-3-7-4-8-5-6-2-4-4-2-5-6-2-4-4-2-6-5-2-4-4-2-5-6-2-1	0.0-3.0-7.0-4.0-8.0-5.0-6.0-2.0-4.1-4.0-2.1-5.0-6.0-2.0-4.1-4.0-2.1-6.1-5.1-2.0-4.1-4.0-2.1-5.0-6.0-2.0-1.0	98	360273	363216
HG03710.verkko_filt_pat.fa:haplotype2-0000488_101614437_102218208_0	HG03710	364395	376136	5	78	1	74	3	11741	363516	351775	0-3-7-4-8-5-6-2-4-4-2-5-6-2-4-4-2-6-5-2-4-4-2-5-6-2-1	0.0-3.0-7.0-4.0-8.0-5.0-6.0-2.0-4.1-4.0-2.1-5.0-6.0-2.0-4.1-4.0-2.1-6.1-5.1-2.0-4.1-4.0-2.1-5.0-6.0-2.0-1.0	98	364297	376038
HG03710.verkko_filt_pat.fa:haplotype2-0000488_101614437_102218208_0	HG03710	376575	404496	2	172	0	15	171	27921	391437	363516	0-3-7-4-8-5-6-2-4-4-2-5-6-2-4-4-2-6-5-2-4-4-2-5-6-2-1	0.0-3.0-7.0-4.0-8.0-5.0-6.0-2.0-4.1-4.0-2.1-5.0-6.0-2.0-4.1-4.0-2.1-6.1-5.1-2.0-4.1-4.0-2.1-5.0-6.0-2.0-1.0	98	376477	404398
HG03710.verkko_filt_pat.fa:haplotype2-0000488_101614437_102218208_0	HG03710	406362	414839	4	96	1	58	22	8477	399914	391437	0-3-7-4-8-5-6-2-4-4-2-5-6-2-4-4-2-6-5-2-4-4-2-5-6-2-1	0.0-3.0-7.0-4.0-8.0-5.0-6.0-2.0-4.1-4.0-2.1-5.0-6.0-2.0-4.1-4.0-2.1-6.1-5.1-2.0-4.1-4.0-2.1-5.0-6.0-2.0-1.0	98	406264	414741
HG03710.verkko_filt_pat.fa:haplotype2-0000488_101614437_102218208_0	HG03710	415147	424375	4	96	0	20	58	9228	409142	399914	0-3-7-4-8-5-6-2-4-4-2-5-6-2-4-4-2-6-5-2-4-4-2-5-6-2-1	0.0-3.0-7.0-4.0-8.0-5.0-6.0-2.0-4.1-4.0-2.1-5.0-6.0-2.0-4.1-4.0-2.1-6.1-5.1-2.0-4.1-4.0-2.1-5.0-6.0-2.0-1.0	98	415049	424277
HG03710.verkko_filt_pat.fa:haplotype2-0000488_101614437_102218208_0	HG03710	426241	454164	2	172	1	171	15	27923	437065	409142	0-3-7-4-8-5-6-2-4-4-2-5-6-2-4-4-2-6-5-2-4-4-2-5-6-2-1	0.0-3.0-7.0-4.0-8.0-5.0-6.0-2.0-4.1-4.0-2.1-5.0-6.0-2.0-4.1-4.0-2.1-6.1-5.1-2.0-4.1-4.0-2.1-5.0-6.0-2.0-1.0	98	426143	454066
HG03710.verkko_filt_pat.fa:haplotype2-0000488_101614437_102218208_0	HG03710	454603	466344	5	78	0	3	74	11741	448806	437065	0-3-7-4-8-5-6-2-4-4-2-5-6-2-4-4-2-6-5-2-4-4-2-5-6-2-1	0.0-3.0-7.0-4.0-8.0-5.0-6.0-2.0-4.1-4.0-2.1-5.0-6.0-2.0-4.1-4.0-2.1-6.1-5.1-2.0-4.1-4.0-2.1-5.0-6.0-2.0-1.0	98	454505	466246
HG03710.verkko_filt_pat.fa:haplotype2-0000488_101614437_102218208_0	HG03710	467425	470368	6	24	0	1	23	2943	451749	448806	0-3-7-4-8-5-6-2-4-4-2-5-6-2-4-4-2-6-5-2-4-4-2-5-6-2-1	0.0-3.0-7.0-4.0-8.0-5.0-6.0-2.0-4.1-4.0-2.1-5.0-6.0-2.0-4.1-4.0-2.1-6.1-5.1-2.0-4.1-4.0-2.1-5.0-6.0-2.0-1.0	98	467327	470270
HG03710.verkko_filt_pat.fa:haplotype2-0000488_101614437_102218208_0	HG03710	470312	501522	2	172	0	0	171	31210	482959	451749	0-3-7-4-8-5-6-2-4-4-2-5-6-2-4-4-2-6-5-2-4-4-2-5-6-2-1	0.0-3.0-7.0-4.0-8.0-5.0-6.0-2.0-4.1-4.0-2.1-5.0-6.0-2.0-4.1-4.0-2.1-6.1-5.1-2.0-4.1-4.0-2.1-5.0-6.0-2.0-1.0	98	470214	501424
HG03710.verkko_filt_pat.fa:haplotype2-0000488_101614437_102218208_0	HG03710	501466	603827	1	612	0	0	606	102361	585320	482959	0-3-7-4-8-5-6-2-4-4-2-5-6-2-4-4-2-6-5-2-4-4-2-5-6-2-1	0.0-3.0-7.0-4.0-8.0-5.0-6.0-2.0-4.1-4.0-2.1-5.0-6.0-2.0-4.1-4.0-2.1-6.1-5.1-2.0-4.1-4.0-2.1-5.0-6.0-2.0-1.0	98	501368	603729
HG03927.verkko_filt_mat.fa:haplotype1-0000009_134765170_135173010_1	HG03927	154	115545	0	671	0	0	670	115391	115391	0	0-3-7-4-8-5-6-2-7-4-2-6-5-2-1	0.0-3.0-7.0-4.0-8.0-5.0-6.0-2.0-7.0-4.0-2.1-6.1-5.1-2.0-1.0	154	0	115391
HG03927.verkko_filt_mat.fa:haplotype1-0000009_134765170_135173010_1	HG03927	115636	138470	3	132	0	0	131	22834	138225	115391	0-3-7-4-8-5-6-2-7-4-2-6-5-2-1	0.0-3.0-7.0-4.0-8.0-5.0-6.0-2.0-7.0-4.0-2.1-6.1-5.1-2.0-1.0	154	115482	138316
HG03927.verkko_filt_mat.fa:haplotype1-0000009_134765170_135173010_1	HG03927	139229	142525	7	17	0	0	16	3296	141521	138225	0-3-7-4-8-5-6-2-7-4-2-6-5-2-1	0.0-3.0-7.0-4.0-8.0-5.0-6.0-2.0-7.0-4.0-2.1-6.1-5.1-2.0-1.0	154	139075	142371
HG03927.verkko_filt_mat.fa:haplotype1-0000009_134765170_135173010_1	HG03927	143316	161539	4	96	0	1	95	18223	159744	141521	0-3-7-4-8-5-6-2-7-4-2-6-5-2-1	0.0-3.0-7.0-4.0-8.0-5.0-6.0-2.0-7.0-4.0-2.1-6.1-5.1-2.0-1.0	154	143162	161385
HG03927.verkko_filt_mat.fa:haplotype1-0000009_134765170_135173010_1	HG03927	161483	163253	8	8	0	0	7	1770	161514	159744	0-3-7-4-8-5-6-2-7-4-2-6-5-2-1	0.0-3.0-7.0-4.0-8.0-5.0-6.0-2.0-7.0-4.0-2.1-6.1-5.1-2.0-1.0	154	161329	163099
HG03927.verkko_filt_mat.fa:haplotype1-0000009_134765170_135173010_1	HG03927	163197	175861	5	78	0	0	76	12664	174178	161514	0-3-7-4-8-5-6-2-7-4-2-6-5-2-1	0.0-3.0-7.0-4.0-8.0-5.0-6.0-2.0-7.0-4.0-2.1-6.1-5.1-2.0-1.0	154	163043	175707
HG03927.verkko_filt_mat.fa:haplotype1-0000009_134765170_135173010_1	HG03927	176468	178995	6	24	0	1	21	2527	176705	174178	0-3-7-4-8-5-6-2-7-4-2-6-5-2-1	0.0-3.0-7.0-4.0-8.0-5.0-6.0-2.0-7.0-4.0-2.1-6.1-5.1-2.0-1.0	154	176314	178841
HG03927.verkko_filt_mat.fa:haplotype1-0000009_134765170_135173010_1	HG03927	179354	210566	2	172	0	0	171	31212	207917	176705	0-3-7-4-8-5-6-2-7-4-2-6-5-2-1	0.0-3.0-7.0-4.0-8.0-5.0-6.0-2.0-7.0-4.0-2.1-6.1-5.1-2.0-1.0	154	179200	210412
HG03927.verkko_filt_mat.fa:haplotype1-0000009_134765170_135173010_1	HG03927	211643	214939	7	17	0	0	16	3296	211213	207917	0-3-7-4-8-5-6-2-7-4-2-6-5-2-1	0.0-3.0-7.0-4.0-8.0-5.0-6.0-2.0-7.0-4.0-2.1-6.1-5.1-2.0-1.0	154	211489	214785
HG03927.verkko_filt_mat.fa:haplotype1-0000009_134765170_135173010_1	HG03927	216002	227548	4	96	0	4	58	11546	222759	211213	0-3-7-4-8-5-6-2-7-4-2-6-5-2-1	0.0-3.0-7.0-4.0-8.0-5.0-6.0-2.0-7.0-4.0-2.1-6.1-5.1-2.0-1.0	154	215848	227394
HG03927.verkko_filt_mat.fa:haplotype1-0000009_134765170_135173010_1	HG03927	229414	260632	2	172	1	171	0	31218	253977	222759	0-3-7-4-8-5-6-2-7-4-2-6-5-2-1	0.0-3.0-7.0-4.0-8.0-5.0-6.0-2.0-7.0-4.0-2.1-6.1-5.1-2.0-1.0	154	229260	260478
HG03927.verkko_filt_mat.fa:haplotype1-0000009_134765170_135173010_1	HG03927	260576	263519	6	24	1	23	1	2943	256920	253977	0-3-7-4-8-5-6-2-7-4-2-6-5-2-1	0.0-3.0-7.0-4.0-8.0-5.0-6.0-2.0-7.0-4.0-2.1-6.1-5.1-2.0-1.0	154	260422	263365
HG03927.verkko_filt_mat.fa:haplotype1-0000009_134765170_135173010_1	HG03927	264126	276341	5	78	1	76	3	12215	269135	256920	0-3-7-4-8-5-6-2-7-4-2-6-5-2-1	0.0-3.0-7.0-4.0-8.0-5.0-6.0-2.0-7.0-4.0-2.1-6.1-5.1-2.0-1.0	154	263972	276187
HG03927.verkko_filt_mat.fa:haplotype1-0000009_134765170_135173010_1	HG03927	276780	304694	2	172	0	15	171	27914	297049	269135	0-3-7-4-8-5-6-2-7-4-2-6-5-2-1	0.0-3.0-7.0-4.0-8.0-5.0-6.0-2.0-7.0-4.0-2.1-6.1-5.1-2.0-1.0	154	276626	304540
HG03927.verkko_filt_mat.fa:haplotype1-0000009_134765170_135173010_1	HG03927	304638	407824	1	612	0	0	611	103186	400235	297049	0-3-7-4-8-5-6-2-7-4-2-6-5-2-1	0.0-3.0-7.0-4.0-8.0-5.0-6.0-2.0-7.0-4.0-2.1-6.1-5.1-2.0-1.0	154	304484	407670
HG03927.verkko_filt_pat.fa:haplotype2-0000800_29002142_29504057_1	HG03927	154	115531	0	671	0	0	670	115377	115377	0	0-3-7-4-8-5-6-2-7-4-2-6-5-2-7-4-2-6-5-2-1	0.0-3.0-7.0-4.0-8.0-5.0-6.0-2.0-7.0-4.0-2.1-6.1-5.1-2.0-7.0-4.0-2.1-6.1-5.1-2.0-1.0	154	0	115377
HG03927.verkko_filt_pat.fa:haplotype2-0000800_29002142_29504057_1	HG03927	115622	138453	3	132	0	0	131	22831	138208	115377	0-3-7-4-8-5-6-2-7-4-2-6-5-2-7-4-2-6-5-2-1	0.0-3.0-7.0-4.0-8.0-5.0-6.0-2.0-7.0-4.0-2.1-6.1-5.1-2.0-7.0-4.0-2.1-6.1-5.1-2.0-1.0	154	115468	138299
HG03927.verkko_filt_pat.fa:haplotype2-0000800_29002142_29504057_1	HG03927	139212	142507	7	17	0	0	16	3295	141503	138208	0-3-7-4-8-5-6-2-7-4-2-6-5-2-7-4-2-6-5-2-1	0.0-3.0-7.0-4.0-8.0-5.0-6.0-2.0-7.0-4.0-2.1-6.1-5.1-2.0-7.0-4.0-2.1-6.1-5.1-2.0-1.0	154	139058	142353
HG03927.verkko_filt_pat.fa:haplotype2-0000800_29002142_29504057_1	HG03927	143298	161507	4	96	0	1	95	18209	159712	141503	0-3-7-4-8-5-6-2-7-4-2-6-5-2-7-4-2-6-5-2-1	0.0-3.0-7.0-4.0-8.0-5.0-6.0-2.0-7.0-4.0-2.1-6.1-5.1-2.0-7.0-4.0-2.1-6.1-5.1-2.0-1.0	154	143144	161353
HG03927.verkko_filt_pat.fa:haplotype2-0000800_29002142_29504057_1	HG03927	161451	163221	8	8	0	0	7	1770	161482	159712	0-3-7-4-8-5-6-2-7-4-2-6-5-2-7-4-2-6-5-2-1	0.0-3.0-7.0-4.0-8.0-5.0-6.0-2.0-7.0-4.0-2.1-6.1-5.1-2.0-7.0-4.0-2.1-6.1-5.1-2.0-1.0	154	161297	163067
HG03927.verkko_filt_pat.fa:haplotype2-0000800_29002142_29504057_1	HG03927	163165	176269	5	78	0	0	77	13104	174586	161482	0-3-7-4-8-5-6-2-7-4-2-6-5-2-7-4-2-6-5-2-1	0.0-3.0-7.0-4.0-8.0-5.0-6.0-2.0-7.0-4.0-2.1-6.1-5.1-2.0-7.0-4.0-2.1-6.1-5.1-2.0-1.0	154	163011	176115
HG03927.verkko_filt_pat.fa:haplotype2-0000800_29002142_29504057_1	HG03927	176213	179373	6	24	0	0	23	3160	177746	174586	0-3-7-4-8-5-6-2-7-4-2-6-5-2-7-4-2-6-5-2-1	0.0-3.0-7.0-4.0-8.0-5.0-6.0-2.0-7.0-4.0-2.1-6.1-5.1-2.0-7.0-4.0-2.1-6.1-5.1-2.0-1.0	154	176059	179219
HG03927.verkko_filt_pat.fa:haplotype2-0000800_29002142_29504057_1	HG03927	179317	210532	2	172	0	0	171	31215	208961	177746	0-3-7-4-8-5-6-2-7-4-2-6-5-2-7-4-2-6-5-2-1	0.0-3.0-7.0-4.0-8.0-5.0-6.0-2.0-7.0-4.0-2.1-6.1-5.1-2.0-7.0-4.0-2.1-6.1-5.1-2.0-1.0	154	179163	210378
HG03927.verkko_filt_pat.fa:haplotype2-0000800_29002142_29504057_1	HG03927	211609	214904	7	17	0	0	16	3295	212256	208961	0-3-7-4-8-5-6-2-7-4-2-6-5-2-7-4-2-6-5-2-1	0.0-3.0-7.0-4.0-8.0-5.0-6.0-2.0-7.0-4.0-2.1-6.1-5.1-2.0-7.0-4.0-2.1-6.1-5.1-2.0-1.0	154	211455	214750
HG03927.verkko_filt_pat.fa:haplotype2-0000800_29002142_29504057_1	HG03927	215967	227511	4	96	0	4	58	11544	223800	212256	0-3-7-4-8-5-6-2-7-4-2-6-5-2-7-4-2-6-5-2-1	0.0-3.0-7.0-4.0-8.0-5.0-6.0-2.0-7.0-4.0-2.1-6.1-5.1-2.0-7.0-4.0-2.1-6.1-5.1-2.0-1.0	154	215813	227357
HG03927.verkko_filt_pat.fa:haplotype2-0000800_29002142_29504057_1	HG03927	229377	260592	2	172	1	171	0	31215	255015	223800	0-3-7-4-8-5-6-2-7-4-2-6-5-2-7-4-2-6-5-2-1	0.0-3.0-7.0-4.0-8.0-5.0-6.0-2.0-7.0-4.0-2.1-6.1-5.1-2.0-7.0-4.0-2.1-6.1-5.1-2.0-1.0	154	229223	260438
HG03927.verkko_filt_pat.fa:haplotype2-0000800_29002142_29504057_1	HG03927	260536	263696	6	24	1	23	0	3160	258175	255015	0-3-7-4-8-5-6-2-7-4-2-6-5-2-7-4-2-6-5-2-1	0.0-3.0-7.0-4.0-8.0-5.0-6.0-2.0-7.0-4.0-2.1-6.1-5.1-2.0-7.0-4.0-2.1-6.1-5.1-2.0-1.0	154	260382	263542
HG03927.verkko_filt_pat.fa:haplotype2-0000800_29002142_29504057_1	HG03927	263640	276295	5	78	1	77	3	12655	270830	258175	0-3-7-4-8-5-6-2-7-4-2-6-5-2-7-4-2-6-5-2-1	0.0-3.0-7.0-4.0-8.0-5.0-6.0-2.0-7.0-4.0-2.1-6.1-5.1-2.0-7.0-4.0-2.1-6.1-5.1-2.0-1.0	154	263486	276141
HG03927.verkko_filt_pat.fa:haplotype2-0000800_29002142_29504057_1	HG03927	276734	304649	2	172	0	15	171	27915	298745	270830	0-3-7-4-8-5-6-2-7-4-2-6-5-2-7-4-2-6-5-2-1	0.0-3.0-7.0-4.0-8.0-5.0-6.0-2.0-7.0-4.0-2.1-6.1-5.1-2.0-7.0-4.0-2.1-6.1-5.1-2.0-1.0	154	276580	304495
HG03927.verkko_filt_pat.fa:haplotype2-0000800_29002142_29504057_1	HG03927	305726	309021	7	17	0	0	16	3295	302040	298745	0-3-7-4-8-5-6-2-7-4-2-6-5-2-7-4-2-6-5-2-1	0.0-3.0-7.0-4.0-8.0-5.0-6.0-2.0-7.0-4.0-2.1-6.1-5.1-2.0-7.0-4.0-2.1-6.1-5.1-2.0-1.0	154	305572	308867
HG03927.verkko_filt_pat.fa:haplotype2-0000800_29002142_29504057_1	HG03927	310084	321628	4	96	0	4	58	11544	313584	302040	0-3-7-4-8-5-6-2-7-4-2-6-5-2-7-4-2-6-5-2-1	0.0-3.0-7.0-4.0-8.0-5.0-6.0-2.0-7.0-4.0-2.1-6.1-5.1-2.0-7.0-4.0-2.1-6.1-5.1-2.0-1.0	154	309930	321474
HG03927.verkko_filt_pat.fa:haplotype2-0000800_29002142_29504057_1	HG03927	323494	354709	2	172	1	171	0	31215	344799	313584	0-3-7-4-8-5-6-2-7-4-2-6-5-2-7-4-2-6-5-2-1	0.0-3.0-7.0-4.0-8.0-5.0-6.0-2.0-7.0-4.0-2.1-6.1-5.1-2.0-7.0-4.0-2.1-6.1-5.1-2.0-1.0	154	323340	354555
HG03927.verkko_filt_pat.fa:haplotype2-0000800_29002142_29504057_1	HG03927	354653	357813	6	24	1	23	0	3160	347959	344799	0-3-7-4-8-5-6-2-7-4-2-6-5-2-7-4-2-6-5-2-1	0.0-3.0-7.0-4.0-8.0-5.0-6.0-2.0-7.0-4.0-2.1-6.1-5.1-2.0-7.0-4.0-2.1-6.1-5.1-2.0-1.0	154	354499	357659
HG03927.verkko_filt_pat.fa:haplotype2-0000800_29002142_29504057_1	HG03927	357757	370412	5	78	1	77	3	12655	360614	347959	0-3-7-4-8-5-6-2-7-4-2-6-5-2-7-4-2-6-5-2-1	0.0-3.0-7.0-4.0-8.0-5.0-6.0-2.0-7.0-4.0-2.1-6.1-5.1-2.0-7.0-4.0-2.1-6.1-5.1-2.0-1.0	154	357603	370258
HG03927.verkko_filt_pat.fa:haplotype2-0000800_29002142_29504057_1	HG03927	370851	398760	2	172	0	15	171	27909	388523	360614	0-3-7-4-8-5-6-2-7-4-2-6-5-2-7-4-2-6-5-2-1	0.0-3.0-7.0-4.0-8.0-5.0-6.0-2.0-7.0-4.0-2.1-6.1-5.1-2.0-7.0-4.0-2.1-6.1-5.1-2.0-1.0	154	370697	398606
HG03927.verkko_filt_pat.fa:haplotype2-0000800_29002142_29504057_1	HG03927	398704	501899	1	612	0	0	611	103195	491718	388523	0-3-7-4-8-5-6-2-7-4-2-6-5-2-7-4-2-6-5-2-1	0.0-3.0-7.0-4.0-8.0-5.0-6.0-2.0-7.0-4.0-2.1-6.1-5.1-2.0-7.0-4.0-2.1-6.1-5.1-2.0-1.0	154	398550	501745
HG04228.verkko_filt_mat.fa:haplotype1-0000023_103429213_103930285_0	HG04228	99	115442	0	671	0	0	670	115343	115343	0	0-3-7-4-8-5-6-2-7-4-2-6-5-2-4-7-2-5-6-2-1	0.0-3.0-7.0-4.0-8.0-5.0-6.0-2.0-7.0-4.0-2.1-6.1-5.1-2.0-4.1-7.1-2.1-5.0-6.0-2.0-1.0	99	0	115343
HG04228.verkko_filt_mat.fa:haplotype1-0000023_103429213_103930285_0	HG04228	115533	138370	3	132	0	0	131	22837	138180	115343	0-3-7-4-8-5-6-2-7-4-2-6-5-2-4-7-2-5-6-2-1	0.0-3.0-7.0-4.0-8.0-5.0-6.0-2.0-7.0-4.0-2.1-6.1-5.1-2.0-4.1-7.1-2.1-5.0-6.0-2.0-1.0	99	115434	138271
HG04228.verkko_filt_mat.fa:haplotype1-0000023_103429213_103930285_0	HG04228	139129	142425	7	17	0	0	16	3296	141476	138180	0-3-7-4-8-5-6-2-7-4-2-6-5-2-4-7-2-5-6-2-1	0.0-3.0-7.0-4.0-8.0-5.0-6.0-2.0-7.0-4.0-2.1-6.1-5.1-2.0-4.1-7.1-2.1-5.0-6.0-2.0-1.0	99	139030	142326
HG04228.verkko_filt_mat.fa:haplotype1-0000023_103429213_103930285_0	HG04228	142873	161428	4	96	0	0	95	18555	160031	141476	0-3-7-4-8-5-6-2-7-4-2-6-5-2-4-7-2-5-6-2-1	0.0-3.0-7.0-4.0-8.0-5.0-6.0-2.0-7.0-4.0-2.1-6.1-5.1-2.0-4.1-7.1-2.1-5.0-6.0-2.0-1.0	99	142774	161329
HG04228.verkko_filt_mat.fa:haplotype1-0000023_103429213_103930285_0	HG04228	161372	163142	8	8	0	0	7	1770	161801	160031	0-3-7-4-8-5-6-2-7-4-2-6-5-2-4-7-2-5-6-2-1	0.0-3.0-7.0-4.0-8.0-5.0-6.0-2.0-7.0-4.0-2.1-6.1-5.1-2.0-4.1-7.1-2.1-5.0-6.0-2.0-1.0	99	161273	163043
HG04228.verkko_filt_mat.fa:haplotype1-0000023_103429213_103930285_0	HG04228	163086	176188	5	78	0	0	77	13102	174903	161801	0-3-7-4-8-5-6-2-7-4-2-6-5-2-4-7-2-5-6-2-1	0.0-3.0-7.0-4.0-8.0-5.0-6.0-2.0-7.0-4.0-2.1-6.1-5.1-2.0-4.1-7.1-2.1-5.0-6.0-2.0-1.0	99	162987	176089
HG04228.verkko_filt_mat.fa:haplotype1-0000023_103429213_103930285_0	HG04228	176132	178876	6	24	0	0	21	2744	177647	174903	0-3-7-4-8-5-6-2-7-4-2-6-5-2-4-7-2-5-6-2-1	0.0-3.0-7.0-4.0-8.0-5.0-6.0-2.0-7.0-4.0-2.1-6.1-5.1-2.0-4.1-7.1-2.1-5.0-6.0-2.0-1.0	99	176033	178777
HG04228.verkko_filt_mat.fa:haplotype1-0000023_103429213_103930285_0	HG04228	179234	210078	2	172	0	0	170	30844	208491	177647	0-3-7-4-8-5-6-2-7-4-2-6-5-2-4-7-2-5-6-2-1	0.0-3.0-7.0-4.0-8.0-5.0-6.0-2.0-7.0-4.0-2.1-6.1-5.1-2.0-4.1-7.1-2.1-5.0-6.0-2.0-1.0	99	179135	209979
HG04228.verkko_filt_mat.fa:haplotype1-0000023_103429213_103930285_0	HG04228	211540	214836	7	17	0	0	16	3296	211787	208491	0-3-7-4-8-5-6-2-7-4-2-6-5-2-4-7-2-5-6-2-1	0.0-3.0-7.0-4.0-8.0-5.0-6.0-2.0-7.0-4.0-2.1-6.1-5.1-2.0-4.1-7.1-2.1-5.0-6.0-2.0-1.0	99	211441	214737
HG04228.verkko_filt_mat.fa:haplotype1-0000023_103429213_103930285_0	HG04228	215789	227439	4	96	0	2	58	11650	223437	211787	0-3-7-4-8-5-6-2-7-4-2-6-5-2-4-7-2-5-6-2-1	0.0-3.0-7.0-4.0-8.0-5.0-6.0-2.0-7.0-4.0-2.1-6.1-5.1-2.0-4.1-7.1-2.1-5.0-6.0-2.0-1.0	99	215690	227340
HG04228.verkko_filt_mat.fa:haplotype1-0000023_103429213_103930285_0	HG04228	229690	260530	2	172	1	170	0	30840	254277	223437	0-3-7-4-8-5-6-2-7-4-2-6-5-2-4-7-2-5-6-2-1	0.0-3.0-7.0-4.0-8.0-5.0-6.0-2.0-7.0-4.0-2.1-6.1-5.1-2.0-4.1-7.1-2.1-5.0-6.0-2.0-1.0	99	229591	260431
HG04228.verkko_filt_mat.fa:haplotype1-0000023_103429213_103930285_0	HG04228	260906	263650	6	24	1	21	0	2744	257021	254277	0-3-7-4-8-5-6-2-7-4-2-6-5-2-4-7-2-5-6-2-1	0.0-3.0-7.0-4.0-8.0-5.0-6.0-2.0-7.0-4.0-2.1-6.1-5.1-2.0-4.1-7.1-2.1-5.0-6.0-2.0-1.0	99	260807	263551
HG04228.verkko_filt_mat.fa:haplotype1-0000023_103429213_103930285_0	HG04228	263594	275722	5	78	1	77	5	12128	269149	257021	0-3-7-4-8-5-6-2-7-4-2-6-5-2-4-7-2-5-6-2-1	0.0-3.0-7.0-4.0-8.0-5.0-6.0-2.0-7.0-4.0-2.1-6.1-5.1-2.0-4.1-7.1-2.1-5.0-6.0-2.0-1.0	99	263495	275623
HG04228.verkko_filt_mat.fa:haplotype1-0000023_103429213_103930285_0	HG04228	276688	303884	2	172	0	15	167	27196	296345	269149	0-3-7-4-8-5-6-2-7-4-2-6-5-2-4-7-2-5-6-2-1	0.0-3.0-7.0-4.0-8.0-5.0-6.0-2.0-7.0-4.0-2.1-6.1-5.1-2.0-4.1-7.1-2.1-5.0-6.0-2.0-1.0	99	276589	303785
HG04228.verkko_filt_mat.fa:haplotype1-0000023_103429213_103930285_0	HG04228	306476	318020	4	96	1	58	4	11544	307889	296345	0-3-7-4-8-5-6-2-7-4-2-6-5-2-4-7-2-5-6-2-1	0.0-3.0-7.0-4.0-8.0-5.0-6.0-2.0-7.0-4.0-2.1-6.1-5.1-2.0-4.1-7.1-2.1-5.0-6.0-2.0-1.0	99	306377	317921
HG04228.verkko_filt_mat.fa:haplotype1-0000023_103429213_103930285_0	HG04228	319087	322382	7	17	1	16	0	3295	311184	307889	0-3-7-4-8-5-6-2-7-4-2-6-5-2-4-7-2-5-6-2-1	0.0-3.0-7.0-4.0-8.0-5.0-6.0-2.0-7.0-4.0-2.1-6.1-5.1-2.0-4.1-7.1-2.1-5.0-6.0-2.0-1.0	99	318988	322283
HG04228.verkko_filt_mat.fa:haplotype1-0000023_103429213_103930285_0	HG04228	323844	351376	2	172	1	170	15	27532	338716	311184	0-3-7-4-8-5-6-2-7-4-2-6-5-2-4-7-2-5-6-2-1	0.0-3.0-7.0-4.0-8.0-5.0-6.0-2.0-7.0-4.0-2.1-6.1-5.1-2.0-4.1-7.1-2.1-5.0-6.0-2.0-1.0	99	323745	351277
HG04228.verkko_filt_mat.fa:haplotype1-0000023_103429213_103930285_0	HG04228	352342	364030	5	78	0	5	76	11688	350404	338716	0-3-7-4-8-5-6-2-7-4-2-6-5-2-4-7-2-5-6-2-1	0.0-3.0-7.0-4.0-8.0-5.0-6.0-2.0-7.0-4.0-2.1-6.1-5.1-2.0-4.1-7.1-2.1-5.0-6.0-2.0-1.0	99	352243	363931
HG04228.verkko_filt_mat.fa:haplotype1-0000023_103429213_103930285_0	HG04228	364637	367164	6	24	0	1	21	2527	352931	350404	0-3-7-4-8-5-6-2-7-4-2-6-5-2-4-7-2-5-6-2-1	0.0-3.0-7.0-4.0-8.0-5.0-6.0-2.0-7.0-4.0-2.1-6.1-5.1-2.0-4.1-7.1-2.1-5.0-6.0-2.0-1.0	99	364538	367065
HG04228.verkko_filt_mat.fa:haplotype1-0000023_103429213_103930285_0	HG04228	367522	398740	2	172	0	0	171	31218	384149	352931	0-3-7-4-8-5-6-2-7-4-2-6-5-2-4-7-2-5-6-2-1	0.0-3.0-7.0-4.0-8.0-5.0-6.0-2.0-7.0-4.0-2.1-6.1-5.1-2.0-4.1-7.1-2.1-5.0-6.0-2.0-1.0	99	367423	398641
HG04228.verkko_filt_mat.fa:haplotype1-0000023_103429213_103930285_0	HG04228	398684	501128	1	612	0	0	606	102444	486593	384149	0-3-7-4-8-5-6-2-7-4-2-6-5-2-4-7-2-5-6-2-1	0.0-3.0-7.0-4.0-8.0-5.0-6.0-2.0-7.0-4.0-2.1-6.1-5.1-2.0-4.1-7.1-2.1-5.0-6.0-2.0-1.0	99	398585	501029
HG04228.verkko_filt_pat.fa:haplotype2-0000600_103806749_104119491_0	HG04228	99	115473	0	671	0	0	670	115374	115374	0	0-3-7-4-8-5-6-2-1	0.0-3.0-7.0-4.0-8.0-5.0-6.0-2.0-1.0	99	0	115374
HG04228.verkko_filt_pat.fa:haplotype2-0000600_103806749_104119491_0	HG04228	115564	138398	3	132	0	0	131	22834	138208	115374	0-3-7-4-8-5-6-2-1	0.0-3.0-7.0-4.0-8.0-5.0-6.0-2.0-1.0	99	115465	138299
HG04228.verkko_filt_pat.fa:haplotype2-0000600_103806749_104119491_0	HG04228	139157	142453	7	17	0	0	16	3296	141504	138208	0-3-7-4-8-5-6-2-1	0.0-3.0-7.0-4.0-8.0-5.0-6.0-2.0-1.0	99	139058	142354
HG04228.verkko_filt_pat.fa:haplotype2-0000600_103806749_104119491_0	HG04228	142901	161456	4	96	0	0	95	18555	160059	141504	0-3-7-4-8-5-6-2-1	0.0-3.0-7.0-4.0-8.0-5.0-6.0-2.0-1.0	99	142802	161357
HG04228.verkko_filt_pat.fa:haplotype2-0000600_103806749_104119491_0	HG04228	161400	163170	8	8	0	0	7	1770	161829	160059	0-3-7-4-8-5-6-2-1	0.0-3.0-7.0-4.0-8.0-5.0-6.0-2.0-1.0	99	161301	163071
HG04228.verkko_filt_pat.fa:haplotype2-0000600_103806749_104119491_0	HG04228	163114	176218	5	78	0	0	77	13104	174933	161829	0-3-7-4-8-5-6-2-1	0.0-3.0-7.0-4.0-8.0-5.0-6.0-2.0-1.0	99	163015	176119
HG04228.verkko_filt_pat.fa:haplotype2-0000600_103806749_104119491_0	HG04228	176162	178906	6	24	0	0	21	2744	177677	174933	0-3-7-4-8-5-6-2-1	0.0-3.0-7.0-4.0-8.0-5.0-6.0-2.0-1.0	99	176063	178807
HG04228.verkko_filt_pat.fa:haplotype2-0000600_103806749_104119491_0	HG04228	179264	210481	2	172	0	0	171	31217	208894	177677	0-3-7-4-8-5-6-2-1	0.0-3.0-7.0-4.0-8.0-5.0-6.0-2.0-1.0	99	179165	210382
HG04228.verkko_filt_pat.fa:haplotype2-0000600_103806749_104119491_0	HG04228	210425	312798	1	612	0	0	606	102373	311267	208894	0-3-7-4-8-5-6-2-1	0.0-3.0-7.0-4.0-8.0-5.0-6.0-2.0-1.0	99	210326	312699
NA18906#1#JAHEOO010000054.1_2103477_2510435_1	NA18906	154	115520	0	671	0	0	670	115366	115366	0	0-3-7-4-8-5-6-2-4-7-2-5-6-2-1	0.0-3.0-7.0-4.0-8.0-5.0-6.0-2.0-4.1-7.1-2.1-5.0-6.0-2.0-1.0	154	0	115366
NA18906#1#JAHEOO010000054.1_2103477_2510435_1	NA18906	115611	138444	3	132	0	0	131	22833	138199	115366	0-3-7-4-8-5-6-2-4-7-2-5-6-2-1	0.0-3.0-7.0-4.0-8.0-5.0-6.0-2.0-4.1-7.1-2.1-5.0-6.0-2.0-1.0	154	115457	138290
NA18906#1#JAHEOO010000054.1_2103477_2510435_1	NA18906	139203	142498	7	17	0	0	16	3295	141494	138199	0-3-7-4-8-5-6-2-4-7-2-5-6-2-1	0.0-3.0-7.0-4.0-8.0-5.0-6.0-2.0-4.1-7.1-2.1-5.0-6.0-2.0-1.0	154	139049	142344
NA18906#1#JAHEOO010000054.1_2103477_2510435_1	NA18906	143565	161536	4	96	0	4	95	17971	159465	141494	0-3-7-4-8-5-6-2-4-7-2-5-6-2-1	0.0-3.0-7.0-4.0-8.0-5.0-6.0-2.0-4.1-7.1-2.1-5.0-6.0-2.0-1.0	154	143411	161382
NA18906#1#JAHEOO010000054.1_2103477_2510435_1	NA18906	161480	163250	8	8	0	0	7	1770	161235	159465	0-3-7-4-8-5-6-2-4-7-2-5-6-2-1	0.0-3.0-7.0-4.0-8.0-5.0-6.0-2.0-4.1-7.1-2.1-5.0-6.0-2.0-1.0	154	161326	163096
NA18906#1#JAHEOO010000054.1_2103477_2510435_1	NA18906	163194	175892	5	78	0	0	76	12698	173933	161235	0-3-7-4-8-5-6-2-4-7-2-5-6-2-1	0.0-3.0-7.0-4.0-8.0-5.0-6.0-2.0-4.1-7.1-2.1-5.0-6.0-2.0-1.0	154	163040	175738
NA18906#1#JAHEOO010000054.1_2103477_2510435_1	NA18906	176499	179026	6	24	0	1	21	2527	176460	173933	0-3-7-4-8-5-6-2-4-7-2-5-6-2-1	0.0-3.0-7.0-4.0-8.0-5.0-6.0-2.0-4.1-7.1-2.1-5.0-6.0-2.0-1.0	154	176345	178872
NA18906#1#JAHEOO010000054.1_2103477_2510435_1	NA18906	179409	210620	2	172	0	0	171	31211	207671	176460	0-3-7-4-8-5-6-2-4-7-2-5-6-2-1	0.0-3.0-7.0-4.0-8.0-5.0-6.0-2.0-4.1-7.1-2.1-5.0-6.0-2.0-1.0	154	179255	210466
NA18906#1#JAHEOO010000054.1_2103477_2510435_1	NA18906	212936	224031	4	96	1	56	4	11095	218766	207671	0-3-7-4-8-5-6-2-4-7-2-5-6-2-1	0.0-3.0-7.0-4.0-8.0-5.0-6.0-2.0-4.1-7.1-2.1-5.0-6.0-2.0-1.0	154	212782	223877
NA18906#1#JAHEOO010000054.1_2103477_2510435_1	NA18906	225094	228389	7	17	1	16	0	3295	222061	218766	0-3-7-4-8-5-6-2-4-7-2-5-6-2-1	0.0-3.0-7.0-4.0-8.0-5.0-6.0-2.0-4.1-7.1-2.1-5.0-6.0-2.0-1.0	154	224940	228235
NA18906#1#JAHEOO010000054.1_2103477_2510435_1	NA18906	229466	257378	2	172	1	171	15	27912	249973	222061	0-3-7-4-8-5-6-2-4-7-2-5-6-2-1	0.0-3.0-7.0-4.0-8.0-5.0-6.0-2.0-4.1-7.1-2.1-5.0-6.0-2.0-1.0	154	229312	257224
NA18906#1#JAHEOO010000054.1_2103477_2510435_1	NA18906	258344	269558	5	78	0	5	74	11214	261187	249973	0-3-7-4-8-5-6-2-4-7-2-5-6-2-1	0.0-3.0-7.0-4.0-8.0-5.0-6.0-2.0-4.1-7.1-2.1-5.0-6.0-2.0-1.0	154	258190	269404
NA18906#1#JAHEOO010000054.1_2103477_2510435_1	NA18906	270639	273166	6	24	0	1	21	2527	263714	261187	0-3-7-4-8-5-6-2-4-7-2-5-6-2-1	0.0-3.0-7.0-4.0-8.0-5.0-6.0-2.0-4.1-7.1-2.1-5.0-6.0-2.0-1.0	154	270485	273012
NA18906#1#JAHEOO010000054.1_2103477_2510435_1	NA18906	273524	304735	2	172	0	0	171	31211	294925	263714	0-3-7-4-8-5-6-2-4-7-2-5-6-2-1	0.0-3.0-7.0-4.0-8.0-5.0-6.0-2.0-4.1-7.1-2.1-5.0-6.0-2.0-1.0	154	273370	304581
NA18906#1#JAHEOO010000054.1_2103477_2510435_1	NA18906	304679	406754	1	612	0	0	604	102075	397000	294925	0-3-7-4-8-5-6-2-4-7-2-5-6-2-1	0.0-3.0-7.0-4.0-8.0-5.0-6.0-2.0-4.1-7.1-2.1-5.0-6.0-2.0-1.0	154	304525	406600
NA18906#2#JAHEON010000009.1_93748295_94249275_0	NA18906	98	115437	0	671	0	0	670	115339	115339	0	0-3-7-4-8-5-6-2-4-7-2-5-6-2-4-7-2-6-5-2-1	0.0-3.0-7.0-4.0-8.0-5.0-6.0-2.0-4.1-7.1-2.1-5.0-6.0-2.0-4.1-7.1-2.1-6.1-5.1-2.0-1.0	98	0	115339
NA18906#2#JAHEON010000009.1_93748295_94249275_0	NA18906	115528	138357	3	132	0	0	131	22829	138168	115339	0-3-7-4-8-5-6-2-4-7-2-5-6-2-4-7-2-6-5-2-1	0.0-3.0-7.0-4.0-8.0-5.0-6.0-2.0-4.1-7.1-2.1-5.0-6.0-2.0-4.1-7.1-2.1-6.1-5.1-2.0-1.0	98	115430	138259
NA18906#2#JAHEON010000009.1_93748295_94249275_0	NA18906	139116	142411	7	17	0	0	16	3295	141463	138168	0-3-7-4-8-5-6-2-4-7-2-5-6-2-4-7-2-6-5-2-1	0.0-3.0-7.0-4.0-8.0-5.0-6.0-2.0-4.1-7.1-2.1-5.0-6.0-2.0-4.1-7.1-2.1-6.1-5.1-2.0-1.0	98	139018	142313
NA18906#2#JAHEON010000009.1_93748295_94249275_0	NA18906	142859	161414	4	96	0	0	95	18555	160018	141463	0-3-7-4-8-5-6-2-4-7-2-5-6-2-4-7-2-6-5-2-1	0.0-3.0-7.0-4.0-8.0-5.0-6.0-2.0-4.1-7.1-2.1-5.0-6.0-2.0-4.1-7.1-2.1-6.1-5.1-2.0-1.0	98	142761	161316
NA18906#2#JAHEON010000009.1_93748295_94249275_0	NA18906	161358	163128	8	8	0	0	7	1770	161788	160018	0-3-7-4-8-5-6-2-4-7-2-5-6-2-4-7-2-6-5-2-1	0.0-3.0-7.0-4.0-8.0-5.0-6.0-2.0-4.1-7.1-2.1-5.0-6.0-2.0-4.1-7.1-2.1-6.1-5.1-2.0-1.0	98	161260	163030
NA18906#2#JAHEON010000009.1_93748295_94249275_0	NA18906	163072	175729	5	78	0	0	76	12657	174445	161788	0-3-7-4-8-5-6-2-4-7-2-5-6-2-4-7-2-6-5-2-1	0.0-3.0-7.0-4.0-8.0-5.0-6.0-2.0-4.1-7.1-2.1-5.0-6.0-2.0-4.1-7.1-2.1-6.1-5.1-2.0-1.0	98	162974	175631
NA18906#2#JAHEON010000009.1_93748295_94249275_0	NA18906	176113	179273	6	24	0	0	23	3160	177605	174445	0-3-7-4-8-5-6-2-4-7-2-5-6-2-4-7-2-6-5-2-1	0.0-3.0-7.0-4.0-8.0-5.0-6.0-2.0-4.1-7.1-2.1-5.0-6.0-2.0-4.1-7.1-2.1-6.1-5.1-2.0-1.0	98	176015	179175
NA18906#2#JAHEON010000009.1_93748295_94249275_0	NA18906	179217	210441	2	172	0	0	171	31224	208829	177605	0-3-7-4-8-5-6-2-4-7-2-5-6-2-4-7-2-6-5-2-1	0.0-3.0-7.0-4.0-8.0-5.0-6.0-2.0-4.1-7.1-2.1-5.0-6.0-2.0-4.1-7.1-2.1-6.1-5.1-2.0-1.0	98	179119	210343
NA18906#2#JAHEON010000009.1_93748295_94249275_0	NA18906	212307	223852	4	96	1	58	4	11545	220374	208829	0-3-7-4-8-5-6-2-4-7-2-5-6-2-4-7-2-6-5-2-1	0.0-3.0-7.0-4.0-8.0-5.0-6.0-2.0-4.1-7.1-2.1-5.0-6.0-2.0-4.1-7.1-2.1-6.1-5.1-2.0-1.0	98	212209	223754
NA18906#2#JAHEON010000009.1_93748295_94249275_0	NA18906	224919	228214	7	17	1	16	0	3295	223669	220374	0-3-7-4-8-5-6-2-4-7-2-5-6-2-4-7-2-6-5-2-1	0.0-3.0-7.0-4.0-8.0-5.0-6.0-2.0-4.1-7.1-2.1-5.0-6.0-2.0-4.1-7.1-2.1-6.1-5.1-2.0-1.0	98	224821	228116
NA18906#2#JAHEON010000009.1_93748295_94249275_0	NA18906	229291	257209	2	172	1	171	15	27918	251587	223669	0-3-7-4-8-5-6-2-4-7-2-5-6-2-4-7-2-6-5-2-1	0.0-3.0-7.0-4.0-8.0-5.0-6.0-2.0-4.1-7.1-2.1-5.0-6.0-2.0-4.1-7.1-2.1-6.1-5.1-2.0-1.0	98	229193	257111
NA18906#2#JAHEON010000009.1_93748295_94249275_0	NA18906	257648	269856	5	78	0	3	76	12208	263795	251587	0-3-7-4-8-5-6-2-4-7-2-5-6-2-4-7-2-6-5-2-1	0.0-3.0-7.0-4.0-8.0-5.0-6.0-2.0-4.1-7.1-2.1-5.0-6.0-2.0-4.1-7.1-2.1-6.1-5.1-2.0-1.0	98	257550	269758
NA18906#2#JAHEON010000009.1_93748295_94249275_0	NA18906	270240	273400	6	24	0	0	23	3160	266955	263795	0-3-7-4-8-5-6-2-4-7-2-5-6-2-4-7-2-6-5-2-1	0.0-3.0-7.0-4.0-8.0-5.0-6.0-2.0-4.1-7.1-2.1-5.0-6.0-2.0-4.1-7.1-2.1-6.1-5.1-2.0-1.0	98	270142	273302
NA18906#2#JAHEON010000009.1_93748295_94249275_0	NA18906	273344	304555	2	172	0	0	171	31211	298166	266955	0-3-7-4-8-5-6-2-4-7-2-5-6-2-4-7-2-6-5-2-1	0.0-3.0-7.0-4.0-8.0-5.0-6.0-2.0-4.1-7.1-2.1-5.0-6.0-2.0-4.1-7.1-2.1-6.1-5.1-2.0-1.0	98	273246	304457
NA18906#2#JAHEON010000009.1_93748295_94249275_0	NA18906	306421	317966	4	96	1	58	4	11545	309711	298166	0-3-7-4-8-5-6-2-4-7-2-5-6-2-4-7-2-6-5-2-1	0.0-3.0-7.0-4.0-8.0-5.0-6.0-2.0-4.1-7.1-2.1-5.0-6.0-2.0-4.1-7.1-2.1-6.1-5.1-2.0-1.0	98	306323	317868
NA18906#2#JAHEON010000009.1_93748295_94249275_0	NA18906	319033	322328	7	17	1	16	0	3295	313006	309711	0-3-7-4-8-5-6-2-4-7-2-5-6-2-4-7-2-6-5-2-1	0.0-3.0-7.0-4.0-8.0-5.0-6.0-2.0-4.1-7.1-2.1-5.0-6.0-2.0-4.1-7.1-2.1-6.1-5.1-2.0-1.0	98	318935	322230
NA18906#2#JAHEON010000009.1_93748295_94249275_0	NA18906	323405	354626	2	172	1	171	0	31221	344227	313006	0-3-7-4-8-5-6-2-4-7-2-5-6-2-4-7-2-6-5-2-1	0.0-3.0-7.0-4.0-8.0-5.0-6.0-2.0-4.1-7.1-2.1-5.0-6.0-2.0-4.1-7.1-2.1-6.1-5.1-2.0-1.0	98	323307	354528
NA18906#2#JAHEON010000009.1_93748295_94249275_0	NA18906	354985	357512	6	24	1	21	1	2527	346754	344227	0-3-7-4-8-5-6-2-4-7-2-5-6-2-4-7-2-6-5-2-1	0.0-3.0-7.0-4.0-8.0-5.0-6.0-2.0-4.1-7.1-2.1-5.0-6.0-2.0-4.1-7.1-2.1-6.1-5.1-2.0-1.0	98	354887	357414
NA18906#2#JAHEON010000009.1_93748295_94249275_0	NA18906	358119	370327	5	78	1	76	3	12208	358962	346754	0-3-7-4-8-5-6-2-4-7-2-5-6-2-4-7-2-6-5-2-1	0.0-3.0-7.0-4.0-8.0-5.0-6.0-2.0-4.1-7.1-2.1-5.0-6.0-2.0-4.1-7.1-2.1-6.1-5.1-2.0-1.0	98	358021	370229
NA18906#2#JAHEON010000009.1_93748295_94249275_0	NA18906	370766	398685	2	172	0	15	171	27919	386881	358962	0-3-7-4-8-5-6-2-4-7-2-5-6-2-4-7-2-6-5-2-1	0.0-3.0-7.0-4.0-8.0-5.0-6.0-2.0-4.1-7.1-2.1-5.0-6.0-2.0-4.1-7.1-2.1-6.1-5.1-2.0-1.0	98	370668	398587
NA18906#2#JAHEON010000009.1_93748295_94249275_0	NA18906	398629	501036	1	612	0	0	606	102407	489288	386881	0-3-7-4-8-5-6-2-4-7-2-5-6-2-4-7-2-6-5-2-1	0.0-3.0-7.0-4.0-8.0-5.0-6.0-2.0-4.1-7.1-2.1-5.0-6.0-2.0-4.1-7.1-2.1-6.1-5.1-2.0-1.0	98	398531	500938
NA19240#1#JAHEOM010000047.1_30103390_30511199_1	NA19240	154	115558	0	671	0	0	670	115404	115404	0	0-3-7-4-8-5-6-2-4-7-2-6-5-2-1	0.0-3.0-7.0-4.0-8.0-5.0-6.0-2.0-4.1-7.1-2.1-6.1-5.1-2.0-1.0	154	0	115404
NA19240#1#JAHEOM010000047.1_30103390_30511199_1	NA19240	115649	138484	3	132	0	0	131	22835	138239	115404	0-3-7-4-8-5-6-2-4-7-2-6-5-2-1	0.0-3.0-7.0-4.0-8.0-5.0-6.0-2.0-4.1-7.1-2.1-6.1-5.1-2.0-1.0	154	115495	138330
NA19240#1#JAHEOM010000047.1_30103390_30511199_1	NA19240	139243	142538	7	17	0	0	16	3295	141534	138239	0-3-7-4-8-5-6-2-4-7-2-6-5-2-1	0.0-3.0-7.0-4.0-8.0-5.0-6.0-2.0-4.1-7.1-2.1-6.1-5.1-2.0-1.0	154	139089	142384
NA19240#1#JAHEOM010000047.1_30103390_30511199_1	NA19240	142986	161544	4	96	0	0	95	18558	160092	141534	0-3-7-4-8-5-6-2-4-7-2-6-5-2-1	0.0-3.0-7.0-4.0-8.0-5.0-6.0-2.0-4.1-7.1-2.1-6.1-5.1-2.0-1.0	154	142832	161390
NA19240#1#JAHEOM010000047.1_30103390_30511199_1	NA19240	161488	163258	8	8	0	0	7	1770	161862	160092	0-3-7-4-8-5-6-2-4-7-2-6-5-2-1	0.0-3.0-7.0-4.0-8.0-5.0-6.0-2.0-4.1-7.1-2.1-6.1-5.1-2.0-1.0	154	161334	163104
NA19240#1#JAHEOM010000047.1_30103390_30511199_1	NA19240	163202	175393	5	78	0	0	74	12191	174053	161862	0-3-7-4-8-5-6-2-4-7-2-6-5-2-1	0.0-3.0-7.0-4.0-8.0-5.0-6.0-2.0-4.1-7.1-2.1-6.1-5.1-2.0-1.0	154	163048	175239
NA19240#1#JAHEOM010000047.1_30103390_30511199_1	NA19240	176474	179417	6	24	0	1	23	2943	176996	174053	0-3-7-4-8-5-6-2-4-7-2-6-5-2-1	0.0-3.0-7.0-4.0-8.0-5.0-6.0-2.0-4.1-7.1-2.1-6.1-5.1-2.0-1.0	154	176320	179263
NA19240#1#JAHEOM010000047.1_30103390_30511199_1	NA19240	179361	210580	2	172	0	0	171	31219	208215	176996	0-3-7-4-8-5-6-2-4-7-2-6-5-2-1	0.0-3.0-7.0-4.0-8.0-5.0-6.0-2.0-4.1-7.1-2.1-6.1-5.1-2.0-1.0	154	179207	210426
NA19240#1#JAHEOM010000047.1_30103390_30511199_1	NA19240	212446	223572	4	96	1	58	6	11126	219341	208215	0-3-7-4-8-5-6-2-4-7-2-6-5-2-1	0.0-3.0-7.0-4.0-8.0-5.0-6.0-2.0-4.1-7.1-2.1-6.1-5.1-2.0-1.0	154	212292	223418
NA19240#1#JAHEOM010000047.1_30103390_30511199_1	NA19240	225059	228354	7	17	1	16	0	3295	222636	219341	0-3-7-4-8-5-6-2-4-7-2-6-5-2-1	0.0-3.0-7.0-4.0-8.0-5.0-6.0-2.0-4.1-7.1-2.1-6.1-5.1-2.0-1.0	154	224905	228200
NA19240#1#JAHEOM010000047.1_30103390_30511199_1	NA19240	229816	260654	2	172	1	170	0	30838	253474	222636	0-3-7-4-8-5-6-2-4-7-2-6-5-2-1	0.0-3.0-7.0-4.0-8.0-5.0-6.0-2.0-4.1-7.1-2.1-6.1-5.1-2.0-1.0	154	229662	260500
NA19240#1#JAHEOM010000047.1_30103390_30511199_1	NA19240	260598	263541	6	24	1	23	1	2943	256417	253474	0-3-7-4-8-5-6-2-4-7-2-6-5-2-1	0.0-3.0-7.0-4.0-8.0-5.0-6.0-2.0-4.1-7.1-2.1-6.1-5.1-2.0-1.0	154	260444	263387
NA19240#1#JAHEOM010000047.1_30103390_30511199_1	NA19240	264622	276519	5	78	1	74	2	11897	268314	256417	0-3-7-4-8-5-6-2-4-7-2-6-5-2-1	0.0-3.0-7.0-4.0-8.0-5.0-6.0-2.0-4.1-7.1-2.1-6.1-5.1-2.0-1.0	154	264468	276365
NA19240#1#JAHEOM010000047.1_30103390_30511199_1	NA19240	276801	304715	2	172	0	15	171	27914	296228	268314	0-3-7-4-8-5-6-2-4-7-2-6-5-2-1	0.0-3.0-7.0-4.0-8.0-5.0-6.0-2.0-4.1-7.1-2.1-6.1-5.1-2.0-1.0	154	276647	304561
NA19240#1#JAHEOM010000047.1_30103390_30511199_1	NA19240	304659	407793	1	612	0	0	611	103134	399362	296228	0-3-7-4-8-5-6-2-4-7-2-6-5-2-1	0.0-3.0-7.0-4.0-8.0-5.0-6.0-2.0-4.1-7.1-2.1-6.1-5.1-2.0-1.0	154	304505	407639
NA19240#2#JAHEOL010000010.1_37445323_37853017_0	NA19240	98	115416	0	671	0	0	670	115318	115318	0	0-3-7-4-8-5-6-2-7-4-2-6-5-2-1	0.0-3.0-7.0-4.0-8.0-5.0-6.0-2.0-7.0-4.0-2.1-6.1-5.1-2.0-1.0	98	0	115318
NA19240#2#JAHEOL010000010.1_37445323_37853017_0	NA19240	115507	138338	3	132	0	0	131	22831	138149	115318	0-3-7-4-8-5-6-2-7-4-2-6-5-2-1	0.0-3.0-7.0-4.0-8.0-5.0-6.0-2.0-7.0-4.0-2.1-6.1-5.1-2.0-1.0	98	115409	138240
NA19240#2#JAHEOL010000010.1_37445323_37853017_0	NA19240	139097	142392	7	17	0	0	16	3295	141444	138149	0-3-7-4-8-5-6-2-7-4-2-6-5-2-1	0.0-3.0-7.0-4.0-8.0-5.0-6.0-2.0-7.0-4.0-2.1-6.1-5.1-2.0-1.0	98	138999	142294
NA19240#2#JAHEOL010000010.1_37445323_37853017_0	NA19240	143183	161390	4	96	0	1	95	18207	159651	141444	0-3-7-4-8-5-6-2-7-4-2-6-5-2-1	0.0-3.0-7.0-4.0-8.0-5.0-6.0-2.0-7.0-4.0-2.1-6.1-5.1-2.0-1.0	98	143085	161292
NA19240#2#JAHEOL010000010.1_37445323_37853017_0	NA19240	161334	163104	8	8	0	0	7	1770	161421	159651	0-3-7-4-8-5-6-2-7-4-2-6-5-2-1	0.0-3.0-7.0-4.0-8.0-5.0-6.0-2.0-7.0-4.0-2.1-6.1-5.1-2.0-1.0	98	161236	163006
NA19240#2#JAHEOL010000010.1_37445323_37853017_0	NA19240	163048	175712	5	78	0	0	76	12664	174085	161421	0-3-7-4-8-5-6-2-7-4-2-6-5-2-1	0.0-3.0-7.0-4.0-8.0-5.0-6.0-2.0-7.0-4.0-2.1-6.1-5.1-2.0-1.0	98	162950	175614
NA19240#2#JAHEOL010000010.1_37445323_37853017_0	NA19240	176096	178840	6	24	0	0	21	2744	176829	174085	0-3-7-4-8-5-6-2-7-4-2-6-5-2-1	0.0-3.0-7.0-4.0-8.0-5.0-6.0-2.0-7.0-4.0-2.1-6.1-5.1-2.0-1.0	98	175998	178742
NA19240#2#JAHEOL010000010.1_37445323_37853017_0	NA19240	179199	210413	2	172	0	0	171	31214	208043	176829	0-3-7-4-8-5-6-2-7-4-2-6-5-2-1	0.0-3.0-7.0-4.0-8.0-5.0-6.0-2.0-7.0-4.0-2.1-6.1-5.1-2.0-1.0	98	179101	210315
NA19240#2#JAHEOL010000010.1_37445323_37853017_0	NA19240	211490	214785	7	17	0	0	16	3295	211338	208043	0-3-7-4-8-5-6-2-7-4-2-6-5-2-1	0.0-3.0-7.0-4.0-8.0-5.0-6.0-2.0-7.0-4.0-2.1-6.1-5.1-2.0-1.0	98	211392	214687
NA19240#2#JAHEOL010000010.1_37445323_37853017_0	NA19240	215848	227391	4	96	0	4	58	11543	222881	211338	0-3-7-4-8-5-6-2-7-4-2-6-5-2-1	0.0-3.0-7.0-4.0-8.0-5.0-6.0-2.0-7.0-4.0-2.1-6.1-5.1-2.0-1.0	98	215750	227293
NA19240#2#JAHEOL010000010.1_37445323_37853017_0	NA19240	229257	260471	2	172	1	171	0	31214	254095	222881	0-3-7-4-8-5-6-2-7-4-2-6-5-2-1	0.0-3.0-7.0-4.0-8.0-5.0-6.0-2.0-7.0-4.0-2.1-6.1-5.1-2.0-1.0	98	229159	260373
NA19240#2#JAHEOL010000010.1_37445323_37853017_0	NA19240	260830	263357	6	24	1	21	1	2527	256622	254095	0-3-7-4-8-5-6-2-7-4-2-6-5-2-1	0.0-3.0-7.0-4.0-8.0-5.0-6.0-2.0-7.0-4.0-2.1-6.1-5.1-2.0-1.0	98	260732	263259
NA19240#2#JAHEOL010000010.1_37445323_37853017_0	NA19240	263964	276144	5	78	1	76	3	12180	268802	256622	0-3-7-4-8-5-6-2-7-4-2-6-5-2-1	0.0-3.0-7.0-4.0-8.0-5.0-6.0-2.0-7.0-4.0-2.1-6.1-5.1-2.0-1.0	98	263866	276046
NA19240#2#JAHEOL010000010.1_37445323_37853017_0	NA19240	276583	304496	2	172	0	15	171	27913	296715	268802	0-3-7-4-8-5-6-2-7-4-2-6-5-2-1	0.0-3.0-7.0-4.0-8.0-5.0-6.0-2.0-7.0-4.0-2.1-6.1-5.1-2.0-1.0	98	276485	304398
NA19240#2#JAHEOL010000010.1_37445323_37853017_0	NA19240	304440	407622	1	612	0	0	611	103182	399897	296715	0-3-7-4-8-5-6-2-7-4-2-6-5-2-1	0.0-3.0-7.0-4.0-8.0-5.0-6.0-2.0-7.0-4.0-2.1-6.1-5.1-2.0-1.0	98	304342	407524
NA20129#2#JAHEPD010000155.1_90039_569275_0	NA20129	98	115404	0	671	0	0	670	115306	115306	0	0-3-7-4-8-5-6-2-7-4-2-6-5-8-4-7-2-5-6-2-1	0.0-3.0-7.0-4.0-8.0-5.0-6.0-2.0-7.0-4.0-2.1-6.1-5.1-8.1-4.1-7.1-2.1-5.0-6.0-2.0-1.0	98	0	115306
NA20129#2#JAHEPD010000155.1_90039_569275_0	NA20129	115495	138315	3	132	0	0	131	22820	138126	115306	0-3-7-4-8-5-6-2-7-4-2-6-5-8-4-7-2-5-6-2-1	0.0-3.0-7.0-4.0-8.0-5.0-6.0-2.0-7.0-4.0-2.1-6.1-5.1-8.1-4.1-7.1-2.1-5.0-6.0-2.0-1.0	98	115397	138217
NA20129#2#JAHEPD010000155.1_90039_569275_0	NA20129	139074	142369	7	17	0	0	16	3295	141421	138126	0-3-7-4-8-5-6-2-7-4-2-6-5-8-4-7-2-5-6-2-1	0.0-3.0-7.0-4.0-8.0-5.0-6.0-2.0-7.0-4.0-2.1-6.1-5.1-8.1-4.1-7.1-2.1-5.0-6.0-2.0-1.0	98	138976	142271
NA20129#2#JAHEPD010000155.1_90039_569275_0	NA20129	142817	161389	4	96	0	0	95	18572	159993	141421	0-3-7-4-8-5-6-2-7-4-2-6-5-8-4-7-2-5-6-2-1	0.0-3.0-7.0-4.0-8.0-5.0-6.0-2.0-7.0-4.0-2.1-6.1-5.1-8.1-4.1-7.1-2.1-5.0-6.0-2.0-1.0	98	142719	161291
NA20129#2#JAHEPD010000155.1_90039_569275_0	NA20129	161333	163103	8	8	0	0	7	1770	161763	159993	0-3-7-4-8-5-6-2-7-4-2-6-5-8-4-7-2-5-6-2-1	0.0-3.0-7.0-4.0-8.0-5.0-6.0-2.0-7.0-4.0-2.1-6.1-5.1-8.1-4.1-7.1-2.1-5.0-6.0-2.0-1.0	98	161235	163005
NA20129#2#JAHEPD010000155.1_90039_569275_0	NA20129	163047	176151	5	78	0	0	77	13104	174867	161763	0-3-7-4-8-5-6-2-7-4-2-6-5-8-4-7-2-5-6-2-1	0.0-3.0-7.0-4.0-8.0-5.0-6.0-2.0-7.0-4.0-2.1-6.1-5.1-8.1-4.1-7.1-2.1-5.0-6.0-2.0-1.0	98	162949	176053
NA20129#2#JAHEPD010000155.1_90039_569275_0	NA20129	176095	178839	6	24	0	0	21	2744	177611	174867	0-3-7-4-8-5-6-2-7-4-2-6-5-8-4-7-2-5-6-2-1	0.0-3.0-7.0-4.0-8.0-5.0-6.0-2.0-7.0-4.0-2.1-6.1-5.1-8.1-4.1-7.1-2.1-5.0-6.0-2.0-1.0	98	175997	178741
NA20129#2#JAHEPD010000155.1_90039_569275_0	NA20129	179198	210421	2	172	0	0	171	31223	208834	177611	0-3-7-4-8-5-6-2-7-4-2-6-5-8-4-7-2-5-6-2-1	0.0-3.0-7.0-4.0-8.0-5.0-6.0-2.0-7.0-4.0-2.1-6.1-5.1-8.1-4.1-7.1-2.1-5.0-6.0-2.0-1.0	98	179100	210323
NA20129#2#JAHEPD010000155.1_90039_569275_0	NA20129	211498	214793	7	17	0	0	16	3295	212129	208834	0-3-7-4-8-5-6-2-7-4-2-6-5-8-4-7-2-5-6-2-1	0.0-3.0-7.0-4.0-8.0-5.0-6.0-2.0-7.0-4.0-2.1-6.1-5.1-8.1-4.1-7.1-2.1-5.0-6.0-2.0-1.0	98	211400	214695
NA20129#2#JAHEPD010000155.1_90039_569275_0	NA20129	215856	227404	4	96	0	4	58	11548	223677	212129	0-3-7-4-8-5-6-2-7-4-2-6-5-8-4-7-2-5-6-2-1	0.0-3.0-7.0-4.0-8.0-5.0-6.0-2.0-7.0-4.0-2.1-6.1-5.1-8.1-4.1-7.1-2.1-5.0-6.0-2.0-1.0	98	215758	227306
NA20129#2#JAHEPD010000155.1_90039_569275_0	NA20129	229270	260487	2	172	1	171	0	31217	254894	223677	0-3-7-4-8-5-6-2-7-4-2-6-5-8-4-7-2-5-6-2-1	0.0-3.0-7.0-4.0-8.0-5.0-6.0-2.0-7.0-4.0-2.1-6.1-5.1-8.1-4.1-7.1-2.1-5.0-6.0-2.0-1.0	98	229172	260389
NA20129#2#JAHEPD010000155.1_90039_569275_0	NA20129	260846	263590	6	24	1	21	0	2744	257638	254894	0-3-7-4-8-5-6-2-7-4-2-6-5-8-4-7-2-5-6-2-1	0.0-3.0-7.0-4.0-8.0-5.0-6.0-2.0-7.0-4.0-2.1-6.1-5.1-8.1-4.1-7.1-2.1-5.0-6.0-2.0-1.0	98	260748	263492
NA20129#2#JAHEPD010000155.1_90039_569275_0	NA20129	263534	276638	5	78	1	77	0	13104	270742	257638	0-3-7-4-8-5-6-2-7-4-2-6-5-8-4-7-2-5-6-2-1	0.0-3.0-7.0-4.0-8.0-5.0-6.0-2.0-7.0-4.0-2.1-6.1-5.1-8.1-4.1-7.1-2.1-5.0-6.0-2.0-1.0	98	263436	276540
NA20129#2#JAHEPD010000155.1_90039_569275_0	NA20129	276826	278352	8	8	1	6	0	1526	272268	270742	0-3-7-4-8-5-6-2-7-4-2-6-5-8-4-7-2-5-6-2-1	0.0-3.0-7.0-4.0-8.0-5.0-6.0-2.0-7.0-4.0-2.1-6.1-5.1-8.1-4.1-7.1-2.1-5.0-6.0-2.0-1.0	98	276728	278254
NA20129#2#JAHEPD010000155.1_90039_569275_0	NA20129	278296	296867	4	96	1	95	0	18571	290839	272268	0-3-7-4-8-5-6-2-7-4-2-6-5-8-4-7-2-5-6-2-1	0.0-3.0-7.0-4.0-8.0-5.0-6.0-2.0-7.0-4.0-2.1-6.1-5.1-8.1-4.1-7.1-2.1-5.0-6.0-2.0-1.0	98	278198	296769
NA20129#2#JAHEPD010000155.1_90039_569275_0	NA20129	297315	300610	7	17	1	16	0	3295	294134	290839	0-3-7-4-8-5-6-2-7-4-2-6-5-8-4-7-2-5-6-2-1	0.0-3.0-7.0-4.0-8.0-5.0-6.0-2.0-7.0-4.0-2.1-6.1-5.1-8.1-4.1-7.1-2.1-5.0-6.0-2.0-1.0	98	297217	300512
NA20129#2#JAHEPD010000155.1_90039_569275_0	NA20129	301687	329426	2	172	1	171	16	27739	321873	294134	0-3-7-4-8-5-6-2-7-4-2-6-5-8-4-7-2-5-6-2-1	0.0-3.0-7.0-4.0-8.0-5.0-6.0-2.0-7.0-4.0-2.1-6.1-5.1-8.1-4.1-7.1-2.1-5.0-6.0-2.0-1.0	98	301589	329328
NA20129#2#JAHEPD010000155.1_90039_569275_0	NA20129	330046	342226	5	78	0	3	76	12180	334053	321873	0-3-7-4-8-5-6-2-7-4-2-6-5-8-4-7-2-5-6-2-1	0.0-3.0-7.0-4.0-8.0-5.0-6.0-2.0-7.0-4.0-2.1-6.1-5.1-8.1-4.1-7.1-2.1-5.0-6.0-2.0-1.0	98	329948	342128
NA20129#2#JAHEPD010000155.1_90039_569275_0	NA20129	342833	345360	6	24	0	1	21	2527	336580	334053	0-3-7-4-8-5-6-2-7-4-2-6-5-8-4-7-2-5-6-2-1	0.0-3.0-7.0-4.0-8.0-5.0-6.0-2.0-7.0-4.0-2.1-6.1-5.1-8.1-4.1-7.1-2.1-5.0-6.0-2.0-1.0	98	342735	345262
NA20129#2#JAHEPD010000155.1_90039_569275_0	NA20129	345719	376935	2	172	0	0	171	31216	367796	336580	0-3-7-4-8-5-6-2-7-4-2-6-5-8-4-7-2-5-6-2-1	0.0-3.0-7.0-4.0-8.0-5.0-6.0-2.0-7.0-4.0-2.1-6.1-5.1-8.1-4.1-7.1-2.1-5.0-6.0-2.0-1.0	98	345621	376837
NA20129#2#JAHEPD010000155.1_90039_569275_0	NA20129	376879	479292	1	612	0	0	606	102413	470209	367796	0-3-7-4-8-5-6-2-7-4-2-6-5-8-4-7-2-5-6-2-1	0.0-3.0-7.0-4.0-8.0-5.0-6.0-2.0-7.0-4.0-2.1-6.1-5.1-8.1-4.1-7.1-2.1-5.0-6.0-2.0-1.0	98	376781	479194
chr1_chm13_103304997_103901127_0	chr1_chm13_103304997_103901127_0	99	115472	0	671	0	0	670	115373	115373	0	0-3-7-4-8-5-6-2-4-7-2-6-5-2-4-7-2-5-6-2-4-7-2-5-6-2-1	0.0-3.0-7.0-4.0-8.0-5.0-6.0-2.0-4.1-7.1-2.1-6.1-5.1-2.0-4.1-7.1-2.1-5.0-6.0-2.0-4.1-7.1-2.1-5.0-6.0-2.0-1.0	99	0	115373
chr1_chm13_103304997_103901127_0	chr1_chm13_103304997_103901127_0	115563	138400	3	132	0	0	131	22837	138210	115373	0-3-7-4-8-5-6-2-4-7-2-6-5-2-4-7-2-5-6-2-4-7-2-5-6-2-1	0.0-3.0-7.0-4.0-8.0-5.0-6.0-2.0-4.1-7.1-2.1-6.1-5.1-2.0-4.1-7.1-2.1-5.0-6.0-2.0-4.1-7.1-2.1-5.0-6.0-2.0-1.0	99	115464	138301
chr1_chm13_103304997_103901127_0	chr1_chm13_103304997_103901127_0	139159	142455	7	17	0	0	16	3296	141506	138210	0-3-7-4-8-5-6-2-4-7-2-6-5-2-4-7-2-5-6-2-4-7-2-5-6-2-1	0.0-3.0-7.0-4.0-8.0-5.0-6.0-2.0-4.1-7.1-2.1-6.1-5.1-2.0-4.1-7.1-2.1-5.0-6.0-2.0-4.1-7.1-2.1-5.0-6.0-2.0-1.0	99	139060	142356
chr1_chm13_103304997_103901127_0	chr1_chm13_103304997_103901127_0	143249	161460	4	96	0	1	95	18211	159717	141506	0-3-7-4-8-5-6-2-4-7-2-6-5-2-4-7-2-5-6-2-4-7-2-5-6-2-1	0.0-3.0-7.0-4.0-8.0-5.0-6.0-2.0-4.1-7.1-2.1-6.1-5.1-2.0-4.1-7.1-2.1-5.0-6.0-2.0-4.1-7.1-2.1-5.0-6.0-2.0-1.0	99	143150	161361
chr1_chm13_103304997_103901127_0	chr1_chm13_103304997_103901127_0	161404	163174	8	8	0	0	7	1770	161487	159717	0-3-7-4-8-5-6-2-4-7-2-6-5-2-4-7-2-5-6-2-4-7-2-5-6-2-1	0.0-3.0-7.0-4.0-8.0-5.0-6.0-2.0-4.1-7.1-2.1-6.1-5.1-2.0-4.1-7.1-2.1-5.0-6.0-2.0-4.1-7.1-2.1-5.0-6.0-2.0-1.0	99	161305	163075
chr1_chm13_103304997_103901127_0	chr1_chm13_103304997_103901127_0	163118	176222	5	78	0	0	77	13104	174591	161487	0-3-7-4-8-5-6-2-4-7-2-6-5-2-4-7-2-5-6-2-4-7-2-5-6-2-1	0.0-3.0-7.0-4.0-8.0-5.0-6.0-2.0-4.1-7.1-2.1-6.1-5.1-2.0-4.1-7.1-2.1-5.0-6.0-2.0-4.1-7.1-2.1-5.0-6.0-2.0-1.0	99	163019	176123
chr1_chm13_103304997_103901127_0	chr1_chm13_103304997_103901127_0	176166	178910	6	24	0	0	21	2744	177335	174591	0-3-7-4-8-5-6-2-4-7-2-6-5-2-4-7-2-5-6-2-4-7-2-5-6-2-1	0.0-3.0-7.0-4.0-8.0-5.0-6.0-2.0-4.1-7.1-2.1-6.1-5.1-2.0-4.1-7.1-2.1-5.0-6.0-2.0-4.1-7.1-2.1-5.0-6.0-2.0-1.0	99	176067	178811
chr1_chm13_103304997_103901127_0	chr1_chm13_103304997_103901127_0	179269	210101	2	172	0	0	170	30832	208167	177335	0-3-7-4-8-5-6-2-4-7-2-6-5-2-4-7-2-5-6-2-4-7-2-5-6-2-1	0.0-3.0-7.0-4.0-8.0-5.0-6.0-2.0-4.1-7.1-2.1-6.1-5.1-2.0-4.1-7.1-2.1-5.0-6.0-2.0-4.1-7.1-2.1-5.0-6.0-2.0-1.0	99	179170	210002
chr1_chm13_103304997_103901127_0	chr1_chm13_103304997_103901127_0	212352	224166	4	96	1	58	1	11814	219981	208167	0-3-7-4-8-5-6-2-4-7-2-6-5-2-4-7-2-5-6-2-4-7-2-5-6-2-1	0.0-3.0-7.0-4.0-8.0-5.0-6.0-2.0-4.1-7.1-2.1-6.1-5.1-2.0-4.1-7.1-2.1-5.0-6.0-2.0-4.1-7.1-2.1-5.0-6.0-2.0-1.0	99	212253	224067
chr1_chm13_103304997_103901127_0	chr1_chm13_103304997_103901127_0	224960	228256	7	17	1	16	0	3296	223277	219981	0-3-7-4-8-5-6-2-4-7-2-6-5-2-4-7-2-5-6-2-4-7-2-5-6-2-1	0.0-3.0-7.0-4.0-8.0-5.0-6.0-2.0-4.1-7.1-2.1-6.1-5.1-2.0-4.1-7.1-2.1-5.0-6.0-2.0-4.1-7.1-2.1-5.0-6.0-2.0-1.0	99	224861	228157
chr1_chm13_103304997_103901127_0	chr1_chm13_103304997_103901127_0	229718	260554	2	172	1	170	0	30836	254113	223277	0-3-7-4-8-5-6-2-4-7-2-6-5-2-4-7-2-5-6-2-4-7-2-5-6-2-1	0.0-3.0-7.0-4.0-8.0-5.0-6.0-2.0-4.1-7.1-2.1-6.1-5.1-2.0-4.1-7.1-2.1-5.0-6.0-2.0-4.1-7.1-2.1-5.0-6.0-2.0-1.0	99	229619	260455
chr1_chm13_103304997_103901127_0	chr1_chm13_103304997_103901127_0	260930	263674	6	24	1	21	0	2744	256857	254113	0-3-7-4-8-5-6-2-4-7-2-6-5-2-4-7-2-5-6-2-4-7-2-5-6-2-1	0.0-3.0-7.0-4.0-8.0-5.0-6.0-2.0-4.1-7.1-2.1-6.1-5.1-2.0-4.1-7.1-2.1-5.0-6.0-2.0-4.1-7.1-2.1-5.0-6.0-2.0-1.0	99	260831	263575
chr1_chm13_103304997_103901127_0	chr1_chm13_103304997_103901127_0	263618	275746	5	78	1	77	5	12128	268985	256857	0-3-7-4-8-5-6-2-4-7-2-6-5-2-4-7-2-5-6-2-4-7-2-5-6-2-1	0.0-3.0-7.0-4.0-8.0-5.0-6.0-2.0-4.1-7.1-2.1-6.1-5.1-2.0-4.1-7.1-2.1-5.0-6.0-2.0-4.1-7.1-2.1-5.0-6.0-2.0-1.0	99	263519	275647
chr1_chm13_103304997_103901127_0	chr1_chm13_103304997_103901127_0	276712	303901	2	172	0	15	167	27189	296174	268985	0-3-7-4-8-5-6-2-4-7-2-6-5-2-4-7-2-5-6-2-4-7-2-5-6-2-1	0.0-3.0-7.0-4.0-8.0-5.0-6.0-2.0-4.1-7.1-2.1-6.1-5.1-2.0-4.1-7.1-2.1-5.0-6.0-2.0-4.1-7.1-2.1-5.0-6.0-2.0-1.0	99	276613	303802
chr1_chm13_103304997_103901127_0	chr1_chm13_103304997_103901127_0	306493	317620	4	96	1	58	6	11127	307301	296174	0-3-7-4-8-5-6-2-4-7-2-6-5-2-4-7-2-5-6-2-4-7-2-5-6-2-1	0.0-3.0-7.0-4.0-8.0-5.0-6.0-2.0-4.1-7.1-2.1-6.1-5.1-2.0-4.1-7.1-2.1-5.0-6.0-2.0-4.1-7.1-2.1-5.0-6.0-2.0-1.0	99	306394	317521
chr1_chm13_103304997_103901127_0	chr1_chm13_103304997_103901127_0	319107	322402	7	17	1	16	0	3295	310596	307301	0-3-7-4-8-5-6-2-4-7-2-6-5-2-4-7-2-5-6-2-4-7-2-5-6-2-1	0.0-3.0-7.0-4.0-8.0-5.0-6.0-2.0-4.1-7.1-2.1-6.1-5.1-2.0-4.1-7.1-2.1-5.0-6.0-2.0-4.1-7.1-2.1-5.0-6.0-2.0-1.0	99	319008	322303
chr1_chm13_103304997_103901127_0	chr1_chm13_103304997_103901127_0	323864	351396	2	172	1	170	15	27532	338128	310596	0-3-7-4-8-5-6-2-4-7-2-6-5-2-4-7-2-5-6-2-4-7-2-5-6-2-1	0.0-3.0-7.0-4.0-8.0-5.0-6.0-2.0-4.1-7.1-2.1-6.1-5.1-2.0-4.1-7.1-2.1-5.0-6.0-2.0-4.1-7.1-2.1-5.0-6.0-2.0-1.0	99	323765	351297
chr1_chm13_103304997_103901127_0	chr1_chm13_103304997_103901127_0	352843	364050	5	78	0	8	76	11207	349335	338128	0-3-7-4-8-5-6-2-4-7-2-6-5-2-4-7-2-5-6-2-4-7-2-5-6-2-1	0.0-3.0-7.0-4.0-8.0-5.0-6.0-2.0-4.1-7.1-2.1-6.1-5.1-2.0-4.1-7.1-2.1-5.0-6.0-2.0-4.1-7.1-2.1-5.0-6.0-2.0-1.0	99	352744	363951
chr1_chm13_103304997_103901127_0	chr1_chm13_103304997_103901127_0	364657	367184	6	24	0	1	21	2527	351862	349335	0-3-7-4-8-5-6-2-4-7-2-6-5-2-4-7-2-5-6-2-4-7-2-5-6-2-1	0.0-3.0-7.0-4.0-8.0-5.0-6.0-2.0-4.1-7.1-2.1-6.1-5.1-2.0-4.1-7.1-2.1-5.0-6.0-2.0-4.1-7.1-2.1-5.0-6.0-2.0-1.0	99	364558	367085
chr1_chm13_103304997_103901127_0	chr1_chm13_103304997_103901127_0	367542	398034	2	172	0	0	167	30492	382354	351862	0-3-7-4-8-5-6-2-4-7-2-6-5-2-4-7-2-5-6-2-4-7-2-5-6-2-1	0.0-3.0-7.0-4.0-8.0-5.0-6.0-2.0-4.1-7.1-2.1-6.1-5.1-2.0-4.1-7.1-2.1-5.0-6.0-2.0-4.1-7.1-2.1-5.0-6.0-2.0-1.0	99	367443	397935
chr1_chm13_103304997_103901127_0	chr1_chm13_103304997_103901127_0	400626	412170	4	96	1	58	4	11544	393898	382354	0-3-7-4-8-5-6-2-4-7-2-6-5-2-4-7-2-5-6-2-4-7-2-5-6-2-1	0.0-3.0-7.0-4.0-8.0-5.0-6.0-2.0-4.1-7.1-2.1-6.1-5.1-2.0-4.1-7.1-2.1-5.0-6.0-2.0-4.1-7.1-2.1-5.0-6.0-2.0-1.0	99	400527	412071
chr1_chm13_103304997_103901127_0	chr1_chm13_103304997_103901127_0	413239	416534	7	17	1	16	0	3295	397193	393898	0-3-7-4-8-5-6-2-4-7-2-6-5-2-4-7-2-5-6-2-4-7-2-5-6-2-1	0.0-3.0-7.0-4.0-8.0-5.0-6.0-2.0-4.1-7.1-2.1-6.1-5.1-2.0-4.1-7.1-2.1-5.0-6.0-2.0-4.1-7.1-2.1-5.0-6.0-2.0-1.0	99	413140	416435
chr1_chm13_103304997_103901127_0	chr1_chm13_103304997_103901127_0	417996	445526	2	172	1	170	15	27530	424723	397193	0-3-7-4-8-5-6-2-4-7-2-6-5-2-4-7-2-5-6-2-4-7-2-5-6-2-1	0.0-3.0-7.0-4.0-8.0-5.0-6.0-2.0-4.1-7.1-2.1-6.1-5.1-2.0-4.1-7.1-2.1-5.0-6.0-2.0-4.1-7.1-2.1-5.0-6.0-2.0-1.0	99	417897	445427
chr1_chm13_103304997_103901127_0	chr1_chm13_103304997_103901127_0	446973	458180	5	78	0	8	76	11207	435930	424723	0-3-7-4-8-5-6-2-4-7-2-6-5-2-4-7-2-5-6-2-4-7-2-5-6-2-1	0.0-3.0-7.0-4.0-8.0-5.0-6.0-2.0-4.1-7.1-2.1-6.1-5.1-2.0-4.1-7.1-2.1-5.0-6.0-2.0-4.1-7.1-2.1-5.0-6.0-2.0-1.0	99	446874	458081
chr1_chm13_103304997_103901127_0	chr1_chm13_103304997_103901127_0	458787	461314	6	24	0	1	21	2527	438457	435930	0-3-7-4-8-5-6-2-4-7-2-6-5-2-4-7-2-5-6-2-4-7-2-5-6-2-1	0.0-3.0-7.0-4.0-8.0-5.0-6.0-2.0-4.1-7.1-2.1-6.1-5.1-2.0-4.1-7.1-2.1-5.0-6.0-2.0-4.1-7.1-2.1-5.0-6.0-2.0-1.0	99	458688	461215
chr1_chm13_103304997_103901127_0	chr1_chm13_103304997_103901127_0	461672	492896	2	172	0	0	171	31224	469681	438457	0-3-7-4-8-5-6-2-4-7-2-6-5-2-4-7-2-5-6-2-4-7-2-5-6-2-1	0.0-3.0-7.0-4.0-8.0-5.0-6.0-2.0-4.1-7.1-2.1-6.1-5.1-2.0-4.1-7.1-2.1-5.0-6.0-2.0-4.1-7.1-2.1-5.0-6.0-2.0-1.0	99	461573	492797
chr1_chm13_103304997_103901127_0	chr1_chm13_103304997_103901127_0	492840	596058	1	612	0	0	611	103218	572899	469681	0-3-7-4-8-5-6-2-4-7-2-6-5-2-4-7-2-5-6-2-4-7-2-5-6-2-1	0.0-3.0-7.0-4.0-8.0-5.0-6.0-2.0-4.1-7.1-2.1-6.1-5.1-2.0-4.1-7.1-2.1-5.0-6.0-2.0-4.1-7.1-2.1-5.0-6.0-2.0-1.0	99	492741	595959
chr1_hg38_103456064_103863972_0	chr1_hg38_103456064_103863972_0	99	115462	0	671	0	0	670	115363	115363	0	0-3-7-4-8-5-6-2-4-7-2-5-6-2-1	0.0-3.0-7.0-4.0-8.0-5.0-6.0-2.0-4.1-7.1-2.1-5.0-6.0-2.0-1.0	99	0	115363
chr1_hg38_103456064_103863972_0	chr1_hg38_103456064_103863972_0	115553	138389	3	132	0	0	131	22836	138199	115363	0-3-7-4-8-5-6-2-4-7-2-5-6-2-1	0.0-3.0-7.0-4.0-8.0-5.0-6.0-2.0-4.1-7.1-2.1-5.0-6.0-2.0-1.0	99	115454	138290
chr1_hg38_103456064_103863972_0	chr1_hg38_103456064_103863972_0	139148	142444	7	17	0	0	16	3296	141495	138199	0-3-7-4-8-5-6-2-4-7-2-5-6-2-1	0.0-3.0-7.0-4.0-8.0-5.0-6.0-2.0-4.1-7.1-2.1-5.0-6.0-2.0-1.0	99	139049	142345
chr1_hg38_103456064_103863972_0	chr1_hg38_103456064_103863972_0	142892	161447	4	96	0	0	95	18555	160050	141495	0-3-7-4-8-5-6-2-4-7-2-5-6-2-1	0.0-3.0-7.0-4.0-8.0-5.0-6.0-2.0-4.1-7.1-2.1-5.0-6.0-2.0-1.0	99	142793	161348
chr1_hg38_103456064_103863972_0	chr1_hg38_103456064_103863972_0	161391	163161	8	8	0	0	7	1770	161820	160050	0-3-7-4-8-5-6-2-4-7-2-5-6-2-1	0.0-3.0-7.0-4.0-8.0-5.0-6.0-2.0-4.1-7.1-2.1-5.0-6.0-2.0-1.0	99	161292	163062
chr1_hg38_103456064_103863972_0	chr1_hg38_103456064_103863972_0	163105	176288	5	78	0	0	77	13183	175003	161820	0-3-7-4-8-5-6-2-4-7-2-5-6-2-1	0.0-3.0-7.0-4.0-8.0-5.0-6.0-2.0-4.1-7.1-2.1-5.0-6.0-2.0-1.0	99	163006	176189
chr1_hg38_103456064_103863972_0	chr1_hg38_103456064_103863972_0	176232	178976	6	24	0	0	21	2744	177747	175003	0-3-7-4-8-5-6-2-4-7-2-5-6-2-1	0.0-3.0-7.0-4.0-8.0-5.0-6.0-2.0-4.1-7.1-2.1-5.0-6.0-2.0-1.0	99	176133	178877
chr1_hg38_103456064_103863972_0	chr1_hg38_103456064_103863972_0	179334	210167	2	172	0	0	170	30833	208580	177747	0-3-7-4-8-5-6-2-4-7-2-5-6-2-1	0.0-3.0-7.0-4.0-8.0-5.0-6.0-2.0-4.1-7.1-2.1-5.0-6.0-2.0-1.0	99	179235	210068
chr1_hg38_103456064_103863972_0	chr1_hg38_103456064_103863972_0	212418	223963	4	96	1	58	4	11545	220125	208580	0-3-7-4-8-5-6-2-4-7-2-5-6-2-1	0.0-3.0-7.0-4.0-8.0-5.0-6.0-2.0-4.1-7.1-2.1-5.0-6.0-2.0-1.0	99	212319	223864
chr1_hg38_103456064_103863972_0	chr1_hg38_103456064_103863972_0	225028	228323	7	17	1	16	0	3295	223420	220125	0-3-7-4-8-5-6-2-4-7-2-5-6-2-1	0.0-3.0-7.0-4.0-8.0-5.0-6.0-2.0-4.1-7.1-2.1-5.0-6.0-2.0-1.0	99	224929	228224
chr1_hg38_103456064_103863972_0	chr1_hg38_103456064_103863972_0	229785	257319	2	172	1	170	15	27534	250954	223420	0-3-7-4-8-5-6-2-4-7-2-5-6-2-1	0.0-3.0-7.0-4.0-8.0-5.0-6.0-2.0-4.1-7.1-2.1-5.0-6.0-2.0-1.0	99	229686	257220
chr1_hg38_103456064_103863972_0	chr1_hg38_103456064_103863972_0	258285	270413	5	78	0	5	77	12128	263082	250954	0-3-7-4-8-5-6-2-4-7-2-5-6-2-1	0.0-3.0-7.0-4.0-8.0-5.0-6.0-2.0-4.1-7.1-2.1-5.0-6.0-2.0-1.0	99	258186	270314
chr1_hg38_103456064_103863972_0	chr1_hg38_103456064_103863972_0	270357	273101	6	24	0	0	21	2744	265826	263082	0-3-7-4-8-5-6-2-4-7-2-5-6-2-1	0.0-3.0-7.0-4.0-8.0-5.0-6.0-2.0-4.1-7.1-2.1-5.0-6.0-2.0-1.0	99	270258	273002
chr1_hg38_103456064_103863972_0	chr1_hg38_103456064_103863972_0	273476	304690	2	172	0	0	171	31214	297040	265826	0-3-7-4-8-5-6-2-4-7-2-5-6-2-1	0.0-3.0-7.0-4.0-8.0-5.0-6.0-2.0-4.1-7.1-2.1-5.0-6.0-2.0-1.0	99	273377	304591
chr1_hg38_103456064_103863972_0	chr1_hg38_103456064_103863972_0	304634	407836	1	612	0	0	611	103202	400242	297040	0-3-7-4-8-5-6-2-4-7-2-5-6-2-1	0.0-3.0-7.0-4.0-8.0-5.0-6.0-2.0-4.1-7.1-2.1-5.0-6.0-2.0-1.0	99	304535	407737
