"qname"	"qlen"	"qstart"	"qend"	"strand"	"tname"	"tlen"	"tstart"	"tend"	"nmatch"	"alen"	"mapq"	"tp"	"cm"	"s1"	"s2"	"dv"	"rl"	"contig"	"name2"	"name"	"hap_struc"	"hap_struc_d"	"hap_block_start"	"chrom"	"start"	"end"
"ENST00000370083.9"	1785	2	1784	"-"	"HG002#1#JAHKSE010000012.1_16776806_17183707_1"	406901	231373	240166	1769	8793	0	"P"	557	1686	1686	1e-04	0	"HG002#1#JAHKSE010000012.1_16776806_17183707_1"	"AMY1A-201"	"1"	"1-2-5-2-4-2-5-4-3-0"	"1.0-2.0-5.1-2.1-4.1-2.0-5.0-4.0-3.0-0.0"	16776960	"HG002#1#JAHKSE010000012.1_16776806_17183707_1"	231373	240166
"ENST00000370083.9"	1785	2	1784	"+"	"HG002#1#JAHKSE010000012.1_16776806_17183707_1"	406901	199718	208510	1769	8792	0	"S"	557	1686	NA	1e-04	0	"HG002#1#JAHKSE010000012.1_16776806_17183707_1"	"AMY1A-201"	"1"	"1-2-5-2-4-2-5-4-3-0"	"1.0-2.0-5.1-2.1-4.1-2.0-5.0-4.0-3.0-0.0"	16776960	"HG002#1#JAHKSE010000012.1_16776806_17183707_1"	199718	208510
"ENST00000370083.9"	1785	2	1784	"+"	"HG002#1#JAHKSE010000012.1_16776806_17183707_1"	406901	293848	302639	1769	8791	0	"S"	557	1686	NA	1e-04	0	"HG002#1#JAHKSE010000012.1_16776806_17183707_1"	"AMY1A-201"	"1"	"1-2-5-2-4-2-5-4-3-0"	"1.0-2.0-5.1-2.1-4.1-2.0-5.0-4.0-3.0-0.0"	16776960	"HG002#1#JAHKSE010000012.1_16776806_17183707_1"	293848	302639
"ENST00000414303.7"	1584	4	1583	"+"	"HG002#1#JAHKSE010000012.1_16776806_17183707_1"	406901	161424	169729	1563	8305	28	"P"	488	1488	1342	5e-04	0	"HG002#1#JAHKSE010000012.1_16776806_17183707_1"	"AMY2A-201"	"2A"	"1-2-5-2-4-2-5-4-3-0"	"1.0-2.0-5.1-2.1-4.1-2.0-5.0-4.0-3.0-0.0"	16776960	"HG002#1#JAHKSE010000012.1_16776806_17183707_1"	161424	169729
"ENST00000610648.1"	1736	4	1733	"+"	"HG002#1#JAHKSE010000012.1_16776806_17183707_1"	406901	115091	123513	1720	8422	48	"P"	531	1638	1371	1e-04	0	"HG002#1#JAHKSE010000012.1_16776806_17183707_1"	"AMY2B-208"	"2B"	"1-2-5-2-4-2-5-4-3-0"	"1.0-2.0-5.1-2.1-4.1-2.0-5.0-4.0-3.0-0.0"	16776960	"HG002#1#JAHKSE010000012.1_16776806_17183707_1"	115091	123513
"ENST00000370083.9"	1785	2	1784	"-"	"HG002#2#JAHKSD010000021.1_102757493_103165350_0"	407857	231292	240085	1769	8793	0	"P"	557	1686	1686	2e-04	0	"HG002#2#JAHKSD010000021.1_102757493_103165350_0"	"AMY1A-201"	"1"	"1-2-5-2-6-4-2-5-4-3-0"	"1.0-2.0-5.0-2.1-6.1-4.1-2.0-5.0-4.0-3.0-0.0"	102757591	"HG002#2#JAHKSD010000021.1_102757493_103165350_0"	231292	240085
"ENST00000370083.9"	1785	2	1784	"+"	"HG002#2#JAHKSD010000021.1_102757493_103165350_0"	407857	293763	302554	1769	8791	0	"S"	558	1686	NA	1e-04	0	"HG002#2#JAHKSD010000021.1_102757493_103165350_0"	"AMY1A-201"	"1"	"1-2-5-2-6-4-2-5-4-3-0"	"1.0-2.0-5.0-2.1-6.1-4.1-2.0-5.0-4.0-3.0-0.0"	102757591	"HG002#2#JAHKSD010000021.1_102757493_103165350_0"	293763	302554
"ENST00000370083.9"	1785	2	1784	"+"	"HG002#2#JAHKSD010000021.1_102757493_103165350_0"	407857	199626	208419	1769	8793	0	"S"	557	1686	NA	2e-04	0	"HG002#2#JAHKSD010000021.1_102757493_103165350_0"	"AMY1A-201"	"1"	"1-2-5-2-6-4-2-5-4-3-0"	"1.0-2.0-5.0-2.1-6.1-4.1-2.0-5.0-4.0-3.0-0.0"	102757591	"HG002#2#JAHKSD010000021.1_102757493_103165350_0"	199626	208419
"ENST00000414303.7"	1584	4	1583	"+"	"HG002#2#JAHKSD010000021.1_102757493_103165350_0"	407857	161376	169646	1574	8270	30	"P"	491	1499	1342	3e-04	0	"HG002#2#JAHKSD010000021.1_102757493_103165350_0"	"AMY2A-201"	"2A"	"1-2-5-2-6-4-2-5-4-3-0"	"1.0-2.0-5.0-2.1-6.1-4.1-2.0-5.0-4.0-3.0-0.0"	102757591	"HG002#2#JAHKSD010000021.1_102757493_103165350_0"	161376	169646
"ENST00000610648.1"	1736	4	1733	"+"	"HG002#2#JAHKSD010000021.1_102757493_103165350_0"	407857	115050	123472	1720	8422	48	"P"	531	1638	1371	3e-04	0	"HG002#2#JAHKSD010000021.1_102757493_103165350_0"	"AMY2B-208"	"2B"	"1-2-5-2-6-4-2-5-4-3-0"	"1.0-2.0-5.0-2.1-6.1-4.1-2.0-5.0-4.0-3.0-0.0"	102757591	"HG002#2#JAHKSD010000021.1_102757493_103165350_0"	115050	123472
"ENST00000370083.9"	1785	2	1784	"-"	"HG00438#1#JAHBCB010000015.1_33474867_33954171_0"	479304	303685	312476	1769	8791	0	"P"	557	1686	1686	1e-04	0	"HG00438#1#JAHBCB010000015.1_33474867_33954171_0"	"AMY1A-201"	"1"	"1-2-5-2-4-5-2-4-2-5-4-3-0"	"1.0-2.0-5.1-2.1-4.1-5.1-2.1-4.1-2.0-5.0-4.0-3.0-0.0"	33474965	"HG00438#1#JAHBCB010000015.1_33474867_33954171_0"	303685	312476
"ENST00000370083.9"	1785	2	1784	"+"	"HG00438#1#JAHBCB010000015.1_33474867_33954171_0"	479304	366163	374956	1769	8793	0	"S"	557	1686	NA	1e-04	0	"HG00438#1#JAHBCB010000015.1_33474867_33954171_0"	"AMY1A-201"	"1"	"1-2-5-2-4-5-2-4-2-5-4-3-0"	"1.0-2.0-5.1-2.1-4.1-5.1-2.1-4.1-2.0-5.0-4.0-3.0-0.0"	33474965	"HG00438#1#JAHBCB010000015.1_33474867_33954171_0"	366163	374956
"ENST00000370083.9"	1785	2	1784	"-"	"HG00438#1#JAHBCB010000015.1_33474867_33954171_0"	479304	231273	240064	1769	8791	0	"S"	557	1686	NA	1e-04	0	"HG00438#1#JAHBCB010000015.1_33474867_33954171_0"	"AMY1A-201"	"1"	"1-2-5-2-4-5-2-4-2-5-4-3-0"	"1.0-2.0-5.1-2.1-4.1-5.1-2.1-4.1-2.0-5.0-4.0-3.0-0.0"	33474965	"HG00438#1#JAHBCB010000015.1_33474867_33954171_0"	231273	240064
"ENST00000370083.9"	1785	2	1784	"+"	"HG00438#1#JAHBCB010000015.1_33474867_33954171_0"	479304	199618	208411	1769	8793	0	"S"	557	1686	NA	1e-04	0	"HG00438#1#JAHBCB010000015.1_33474867_33954171_0"	"AMY1A-201"	"1"	"1-2-5-2-4-5-2-4-2-5-4-3-0"	"1.0-2.0-5.1-2.1-4.1-5.1-2.1-4.1-2.0-5.0-4.0-3.0-0.0"	33474965	"HG00438#1#JAHBCB010000015.1_33474867_33954171_0"	199618	208411
"ENST00000414303.7"	1584	4	1583	"-"	"HG00438#1#JAHBCB010000015.1_33474867_33954171_0"	479304	270047	278317	1574	8270	0	"P"	491	1499	1499	1e-04	0	"HG00438#1#JAHBCB010000015.1_33474867_33954171_0"	"AMY2A-201"	"2A"	"1-2-5-2-4-5-2-4-2-5-4-3-0"	"1.0-2.0-5.1-2.1-4.1-5.1-2.1-4.1-2.0-5.0-4.0-3.0-0.0"	33474965	"HG00438#1#JAHBCB010000015.1_33474867_33954171_0"	270047	278317
"ENST00000414303.7"	1584	4	1583	"+"	"HG00438#1#JAHBCB010000015.1_33474867_33954171_0"	479304	161365	169635	1574	8270	0	"S"	491	1499	NA	1e-04	0	"HG00438#1#JAHBCB010000015.1_33474867_33954171_0"	"AMY2A-201"	"2A"	"1-2-5-2-4-5-2-4-2-5-4-3-0"	"1.0-2.0-5.1-2.1-4.1-5.1-2.1-4.1-2.0-5.0-4.0-3.0-0.0"	33474965	"HG00438#1#JAHBCB010000015.1_33474867_33954171_0"	161365	169635
"ENST00000610648.1"	1736	4	1733	"+"	"HG00438#1#JAHBCB010000015.1_33474867_33954171_0"	479304	115030	123452	1720	8422	40	"P"	531	1638	1414	1e-04	0	"HG00438#1#JAHBCB010000015.1_33474867_33954171_0"	"AMY2B-208"	"2B"	"1-2-5-2-4-5-2-4-2-5-4-3-0"	"1.0-2.0-5.1-2.1-4.1-5.1-2.1-4.1-2.0-5.0-4.0-3.0-0.0"	33474965	"HG00438#1#JAHBCB010000015.1_33474867_33954171_0"	115030	123452
"ENST00000370083.9"	1785	2	1784	"+"	"HG00438#2#JAHBCA010000012.1_51513023_51826723_0"	313700	199617	208409	1769	8792	49	"P"	557	1686	1404	1e-04	0	"HG00438#2#JAHBCA010000012.1_51513023_51826723_0"	"AMY1A-201"	"1"	"1-2-5-4-3-0"	"1.0-2.0-5.0-4.0-3.0-0.0"	51513122	"HG00438#2#JAHBCA010000012.1_51513023_51826723_0"	199617	208409
"ENST00000414303.7"	1584	4	1583	"+"	"HG00438#2#JAHBCA010000012.1_51513023_51826723_0"	313700	161354	169624	1574	8270	30	"P"	491	1499	1342	1e-04	0	"HG00438#2#JAHBCA010000012.1_51513023_51826723_0"	"AMY2A-201"	"2A"	"1-2-5-4-3-0"	"1.0-2.0-5.0-4.0-3.0-0.0"	51513122	"HG00438#2#JAHBCA010000012.1_51513023_51826723_0"	161354	169624
"ENST00000610648.1"	1736	4	1733	"+"	"HG00438#2#JAHBCA010000012.1_51513023_51826723_0"	313700	115025	123449	1720	8424	50	"P"	531	1638	1358	1e-04	0	"HG00438#2#JAHBCA010000012.1_51513023_51826723_0"	"AMY2B-208"	"2B"	"1-2-5-4-3-0"	"1.0-2.0-5.0-4.0-3.0-0.0"	51513122	"HG00438#2#JAHBCA010000012.1_51513023_51826723_0"	115025	123449
"ENST00000370083.9"	1785	2	1784	"-"	"HG005#1#JAHEPO010000002.1_51519219_51926067_0"	406848	231268	240060	1769	8792	0	"P"	557	1686	1686	1e-04	0	"HG005#1#JAHEPO010000002.1_51519219_51926067_0"	"AMY1A-201"	"1"	"1-2-5-2-4-2-5-4-3-0"	"1.0-2.0-5.1-2.1-4.0-2.0-5.0-4.0-3.0-0.0"	51519317	"HG005#1#JAHEPO010000002.1_51519219_51926067_0"	231268	240060
"ENST00000370083.9"	1785	2	1784	"+"	"HG005#1#JAHEPO010000002.1_51519219_51926067_0"	406848	293745	302535	1769	8790	0	"S"	557	1686	NA	1e-04	0	"HG005#1#JAHEPO010000002.1_51519219_51926067_0"	"AMY1A-201"	"1"	"1-2-5-2-4-2-5-4-3-0"	"1.0-2.0-5.1-2.1-4.0-2.0-5.0-4.0-3.0-0.0"	51519317	"HG005#1#JAHEPO010000002.1_51519219_51926067_0"	293745	302535
"ENST00000370083.9"	1785	2	1784	"+"	"HG005#1#JAHEPO010000002.1_51519219_51926067_0"	406848	199620	208411	1769	8791	0	"S"	557	1686	NA	1e-04	0	"HG005#1#JAHEPO010000002.1_51519219_51926067_0"	"AMY1A-201"	"1"	"1-2-5-2-4-2-5-4-3-0"	"1.0-2.0-5.1-2.1-4.0-2.0-5.0-4.0-3.0-0.0"	51519317	"HG005#1#JAHEPO010000002.1_51519219_51926067_0"	199620	208411
"ENST00000414303.7"	1584	4	1583	"+"	"HG005#1#JAHEPO010000002.1_51519219_51926067_0"	406848	161362	169632	1574	8270	30	"P"	491	1499	1342	1e-04	0	"HG005#1#JAHEPO010000002.1_51519219_51926067_0"	"AMY2A-201"	"2A"	"1-2-5-2-4-2-5-4-3-0"	"1.0-2.0-5.1-2.1-4.0-2.0-5.0-4.0-3.0-0.0"	51519317	"HG005#1#JAHEPO010000002.1_51519219_51926067_0"	161362	169632
"ENST00000610648.1"	1736	4	1733	"+"	"HG005#1#JAHEPO010000002.1_51519219_51926067_0"	406848	115023	123445	1720	8422	48	"P"	531	1638	1371	1e-04	0	"HG005#1#JAHEPO010000002.1_51519219_51926067_0"	"AMY2B-208"	"2B"	"1-2-5-2-4-2-5-4-3-0"	"1.0-2.0-5.1-2.1-4.0-2.0-5.0-4.0-3.0-0.0"	51519317	"HG005#1#JAHEPO010000002.1_51519219_51926067_0"	115023	123445
"ENST00000370083.9"	1785	2	1784	"+"	"HG005#2#JAHEPN010000023.1_51542210_51950070_0"	407860	199623	208415	1769	8792	0	"P"	557	1686	1686	1e-04	0	"HG005#2#JAHEPN010000023.1_51542210_51950070_0"	"AMY1A-201"	"1"	"1-2-5-2-6-4-2-5-4-3-0"	"1.0-2.0-5.0-2.1-6.1-4.1-2.0-5.0-4.0-3.0-0.0"	51542309	"HG005#2#JAHEPN010000023.1_51542210_51950070_0"	199623	208415
"ENST00000370083.9"	1785	2	1784	"+"	"HG005#2#JAHEPN010000023.1_51542210_51950070_0"	407860	293767	302559	1769	8792	0	"S"	557	1686	NA	1e-04	0	"HG005#2#JAHEPN010000023.1_51542210_51950070_0"	"AMY1A-201"	"1"	"1-2-5-2-6-4-2-5-4-3-0"	"1.0-2.0-5.0-2.1-6.1-4.1-2.0-5.0-4.0-3.0-0.0"	51542309	"HG005#2#JAHEPN010000023.1_51542210_51950070_0"	293767	302559
"ENST00000370083.9"	1785	2	1784	"-"	"HG005#2#JAHEPN010000023.1_51542210_51950070_0"	407860	231275	240068	1769	8793	0	"S"	557	1686	NA	1e-04	0	"HG005#2#JAHEPN010000023.1_51542210_51950070_0"	"AMY1A-201"	"1"	"1-2-5-2-6-4-2-5-4-3-0"	"1.0-2.0-5.0-2.1-6.1-4.1-2.0-5.0-4.0-3.0-0.0"	51542309	"HG005#2#JAHEPN010000023.1_51542210_51950070_0"	231275	240068
"ENST00000414303.7"	1584	4	1583	"+"	"HG005#2#JAHEPN010000023.1_51542210_51950070_0"	407860	161365	169635	1574	8270	30	"P"	491	1499	1342	1e-04	0	"HG005#2#JAHEPN010000023.1_51542210_51950070_0"	"AMY2A-201"	"2A"	"1-2-5-2-6-4-2-5-4-3-0"	"1.0-2.0-5.0-2.1-6.1-4.1-2.0-5.0-4.0-3.0-0.0"	51542309	"HG005#2#JAHEPN010000023.1_51542210_51950070_0"	161365	169635
"ENST00000610648.1"	1736	4	1733	"+"	"HG005#2#JAHEPN010000023.1_51542210_51950070_0"	407860	115040	123464	1720	8424	48	"P"	531	1638	1371	1e-04	0	"HG005#2#JAHEPN010000023.1_51542210_51950070_0"	"AMY2B-208"	"2B"	"1-2-5-2-6-4-2-5-4-3-0"	"1.0-2.0-5.0-2.1-6.1-4.1-2.0-5.0-4.0-3.0-0.0"	51542309	"HG005#2#JAHEPN010000023.1_51542210_51950070_0"	115040	123464
"ENST00000370083.9"	1785	2	1784	"+"	"HG00621#1#JAHBCD010000034.1_2122997_2624098_1"	501101	293828	302620	1769	8792	0	"P"	557	1686	1686	1e-04	0	"HG00621#1#JAHBCD010000034.1_2122997_2624098_1"	"AMY1A-201"	"1"	"1-2-5-2-6-4-2-5-2-6-4-2-5-4-3-0"	"1.0-2.0-5.1-2.1-6.1-4.1-2.0-5.1-2.1-6.1-4.1-2.0-5.0-4.0-3.0-0.0"	2123152	"HG00621#1#JAHBCD010000034.1_2122997_2624098_1"	293828	302620
"ENST00000370083.9"	1785	2	1784	"-"	"HG00621#1#JAHBCD010000034.1_2122997_2624098_1"	501101	231335	240128	1769	8793	0	"S"	557	1686	NA	1e-04	0	"HG00621#1#JAHBCD010000034.1_2122997_2624098_1"	"AMY1A-201"	"1"	"1-2-5-2-6-4-2-5-2-6-4-2-5-4-3-0"	"1.0-2.0-5.1-2.1-6.1-4.1-2.0-5.1-2.1-6.1-4.1-2.0-5.0-4.0-3.0-0.0"	2123152	"HG00621#1#JAHBCD010000034.1_2122997_2624098_1"	231335	240128
"ENST00000370083.9"	1785	2	1784	"+"	"HG00621#1#JAHBCD010000034.1_2122997_2624098_1"	501101	199680	208474	1769	8794	0	"S"	557	1686	NA	1e-04	0	"HG00621#1#JAHBCD010000034.1_2122997_2624098_1"	"AMY1A-201"	"1"	"1-2-5-2-6-4-2-5-2-6-4-2-5-4-3-0"	"1.0-2.0-5.1-2.1-6.1-4.1-2.0-5.1-2.1-6.1-4.1-2.0-5.0-4.0-3.0-0.0"	2123152	"HG00621#1#JAHBCD010000034.1_2122997_2624098_1"	199680	208474
"ENST00000370083.9"	1785	2	1784	"+"	"HG00621#1#JAHBCD010000034.1_2122997_2624098_1"	501101	387982	396774	1769	8792	0	"S"	557	1686	NA	1e-04	0	"HG00621#1#JAHBCD010000034.1_2122997_2624098_1"	"AMY1A-201"	"1"	"1-2-5-2-6-4-2-5-2-6-4-2-5-4-3-0"	"1.0-2.0-5.1-2.1-6.1-4.1-2.0-5.1-2.1-6.1-4.1-2.0-5.0-4.0-3.0-0.0"	2123152	"HG00621#1#JAHBCD010000034.1_2122997_2624098_1"	387982	396774
"ENST00000370083.9"	1785	2	1784	"-"	"HG00621#1#JAHBCD010000034.1_2122997_2624098_1"	501101	325489	334282	1769	8793	0	"S"	557	1686	NA	1e-04	0	"HG00621#1#JAHBCD010000034.1_2122997_2624098_1"	"AMY1A-201"	"1"	"1-2-5-2-6-4-2-5-2-6-4-2-5-4-3-0"	"1.0-2.0-5.1-2.1-6.1-4.1-2.0-5.1-2.1-6.1-4.1-2.0-5.0-4.0-3.0-0.0"	2123152	"HG00621#1#JAHBCD010000034.1_2122997_2624098_1"	325489	334282
"ENST00000414303.7"	1584	4	1583	"+"	"HG00621#1#JAHBCD010000034.1_2122997_2624098_1"	501101	161422	169692	1574	8270	30	"P"	491	1499	1342	1e-04	0	"HG00621#1#JAHBCD010000034.1_2122997_2624098_1"	"AMY2A-201"	"2A"	"1-2-5-2-6-4-2-5-2-6-4-2-5-4-3-0"	"1.0-2.0-5.1-2.1-6.1-4.1-2.0-5.1-2.1-6.1-4.1-2.0-5.0-4.0-3.0-0.0"	2123152	"HG00621#1#JAHBCD010000034.1_2122997_2624098_1"	161422	169692
"ENST00000610648.1"	1736	4	1733	"+"	"HG00621#1#JAHBCD010000034.1_2122997_2624098_1"	501101	115093	123517	1720	8424	48	"P"	531	1638	1371	1e-04	0	"HG00621#1#JAHBCD010000034.1_2122997_2624098_1"	"AMY2B-208"	"2B"	"1-2-5-2-6-4-2-5-2-6-4-2-5-4-3-0"	"1.0-2.0-5.1-2.1-6.1-4.1-2.0-5.1-2.1-6.1-4.1-2.0-5.0-4.0-3.0-0.0"	2123152	"HG00621#1#JAHBCD010000034.1_2122997_2624098_1"	115093	123517
"ENST00000370083.9"	1785	2	1784	"+"	"HG00621#2#JAHBCC010000031.1_16669999_17077865_0"	407866	293780	302572	1769	8792	0	"P"	557	1686	1686	1e-04	0	"HG00621#2#JAHBCC010000031.1_16669999_17077865_0"	"AMY1A-201"	"1"	"1-2-5-2-6-4-2-5-4-3-0"	"1.0-2.0-5.0-2.1-6.1-4.1-2.0-5.0-4.0-3.0-0.0"	16670098	"HG00621#2#JAHBCC010000031.1_16669999_17077865_0"	293780	302572
"ENST00000370083.9"	1785	2	1784	"+"	"HG00621#2#JAHBCC010000031.1_16669999_17077865_0"	407866	199648	208439	1769	8791	0	"S"	557	1686	NA	1e-04	0	"HG00621#2#JAHBCC010000031.1_16669999_17077865_0"	"AMY1A-201"	"1"	"1-2-5-2-6-4-2-5-4-3-0"	"1.0-2.0-5.0-2.1-6.1-4.1-2.0-5.0-4.0-3.0-0.0"	16670098	"HG00621#2#JAHBCC010000031.1_16669999_17077865_0"	199648	208439
"ENST00000370083.9"	1785	2	1784	"-"	"HG00621#2#JAHBCC010000031.1_16669999_17077865_0"	407866	231306	240098	1769	8792	0	"S"	557	1686	NA	1e-04	0	"HG00621#2#JAHBCC010000031.1_16669999_17077865_0"	"AMY1A-201"	"1"	"1-2-5-2-6-4-2-5-4-3-0"	"1.0-2.0-5.0-2.1-6.1-4.1-2.0-5.0-4.0-3.0-0.0"	16670098	"HG00621#2#JAHBCC010000031.1_16669999_17077865_0"	231306	240098
"ENST00000414303.7"	1584	4	1583	"+"	"HG00621#2#JAHBCC010000031.1_16669999_17077865_0"	407866	161404	169674	1574	8270	30	"P"	491	1499	1342	1e-04	0	"HG00621#2#JAHBCC010000031.1_16669999_17077865_0"	"AMY2A-201"	"2A"	"1-2-5-2-6-4-2-5-4-3-0"	"1.0-2.0-5.0-2.1-6.1-4.1-2.0-5.0-4.0-3.0-0.0"	16670098	"HG00621#2#JAHBCC010000031.1_16669999_17077865_0"	161404	169674
"ENST00000610648.1"	1736	4	1733	"+"	"HG00621#2#JAHBCC010000031.1_16669999_17077865_0"	407866	115075	123499	1720	8424	48	"P"	531	1638	1371	1e-04	0	"HG00621#2#JAHBCC010000031.1_16669999_17077865_0"	"AMY2B-208"	"2B"	"1-2-5-2-6-4-2-5-4-3-0"	"1.0-2.0-5.0-2.1-6.1-4.1-2.0-5.0-4.0-3.0-0.0"	16670098	"HG00621#2#JAHBCC010000031.1_16669999_17077865_0"	115075	123499
"ENST00000370083.9"	1785	2	1784	"+"	"HG00673#1#JAHBBZ010000075.1_16660170_16973851_0"	313681	199649	208440	1769	8791	50	"P"	557	1686	1397	1e-04	0	"HG00673#1#JAHBBZ010000075.1_16660170_16973851_0"	"AMY1A-201"	"1"	"1-2-5-4-6-3-0"	"1.0-2.0-5.0-4.0-6.0-3.0-0.0"	16660268	"HG00673#1#JAHBBZ010000075.1_16660170_16973851_0"	199649	208440
"ENST00000414303.7"	1584	4	1579	"+"	"HG00673#1#JAHBBZ010000075.1_16660170_16973851_0"	313681	161398	169664	1563	8266	28	"P"	484	1488	1342	0.001	0	"HG00673#1#JAHBBZ010000075.1_16660170_16973851_0"	"AMY2A-201"	"2A"	"1-2-5-4-6-3-0"	"1.0-2.0-5.0-4.0-6.0-3.0-0.0"	16660268	"HG00673#1#JAHBBZ010000075.1_16660170_16973851_0"	161398	169664
"ENST00000610648.1"	1736	4	1733	"+"	"HG00673#1#JAHBBZ010000075.1_16660170_16973851_0"	313681	115082	123504	1720	8422	51	"P"	531	1638	1351	1e-04	0	"HG00673#1#JAHBBZ010000075.1_16660170_16973851_0"	"AMY2B-208"	"2B"	"1-2-5-4-6-3-0"	"1.0-2.0-5.0-4.0-6.0-3.0-0.0"	16660268	"HG00673#1#JAHBBZ010000075.1_16660170_16973851_0"	115082	123504
"ENST00000370083.9"	1785	2	1784	"+"	"HG00673#2#JAHBBY010000109.1_16675383_17177395_0"	502012	387922	396714	1769	8792	0	"P"	557	1686	1686	1e-04	0	"HG00673#2#JAHBBY010000109.1_16675383_17177395_0"	"AMY1A-201"	"1"	"1-2-5-2-6-4-2-5-2-6-4-2-5-4-3-0"	"1.0-2.0-5.0-2.1-6.1-4.1-2.0-5.0-2.1-6.1-4.1-2.0-5.0-4.0-3.0-0.0"	16675482	"HG00673#2#JAHBBY010000109.1_16675383_17177395_0"	387922	396714
"ENST00000370083.9"	1785	2	1784	"-"	"HG00673#2#JAHBBY010000109.1_16675383_17177395_0"	502012	231288	240081	1769	8793	0	"S"	557	1686	NA	1e-04	0	"HG00673#2#JAHBBY010000109.1_16675383_17177395_0"	"AMY1A-201"	"1"	"1-2-5-2-6-4-2-5-2-6-4-2-5-4-3-0"	"1.0-2.0-5.0-2.1-6.1-4.1-2.0-5.0-2.1-6.1-4.1-2.0-5.0-4.0-3.0-0.0"	16675482	"HG00673#2#JAHBBY010000109.1_16675383_17177395_0"	231288	240081
"ENST00000370083.9"	1785	2	1784	"+"	"HG00673#2#JAHBBY010000109.1_16675383_17177395_0"	502012	293783	302575	1769	8792	0	"S"	557	1686	NA	1e-04	0	"HG00673#2#JAHBBY010000109.1_16675383_17177395_0"	"AMY1A-201"	"1"	"1-2-5-2-6-4-2-5-2-6-4-2-5-4-3-0"	"1.0-2.0-5.0-2.1-6.1-4.1-2.0-5.0-2.1-6.1-4.1-2.0-5.0-4.0-3.0-0.0"	16675482	"HG00673#2#JAHBBY010000109.1_16675383_17177395_0"	293783	302575
"ENST00000370083.9"	1785	2	1784	"+"	"HG00673#2#JAHBBY010000109.1_16675383_17177395_0"	502012	199631	208424	1769	8793	0	"S"	557	1686	NA	1e-04	0	"HG00673#2#JAHBBY010000109.1_16675383_17177395_0"	"AMY1A-201"	"1"	"1-2-5-2-6-4-2-5-2-6-4-2-5-4-3-0"	"1.0-2.0-5.0-2.1-6.1-4.1-2.0-5.0-2.1-6.1-4.1-2.0-5.0-4.0-3.0-0.0"	16675482	"HG00673#2#JAHBBY010000109.1_16675383_17177395_0"	199631	208424
"ENST00000370083.9"	1785	2	1784	"-"	"HG00673#2#JAHBBY010000109.1_16675383_17177395_0"	502012	325440	334231	1769	8791	0	"S"	557	1686	NA	1e-04	0	"HG00673#2#JAHBBY010000109.1_16675383_17177395_0"	"AMY1A-201"	"1"	"1-2-5-2-6-4-2-5-2-6-4-2-5-4-3-0"	"1.0-2.0-5.0-2.1-6.1-4.1-2.0-5.0-2.1-6.1-4.1-2.0-5.0-4.0-3.0-0.0"	16675482	"HG00673#2#JAHBBY010000109.1_16675383_17177395_0"	325440	334231
"ENST00000414303.7"	1584	4	1583	"+"	"HG00673#2#JAHBBY010000109.1_16675383_17177395_0"	502012	161377	169647	1574	8270	16	"P"	491	1499	1417	1e-04	0	"HG00673#2#JAHBBY010000109.1_16675383_17177395_0"	"AMY2A-201"	"2A"	"1-2-5-2-6-4-2-5-2-6-4-2-5-4-3-0"	"1.0-2.0-5.0-2.1-6.1-4.1-2.0-5.0-2.1-6.1-4.1-2.0-5.0-4.0-3.0-0.0"	16675482	"HG00673#2#JAHBBY010000109.1_16675383_17177395_0"	161377	169647
"ENST00000610648.1"	1736	4	1733	"+"	"HG00673#2#JAHBBY010000109.1_16675383_17177395_0"	502012	115051	123475	1720	8424	48	"P"	531	1638	1371	1e-04	0	"HG00673#2#JAHBBY010000109.1_16675383_17177395_0"	"AMY2B-208"	"2B"	"1-2-5-2-6-4-2-5-2-6-4-2-5-4-3-0"	"1.0-2.0-5.0-2.1-6.1-4.1-2.0-5.0-2.1-6.1-4.1-2.0-5.0-4.0-3.0-0.0"	16675482	"HG00673#2#JAHBBY010000109.1_16675383_17177395_0"	115051	123475
"ENST00000370083.9"	1785	2	1784	"+"	"HG00733#1#JAHEPQ010000019.1_46106835_46420495_0"	313660	199565	208357	1769	8792	49	"P"	557	1686	1404	1e-04	0	"HG00733#1#JAHEPQ010000019.1_46106835_46420495_0"	"AMY1A-201"	"1"	"1-2-5-4-3-0"	"1.0-2.0-5.0-4.0-3.0-0.0"	46106934	"HG00733#1#JAHEPQ010000019.1_46106835_46420495_0"	199565	208357
"ENST00000414303.7"	1584	4	1583	"+"	"HG00733#1#JAHEPQ010000019.1_46106835_46420495_0"	313660	161311	169581	1574	8270	30	"P"	491	1499	1342	1e-04	0	"HG00733#1#JAHEPQ010000019.1_46106835_46420495_0"	"AMY2A-201"	"2A"	"1-2-5-4-3-0"	"1.0-2.0-5.0-4.0-3.0-0.0"	46106934	"HG00733#1#JAHEPQ010000019.1_46106835_46420495_0"	161311	169581
"ENST00000610648.1"	1736	4	1733	"+"	"HG00733#1#JAHEPQ010000019.1_46106835_46420495_0"	313660	114984	123406	1720	8422	50	"P"	531	1638	1358	1e-04	0	"HG00733#1#JAHEPQ010000019.1_46106835_46420495_0"	"AMY2B-208"	"2B"	"1-2-5-4-3-0"	"1.0-2.0-5.0-4.0-3.0-0.0"	46106934	"HG00733#1#JAHEPQ010000019.1_46106835_46420495_0"	114984	123406
"ENST00000370083.9"	1785	2	1784	"+"	"HG00735#1#JAHBCH010000004.1_101548252_101956125_0"	407873	199649	208441	1769	8792	0	"P"	557	1686	1686	1e-04	0	"HG00735#1#JAHBCH010000004.1_101548252_101956125_0"	"AMY1A-201"	"1"	"1-2-5-2-6-4-2-5-4-3-0"	"1.0-2.0-5.0-2.1-6.1-4.1-2.0-5.0-4.0-3.0-0.0"	101548351	"HG00735#1#JAHBCH010000004.1_101548252_101956125_0"	199649	208441
"ENST00000370083.9"	1785	2	1784	"+"	"HG00735#1#JAHBCH010000004.1_101548252_101956125_0"	407873	293777	302570	1769	8793	0	"S"	557	1686	NA	1e-04	0	"HG00735#1#JAHBCH010000004.1_101548252_101956125_0"	"AMY1A-201"	"1"	"1-2-5-2-6-4-2-5-4-3-0"	"1.0-2.0-5.0-2.1-6.1-4.1-2.0-5.0-4.0-3.0-0.0"	101548351	"HG00735#1#JAHBCH010000004.1_101548252_101956125_0"	293777	302570
"ENST00000370083.9"	1785	2	1784	"-"	"HG00735#1#JAHBCH010000004.1_101548252_101956125_0"	407873	231305	240098	1769	8793	0	"S"	557	1686	NA	1e-04	0	"HG00735#1#JAHBCH010000004.1_101548252_101956125_0"	"AMY1A-201"	"1"	"1-2-5-2-6-4-2-5-4-3-0"	"1.0-2.0-5.0-2.1-6.1-4.1-2.0-5.0-4.0-3.0-0.0"	101548351	"HG00735#1#JAHBCH010000004.1_101548252_101956125_0"	231305	240098
"ENST00000414303.7"	1584	4	1583	"+"	"HG00735#1#JAHBCH010000004.1_101548252_101956125_0"	407873	161395	169665	1574	8270	30	"P"	491	1499	1342	1e-04	0	"HG00735#1#JAHBCH010000004.1_101548252_101956125_0"	"AMY2A-201"	"2A"	"1-2-5-2-6-4-2-5-4-3-0"	"1.0-2.0-5.0-2.1-6.1-4.1-2.0-5.0-4.0-3.0-0.0"	101548351	"HG00735#1#JAHBCH010000004.1_101548252_101956125_0"	161395	169665
"ENST00000610648.1"	1736	4	1733	"+"	"HG00735#1#JAHBCH010000004.1_101548252_101956125_0"	407873	115067	123491	1720	8424	48	"P"	531	1638	1371	1e-04	0	"HG00735#1#JAHBCH010000004.1_101548252_101956125_0"	"AMY2B-208"	"2B"	"1-2-5-2-6-4-2-5-4-3-0"	"1.0-2.0-5.0-2.1-6.1-4.1-2.0-5.0-4.0-3.0-0.0"	101548351	"HG00735#1#JAHBCH010000004.1_101548252_101956125_0"	115067	123491
"ENST00000370083.9"	1785	2	1784	"+"	"HG00735#2#JAHBCG010000068.1_4729205_5042887_0"	313682	199586	208379	1769	8793	49	"P"	557	1686	1404	1e-04	0	"HG00735#2#JAHBCG010000068.1_4729205_5042887_0"	"AMY1A-201"	"1"	"1-2-5-4-3-0"	"1.0-2.0-5.0-4.0-3.0-0.0"	4729304	"HG00735#2#JAHBCG010000068.1_4729205_5042887_0"	199586	208379
"ENST00000414303.7"	1584	4	1583	"+"	"HG00735#2#JAHBCG010000068.1_4729205_5042887_0"	313682	161327	169597	1574	8270	30	"P"	491	1499	1342	1e-04	0	"HG00735#2#JAHBCG010000068.1_4729205_5042887_0"	"AMY2A-201"	"2A"	"1-2-5-4-3-0"	"1.0-2.0-5.0-4.0-3.0-0.0"	4729304	"HG00735#2#JAHBCG010000068.1_4729205_5042887_0"	161327	169597
"ENST00000610648.1"	1736	4	1733	"+"	"HG00735#2#JAHBCG010000068.1_4729205_5042887_0"	313682	114999	123423	1720	8424	50	"P"	531	1638	1358	1e-04	0	"HG00735#2#JAHBCG010000068.1_4729205_5042887_0"	"AMY2B-208"	"2B"	"1-2-5-4-3-0"	"1.0-2.0-5.0-4.0-3.0-0.0"	4729304	"HG00735#2#JAHBCG010000068.1_4729205_5042887_0"	114999	123423
"ENST00000370083.9"	1785	2	1784	"+"	"HG00741#1#JAHALY010000007.1_18781197_19307680_1"	526483	315478	324258	1769	8780	0	"P"	557	1686	1686	1e-04	0	"HG00741#1#JAHALY010000007.1_18781197_19307680_1"	"AMY1A-201"	"1"	"1-2-5-2-4-4-2-5-4-6-3-0-4-2-5-4-6-3-0"	"1.0-2.0-5.0-2.1-4.0-4.1-2.0-5.0-4.0-6.0-3.0-0.0-4.1-2.0-5.0-4.0-6.0-3.0-0.0"	18781351	"HG00741#1#JAHALY010000007.1_18781197_19307680_1"	315478	324258
"ENST00000370083.9"	1785	2	1784	"+"	"HG00741#1#JAHALY010000007.1_18781197_19307680_1"	526483	199696	208476	1769	8780	0	"S"	557	1686	NA	1e-04	0	"HG00741#1#JAHALY010000007.1_18781197_19307680_1"	"AMY1A-201"	"1"	"1-2-5-2-4-4-2-5-4-6-3-0-4-2-5-4-6-3-0"	"1.0-2.0-5.0-2.1-4.0-4.1-2.0-5.0-4.0-6.0-3.0-0.0-4.1-2.0-5.0-4.0-6.0-3.0-0.0"	18781351	"HG00741#1#JAHALY010000007.1_18781197_19307680_1"	199696	208476
"ENST00000370083.9"	1785	2	1784	"-"	"HG00741#1#JAHALY010000007.1_18781197_19307680_1"	526483	350026	358806	1769	8780	0	"S"	557	1686	NA	1e-04	0	"HG00741#1#JAHALY010000007.1_18781197_19307680_1"	"AMY1A-201"	"1"	"1-2-5-2-4-4-2-5-4-6-3-0-4-2-5-4-6-3-0"	"1.0-2.0-5.0-2.1-4.0-4.1-2.0-5.0-4.0-6.0-3.0-0.0-4.1-2.0-5.0-4.0-6.0-3.0-0.0"	18781351	"HG00741#1#JAHALY010000007.1_18781197_19307680_1"	350026	358806
"ENST00000370083.9"	1785	2	1784	"+"	"HG00741#1#JAHALY010000007.1_18781197_19307680_1"	526483	412487	421278	1769	8791	0	"S"	557	1686	NA	1e-04	0	"HG00741#1#JAHALY010000007.1_18781197_19307680_1"	"AMY1A-201"	"1"	"1-2-5-2-4-4-2-5-4-6-3-0-4-2-5-4-6-3-0"	"1.0-2.0-5.0-2.1-4.0-4.1-2.0-5.0-4.0-6.0-3.0-0.0-4.1-2.0-5.0-4.0-6.0-3.0-0.0"	18781351	"HG00741#1#JAHALY010000007.1_18781197_19307680_1"	412487	421278
"ENST00000414303.7"	1584	4	1583	"+"	"HG00741#1#JAHALY010000007.1_18781197_19307680_1"	526483	277188	285493	1563	8305	0	"P"	488	1488	1488	5e-04	0	"HG00741#1#JAHALY010000007.1_18781197_19307680_1"	"AMY2A-201"	"2A"	"1-2-5-2-4-4-2-5-4-6-3-0-4-2-5-4-6-3-0"	"1.0-2.0-5.0-2.1-4.0-4.1-2.0-5.0-4.0-6.0-3.0-0.0-4.1-2.0-5.0-4.0-6.0-3.0-0.0"	18781351	"HG00741#1#JAHALY010000007.1_18781197_19307680_1"	277188	285493
"ENST00000414303.7"	1584	4	1583	"+"	"HG00741#1#JAHALY010000007.1_18781197_19307680_1"	526483	161444	169714	1563	8270	0	"S"	488	1488	NA	5e-04	0	"HG00741#1#JAHALY010000007.1_18781197_19307680_1"	"AMY2A-201"	"2A"	"1-2-5-2-4-4-2-5-4-6-3-0-4-2-5-4-6-3-0"	"1.0-2.0-5.0-2.1-4.0-4.1-2.0-5.0-4.0-6.0-3.0-0.0-4.1-2.0-5.0-4.0-6.0-3.0-0.0"	18781351	"HG00741#1#JAHALY010000007.1_18781197_19307680_1"	161444	169714
"ENST00000610648.1"	1736	4	1733	"+"	"HG00741#1#JAHALY010000007.1_18781197_19307680_1"	526483	115108	123530	1720	8422	0	"P"	531	1638	1638	1e-04	0	"HG00741#1#JAHALY010000007.1_18781197_19307680_1"	"AMY2B-208"	"2B"	"1-2-5-2-4-4-2-5-4-6-3-0-4-2-5-4-6-3-0"	"1.0-2.0-5.0-2.1-4.0-4.1-2.0-5.0-4.0-6.0-3.0-0.0-4.1-2.0-5.0-4.0-6.0-3.0-0.0"	18781351	"HG00741#1#JAHALY010000007.1_18781197_19307680_1"	115108	123530
"ENST00000610648.1"	1736	4	1733	"+"	"HG00741#1#JAHALY010000007.1_18781197_19307680_1"	526483	230850	239272	1720	8422	0	"S"	531	1638	NA	1e-04	0	"HG00741#1#JAHALY010000007.1_18781197_19307680_1"	"AMY2B-208"	"2B"	"1-2-5-2-4-4-2-5-4-6-3-0-4-2-5-4-6-3-0"	"1.0-2.0-5.0-2.1-4.0-4.1-2.0-5.0-4.0-6.0-3.0-0.0-4.1-2.0-5.0-4.0-6.0-3.0-0.0"	18781351	"HG00741#1#JAHALY010000007.1_18781197_19307680_1"	230850	239272
"ENST00000370083.9"	1785	2	1784	"+"	"HG00741#2#JAHALX010000013.1_51574319_51981226_0"	406907	293796	302586	1769	8790	0	"P"	557	1686	1686	1e-04	0	"HG00741#2#JAHALX010000013.1_51574319_51981226_0"	"AMY1A-201"	"1"	"1-2-5-2-4-2-5-4-3-0"	"1.0-2.0-5.1-2.1-4.0-2.0-5.0-4.0-3.0-0.0"	51574417	"HG00741#2#JAHALX010000013.1_51574319_51981226_0"	293796	302586
"ENST00000370083.9"	1785	2	1784	"-"	"HG00741#2#JAHALX010000013.1_51574319_51981226_0"	406907	231318	240111	1769	8793	0	"S"	557	1686	NA	1e-04	0	"HG00741#2#JAHALX010000013.1_51574319_51981226_0"	"AMY1A-201"	"1"	"1-2-5-2-4-2-5-4-3-0"	"1.0-2.0-5.1-2.1-4.0-2.0-5.0-4.0-3.0-0.0"	51574417	"HG00741#2#JAHALX010000013.1_51574319_51981226_0"	231318	240111
"ENST00000370083.9"	1785	2	1784	"+"	"HG00741#2#JAHALX010000013.1_51574319_51981226_0"	406907	199664	208457	1767	8793	0	"S"	552	1684	NA	7e-04	0	"HG00741#2#JAHALX010000013.1_51574319_51981226_0"	"AMY1A-201"	"1"	"1-2-5-2-4-2-5-4-3-0"	"1.0-2.0-5.1-2.1-4.0-2.0-5.0-4.0-3.0-0.0"	51574417	"HG00741#2#JAHALX010000013.1_51574319_51981226_0"	199664	208457
"ENST00000414303.7"	1584	4	1583	"+"	"HG00741#2#JAHALX010000013.1_51574319_51981226_0"	406907	161399	169669	1574	8270	30	"P"	491	1499	1342	1e-04	0	"HG00741#2#JAHALX010000013.1_51574319_51981226_0"	"AMY2A-201"	"2A"	"1-2-5-2-4-2-5-4-3-0"	"1.0-2.0-5.1-2.1-4.0-2.0-5.0-4.0-3.0-0.0"	51574417	"HG00741#2#JAHALX010000013.1_51574319_51981226_0"	161399	169669
"ENST00000610648.1"	1736	4	1733	"+"	"HG00741#2#JAHALX010000013.1_51574319_51981226_0"	406907	115083	123505	1720	8422	48	"P"	531	1638	1371	1e-04	0	"HG00741#2#JAHALX010000013.1_51574319_51981226_0"	"AMY2B-208"	"2B"	"1-2-5-2-4-2-5-4-3-0"	"1.0-2.0-5.1-2.1-4.0-2.0-5.0-4.0-3.0-0.0"	51574417	"HG00741#2#JAHALX010000013.1_51574319_51981226_0"	115083	123505
"ENST00000370083.9"	1785	2	1784	"-"	"HG01071#1#JAHBCF010000053.1_26607100_27108065_1"	500965	325425	334218	1769	8793	0	"P"	557	1686	1686	1e-04	0	"HG01071#1#JAHBCF010000053.1_26607100_27108065_1"	"AMY1A-201"	"1"	"1-2-5-2-4-2-5-2-6-4-2-5-4-3-0"	"1.0-2.0-5.1-2.1-4.0-2.0-5.0-2.1-6.1-4.1-2.0-5.0-4.0-3.0-0.0"	26607255	"HG01071#1#JAHBCF010000053.1_26607100_27108065_1"	325425	334218
"ENST00000370083.9"	1785	2	1784	"+"	"HG01071#1#JAHBCF010000053.1_26607100_27108065_1"	500965	387900	396694	1769	8794	0	"S"	557	1686	NA	1e-04	0	"HG01071#1#JAHBCF010000053.1_26607100_27108065_1"	"AMY1A-201"	"1"	"1-2-5-2-4-2-5-2-6-4-2-5-4-3-0"	"1.0-2.0-5.1-2.1-4.0-2.0-5.0-2.1-6.1-4.1-2.0-5.0-4.0-3.0-0.0"	26607255	"HG01071#1#JAHBCF010000053.1_26607100_27108065_1"	387900	396694
"ENST00000370083.9"	1785	2	1784	"-"	"HG01071#1#JAHBCF010000053.1_26607100_27108065_1"	500965	231297	240090	1769	8793	0	"S"	557	1686	NA	1e-04	0	"HG01071#1#JAHBCF010000053.1_26607100_27108065_1"	"AMY1A-201"	"1"	"1-2-5-2-4-2-5-2-6-4-2-5-4-3-0"	"1.0-2.0-5.1-2.1-4.0-2.0-5.0-2.1-6.1-4.1-2.0-5.0-4.0-3.0-0.0"	26607255	"HG01071#1#JAHBCF010000053.1_26607100_27108065_1"	231297	240090
"ENST00000370083.9"	1785	2	1784	"+"	"HG01071#1#JAHBCF010000053.1_26607100_27108065_1"	500965	293767	302560	1769	8793	0	"S"	557	1686	NA	1e-04	0	"HG01071#1#JAHBCF010000053.1_26607100_27108065_1"	"AMY1A-201"	"1"	"1-2-5-2-4-2-5-2-6-4-2-5-4-3-0"	"1.0-2.0-5.1-2.1-4.0-2.0-5.0-2.1-6.1-4.1-2.0-5.0-4.0-3.0-0.0"	26607255	"HG01071#1#JAHBCF010000053.1_26607100_27108065_1"	293767	302560
"ENST00000370083.9"	1785	2	1784	"+"	"HG01071#1#JAHBCF010000053.1_26607100_27108065_1"	500965	199640	208434	1769	8794	0	"S"	557	1686	NA	1e-04	0	"HG01071#1#JAHBCF010000053.1_26607100_27108065_1"	"AMY1A-201"	"1"	"1-2-5-2-4-2-5-2-6-4-2-5-4-3-0"	"1.0-2.0-5.1-2.1-4.0-2.0-5.0-2.1-6.1-4.1-2.0-5.0-4.0-3.0-0.0"	26607255	"HG01071#1#JAHBCF010000053.1_26607100_27108065_1"	199640	208434
"ENST00000414303.7"	1584	4	1583	"+"	"HG01071#1#JAHBCF010000053.1_26607100_27108065_1"	500965	161385	169655	1574	8270	30	"P"	491	1499	1342	1e-04	0	"HG01071#1#JAHBCF010000053.1_26607100_27108065_1"	"AMY2A-201"	"2A"	"1-2-5-2-4-2-5-2-6-4-2-5-4-3-0"	"1.0-2.0-5.1-2.1-4.0-2.0-5.0-2.1-6.1-4.1-2.0-5.0-4.0-3.0-0.0"	26607255	"HG01071#1#JAHBCF010000053.1_26607100_27108065_1"	161385	169655
"ENST00000610648.1"	1736	4	1733	"+"	"HG01071#1#JAHBCF010000053.1_26607100_27108065_1"	500965	115055	123479	1720	8424	48	"P"	531	1638	1371	1e-04	0	"HG01071#1#JAHBCF010000053.1_26607100_27108065_1"	"AMY2B-208"	"2B"	"1-2-5-2-4-2-5-2-6-4-2-5-4-3-0"	"1.0-2.0-5.1-2.1-4.0-2.0-5.0-2.1-6.1-4.1-2.0-5.0-4.0-3.0-0.0"	26607255	"HG01071#1#JAHBCF010000053.1_26607100_27108065_1"	115055	123479
"ENST00000370083.9"	1785	2	1784	"-"	"HG01106#1#JAHAMC010000004.1_31121050_31623013_0"	501963	325403	334195	1769	8792	0	"P"	557	1686	1686	1e-04	0	"HG01106#1#JAHAMC010000004.1_31121050_31623013_0"	"AMY1A-201"	"1"	"1-2-5-2-6-4-2-5-2-4-6-2-5-4-3-0"	"1.0-2.0-5.0-2.1-6.1-4.1-2.0-5.1-2.1-4.0-6.0-2.0-5.0-4.0-3.0-0.0"	31121149	"HG01106#1#JAHAMC010000004.1_31121050_31623013_0"	325403	334195
"ENST00000370083.9"	1785	2	1784	"+"	"HG01106#1#JAHAMC010000004.1_31121050_31623013_0"	501963	293748	302540	1769	8792	0	"S"	557	1686	NA	1e-04	0	"HG01106#1#JAHAMC010000004.1_31121050_31623013_0"	"AMY1A-201"	"1"	"1-2-5-2-6-4-2-5-2-4-6-2-5-4-3-0"	"1.0-2.0-5.0-2.1-6.1-4.1-2.0-5.1-2.1-4.0-6.0-2.0-5.0-4.0-3.0-0.0"	31121149	"HG01106#1#JAHAMC010000004.1_31121050_31623013_0"	293748	302540
"ENST00000370083.9"	1785	2	1784	"+"	"HG01106#1#JAHAMC010000004.1_31121050_31623013_0"	501963	387867	396659	1769	8792	0	"S"	557	1686	NA	1e-04	0	"HG01106#1#JAHAMC010000004.1_31121050_31623013_0"	"AMY1A-201"	"1"	"1-2-5-2-6-4-2-5-2-4-6-2-5-4-3-0"	"1.0-2.0-5.0-2.1-6.1-4.1-2.0-5.1-2.1-4.0-6.0-2.0-5.0-4.0-3.0-0.0"	31121149	"HG01106#1#JAHAMC010000004.1_31121050_31623013_0"	387867	396659
"ENST00000370083.9"	1785	2	1784	"-"	"HG01106#1#JAHAMC010000004.1_31121050_31623013_0"	501963	231281	240073	1769	8792	0	"S"	557	1686	NA	1e-04	0	"HG01106#1#JAHAMC010000004.1_31121050_31623013_0"	"AMY1A-201"	"1"	"1-2-5-2-6-4-2-5-2-4-6-2-5-4-3-0"	"1.0-2.0-5.0-2.1-6.1-4.1-2.0-5.1-2.1-4.0-6.0-2.0-5.0-4.0-3.0-0.0"	31121149	"HG01106#1#JAHAMC010000004.1_31121050_31623013_0"	231281	240073
"ENST00000370083.9"	1785	2	1784	"+"	"HG01106#1#JAHAMC010000004.1_31121050_31623013_0"	501963	199624	208417	1769	8793	0	"S"	557	1686	NA	1e-04	0	"HG01106#1#JAHAMC010000004.1_31121050_31623013_0"	"AMY1A-201"	"1"	"1-2-5-2-6-4-2-5-2-4-6-2-5-4-3-0"	"1.0-2.0-5.0-2.1-6.1-4.1-2.0-5.1-2.1-4.0-6.0-2.0-5.0-4.0-3.0-0.0"	31121149	"HG01106#1#JAHAMC010000004.1_31121050_31623013_0"	199624	208417
"ENST00000414303.7"	1584	4	1583	"+"	"HG01106#1#JAHAMC010000004.1_31121050_31623013_0"	501963	161366	169636	1574	8270	15	"P"	491	1499	1420	1e-04	0	"HG01106#1#JAHAMC010000004.1_31121050_31623013_0"	"AMY2A-201"	"2A"	"1-2-5-2-6-4-2-5-2-4-6-2-5-4-3-0"	"1.0-2.0-5.0-2.1-6.1-4.1-2.0-5.1-2.1-4.0-6.0-2.0-5.0-4.0-3.0-0.0"	31121149	"HG01106#1#JAHAMC010000004.1_31121050_31623013_0"	161366	169636
"ENST00000610648.1"	1736	4	1733	"+"	"HG01106#1#JAHAMC010000004.1_31121050_31623013_0"	501963	115039	123461	1720	8422	48	"P"	531	1638	1371	1e-04	0	"HG01106#1#JAHAMC010000004.1_31121050_31623013_0"	"AMY2B-208"	"2B"	"1-2-5-2-6-4-2-5-2-4-6-2-5-4-3-0"	"1.0-2.0-5.0-2.1-6.1-4.1-2.0-5.1-2.1-4.0-6.0-2.0-5.0-4.0-3.0-0.0"	31121149	"HG01106#1#JAHAMC010000004.1_31121050_31623013_0"	115039	123461
"ENST00000370083.9"	1785	2	1784	"+"	"HG01106#2#JAHAMB010000008.1_19904771_20405763_1"	500992	199651	208444	1769	8793	0	"P"	557	1686	1686	1e-04	0	"HG01106#2#JAHAMB010000008.1_19904771_20405763_1"	"AMY1A-201"	"1"	"1-2-5-2-6-4-2-5-2-4-2-5-4-3-0"	"1.0-2.0-5.0-2.1-6.1-4.1-2.0-5.1-2.1-4.1-2.0-5.0-4.0-3.0-0.0"	19904926	"HG01106#2#JAHAMB010000008.1_19904771_20405763_1"	199651	208444
"ENST00000370083.9"	1785	2	1784	"-"	"HG01106#2#JAHAMB010000008.1_19904771_20405763_1"	500992	231304	240097	1769	8793	0	"S"	557	1686	NA	1e-04	0	"HG01106#2#JAHAMB010000008.1_19904771_20405763_1"	"AMY1A-201"	"1"	"1-2-5-2-6-4-2-5-2-4-2-5-4-3-0"	"1.0-2.0-5.0-2.1-6.1-4.1-2.0-5.1-2.1-4.1-2.0-5.0-4.0-3.0-0.0"	19904926	"HG01106#2#JAHAMB010000008.1_19904771_20405763_1"	231304	240097
"ENST00000370083.9"	1785	2	1784	"+"	"HG01106#2#JAHAMB010000008.1_19904771_20405763_1"	500992	387904	396696	1769	8792	0	"S"	557	1686	NA	1e-04	0	"HG01106#2#JAHAMB010000008.1_19904771_20405763_1"	"AMY1A-201"	"1"	"1-2-5-2-6-4-2-5-2-4-2-5-4-3-0"	"1.0-2.0-5.0-2.1-6.1-4.1-2.0-5.1-2.1-4.1-2.0-5.0-4.0-3.0-0.0"	19904926	"HG01106#2#JAHAMB010000008.1_19904771_20405763_1"	387904	396696
"ENST00000370083.9"	1785	2	1784	"+"	"HG01106#2#JAHAMB010000008.1_19904771_20405763_1"	500992	293775	302566	1769	8791	0	"S"	557	1686	NA	1e-04	0	"HG01106#2#JAHAMB010000008.1_19904771_20405763_1"	"AMY1A-201"	"1"	"1-2-5-2-6-4-2-5-2-4-2-5-4-3-0"	"1.0-2.0-5.0-2.1-6.1-4.1-2.0-5.1-2.1-4.1-2.0-5.0-4.0-3.0-0.0"	19904926	"HG01106#2#JAHAMB010000008.1_19904771_20405763_1"	293775	302566
"ENST00000370083.9"	1785	2	1784	"-"	"HG01106#2#JAHAMB010000008.1_19904771_20405763_1"	500992	325433	334224	1769	8791	0	"S"	557	1686	NA	1e-04	0	"HG01106#2#JAHAMB010000008.1_19904771_20405763_1"	"AMY1A-201"	"1"	"1-2-5-2-6-4-2-5-2-4-2-5-4-3-0"	"1.0-2.0-5.0-2.1-6.1-4.1-2.0-5.1-2.1-4.1-2.0-5.0-4.0-3.0-0.0"	19904926	"HG01106#2#JAHAMB010000008.1_19904771_20405763_1"	325433	334224
"ENST00000414303.7"	1584	4	1583	"+"	"HG01106#2#JAHAMB010000008.1_19904771_20405763_1"	500992	161401	169671	1574	8270	15	"P"	491	1499	1420	1e-04	0	"HG01106#2#JAHAMB010000008.1_19904771_20405763_1"	"AMY2A-201"	"2A"	"1-2-5-2-6-4-2-5-2-4-2-5-4-3-0"	"1.0-2.0-5.0-2.1-6.1-4.1-2.0-5.1-2.1-4.1-2.0-5.0-4.0-3.0-0.0"	19904926	"HG01106#2#JAHAMB010000008.1_19904771_20405763_1"	161401	169671
"ENST00000610648.1"	1736	4	1733	"+"	"HG01106#2#JAHAMB010000008.1_19904771_20405763_1"	500992	115070	123494	1720	8424	48	"P"	531	1638	1371	1e-04	0	"HG01106#2#JAHAMB010000008.1_19904771_20405763_1"	"AMY2B-208"	"2B"	"1-2-5-2-6-4-2-5-2-4-2-5-4-3-0"	"1.0-2.0-5.0-2.1-6.1-4.1-2.0-5.1-2.1-4.1-2.0-5.0-4.0-3.0-0.0"	19904926	"HG01106#2#JAHAMB010000008.1_19904771_20405763_1"	115070	123494
"ENST00000370083.9"	1785	2	1784	"-"	"HG01109#1#JAHEPA010000099.1_2104245_2511104_1"	406859	231324	240117	1769	8793	0	"P"	557	1686	1686	1e-04	0	"HG01109#1#JAHEPA010000099.1_2104245_2511104_1"	"AMY1A-201"	"1"	"1-2-5-2-4-2-5-4-3-0"	"1.0-2.0-5.1-2.1-4.0-2.0-5.0-4.0-3.0-0.0"	2104400	"HG01109#1#JAHEPA010000099.1_2104245_2511104_1"	231324	240117
"ENST00000370083.9"	1785	2	1784	"+"	"HG01109#1#JAHEPA010000099.1_2104245_2511104_1"	406859	293807	302600	1769	8793	0	"S"	557	1686	NA	1e-04	0	"HG01109#1#JAHEPA010000099.1_2104245_2511104_1"	"AMY1A-201"	"1"	"1-2-5-2-4-2-5-4-3-0"	"1.0-2.0-5.1-2.1-4.0-2.0-5.0-4.0-3.0-0.0"	2104400	"HG01109#1#JAHEPA010000099.1_2104245_2511104_1"	293807	302600
"ENST00000370083.9"	1785	2	1784	"+"	"HG01109#1#JAHEPA010000099.1_2104245_2511104_1"	406859	199670	208462	1769	8792	0	"S"	557	1686	NA	1e-04	0	"HG01109#1#JAHEPA010000099.1_2104245_2511104_1"	"AMY1A-201"	"1"	"1-2-5-2-4-2-5-4-3-0"	"1.0-2.0-5.1-2.1-4.0-2.0-5.0-4.0-3.0-0.0"	2104400	"HG01109#1#JAHEPA010000099.1_2104245_2511104_1"	199670	208462
"ENST00000414303.7"	1584	4	1583	"+"	"HG01109#1#JAHEPA010000099.1_2104245_2511104_1"	406859	161418	169688	1574	8270	30	"P"	491	1499	1342	1e-04	0	"HG01109#1#JAHEPA010000099.1_2104245_2511104_1"	"AMY2A-201"	"2A"	"1-2-5-2-4-2-5-4-3-0"	"1.0-2.0-5.1-2.1-4.0-2.0-5.0-4.0-3.0-0.0"	2104400	"HG01109#1#JAHEPA010000099.1_2104245_2511104_1"	161418	169688
"ENST00000610648.1"	1736	4	1733	"+"	"HG01109#1#JAHEPA010000099.1_2104245_2511104_1"	406859	115090	123514	1720	8424	48	"P"	531	1638	1371	1e-04	0	"HG01109#1#JAHEPA010000099.1_2104245_2511104_1"	"AMY2B-208"	"2B"	"1-2-5-2-4-2-5-4-3-0"	"1.0-2.0-5.1-2.1-4.0-2.0-5.0-4.0-3.0-0.0"	2104400	"HG01109#1#JAHEPA010000099.1_2104245_2511104_1"	115090	123514
"ENST00000370083.9"	1785	2	1784	"+"	"HG01109#2#JAHEOZ010000047.1_16671232_17151375_0"	480143	366087	374877	1769	8790	0	"P"	557	1686	1686	1e-04	0	"HG01109#2#JAHEOZ010000047.1_16671232_17151375_0"	"AMY1A-201"	"1"	"1-2-5-2-4-6-2-5-4-6-2-5-4-6-3-0"	"1.0-2.0-5.0-2.1-4.0-6.0-2.0-5.0-4.0-6.0-2.0-5.0-4.0-6.0-3.0-0.0"	16671330	"HG01109#2#JAHEOZ010000047.1_16671232_17151375_0"	366087	374877
"ENST00000370083.9"	1785	2	1784	"-"	"HG01109#2#JAHEOZ010000047.1_16671232_17151375_0"	480143	303623	312412	1769	8789	0	"S"	557	1686	NA	1e-04	0	"HG01109#2#JAHEOZ010000047.1_16671232_17151375_0"	"AMY1A-201"	"1"	"1-2-5-2-4-6-2-5-4-6-2-5-4-6-3-0"	"1.0-2.0-5.0-2.1-4.0-6.0-2.0-5.0-4.0-6.0-2.0-5.0-4.0-6.0-3.0-0.0"	16671330	"HG01109#2#JAHEOZ010000047.1_16671232_17151375_0"	303623	312412
"ENST00000370083.9"	1785	2	1784	"+"	"HG01109#2#JAHEOZ010000047.1_16671232_17151375_0"	480143	271965	280757	1769	8792	0	"S"	557	1686	NA	1e-04	0	"HG01109#2#JAHEOZ010000047.1_16671232_17151375_0"	"AMY1A-201"	"1"	"1-2-5-2-4-6-2-5-4-6-2-5-4-6-3-0"	"1.0-2.0-5.0-2.1-4.0-6.0-2.0-5.0-4.0-6.0-2.0-5.0-4.0-6.0-3.0-0.0"	16671330	"HG01109#2#JAHEOZ010000047.1_16671232_17151375_0"	271965	280757
"ENST00000370083.9"	1785	2	1784	"+"	"HG01109#2#JAHEOZ010000047.1_16671232_17151375_0"	480143	199563	208355	1769	8792	0	"S"	557	1686	NA	1e-04	0	"HG01109#2#JAHEOZ010000047.1_16671232_17151375_0"	"AMY1A-201"	"1"	"1-2-5-2-4-6-2-5-4-6-2-5-4-6-3-0"	"1.0-2.0-5.0-2.1-4.0-6.0-2.0-5.0-4.0-6.0-2.0-5.0-4.0-6.0-3.0-0.0"	16671330	"HG01109#2#JAHEOZ010000047.1_16671232_17151375_0"	199563	208355
"ENST00000414303.7"	1584	4	1583	"+"	"HG01109#2#JAHEOZ010000047.1_16671232_17151375_0"	480143	233718	241981	1571	8263	0	"P"	486	1496	1494	8e-04	0	"HG01109#2#JAHEOZ010000047.1_16671232_17151375_0"	"AMY2A-201"	"2A"	"1-2-5-2-4-6-2-5-4-6-2-5-4-6-3-0"	"1.0-2.0-5.0-2.1-4.0-6.0-2.0-5.0-4.0-6.0-2.0-5.0-4.0-6.0-3.0-0.0"	16671330	"HG01109#2#JAHEOZ010000047.1_16671232_17151375_0"	233718	241981
"ENST00000414303.7"	1584	4	1583	"+"	"HG01109#2#JAHEOZ010000047.1_16671232_17151375_0"	480143	161319	169582	1569	8263	0	"S"	486	1494	NA	8e-04	0	"HG01109#2#JAHEOZ010000047.1_16671232_17151375_0"	"AMY2A-201"	"2A"	"1-2-5-2-4-6-2-5-4-6-2-5-4-6-3-0"	"1.0-2.0-5.0-2.1-4.0-6.0-2.0-5.0-4.0-6.0-2.0-5.0-4.0-6.0-3.0-0.0"	16671330	"HG01109#2#JAHEOZ010000047.1_16671232_17151375_0"	161319	169582
"ENST00000610648.1"	1736	4	1733	"+"	"HG01109#2#JAHEOZ010000047.1_16671232_17151375_0"	480143	114993	123415	1720	8422	45	"P"	531	1638	1386	1e-04	0	"HG01109#2#JAHEOZ010000047.1_16671232_17151375_0"	"AMY2B-208"	"2B"	"1-2-5-2-4-6-2-5-4-6-2-5-4-6-3-0"	"1.0-2.0-5.0-2.1-4.0-6.0-2.0-5.0-4.0-6.0-2.0-5.0-4.0-6.0-3.0-0.0"	16671330	"HG01109#2#JAHEOZ010000047.1_16671232_17151375_0"	114993	123415
"ENST00000370083.9"	1785	2	1784	"+"	"HG01123#1#JAGYYZ010000015.1_51528240_51935090_0"	406850	293749	302540	1769	8791	0	"P"	557	1686	1686	1e-04	0	"HG01123#1#JAGYYZ010000015.1_51528240_51935090_0"	"AMY1A-201"	"1"	"1-2-5-2-4-2-5-4-3-0"	"1.0-2.0-5.1-2.1-4.0-2.0-5.0-4.0-3.0-0.0"	51528338	"HG01123#1#JAGYYZ010000015.1_51528240_51935090_0"	293749	302540
"ENST00000370083.9"	1785	2	1784	"-"	"HG01123#1#JAGYYZ010000015.1_51528240_51935090_0"	406850	231268	240061	1769	8793	0	"S"	557	1686	NA	1e-04	0	"HG01123#1#JAGYYZ010000015.1_51528240_51935090_0"	"AMY1A-201"	"1"	"1-2-5-2-4-2-5-4-3-0"	"1.0-2.0-5.1-2.1-4.0-2.0-5.0-4.0-3.0-0.0"	51528338	"HG01123#1#JAGYYZ010000015.1_51528240_51935090_0"	231268	240061
"ENST00000370083.9"	1785	2	1784	"+"	"HG01123#1#JAGYYZ010000015.1_51528240_51935090_0"	406850	199613	208406	1767	8793	0	"S"	552	1684	NA	7e-04	0	"HG01123#1#JAGYYZ010000015.1_51528240_51935090_0"	"AMY1A-201"	"1"	"1-2-5-2-4-2-5-4-3-0"	"1.0-2.0-5.1-2.1-4.0-2.0-5.0-4.0-3.0-0.0"	51528338	"HG01123#1#JAGYYZ010000015.1_51528240_51935090_0"	199613	208406
"ENST00000414303.7"	1584	4	1583	"+"	"HG01123#1#JAGYYZ010000015.1_51528240_51935090_0"	406850	161352	169622	1574	8270	30	"P"	491	1499	1342	1e-04	0	"HG01123#1#JAGYYZ010000015.1_51528240_51935090_0"	"AMY2A-201"	"2A"	"1-2-5-2-4-2-5-4-3-0"	"1.0-2.0-5.1-2.1-4.0-2.0-5.0-4.0-3.0-0.0"	51528338	"HG01123#1#JAGYYZ010000015.1_51528240_51935090_0"	161352	169622
"ENST00000610648.1"	1736	4	1733	"+"	"HG01123#1#JAGYYZ010000015.1_51528240_51935090_0"	406850	115030	123452	1720	8422	48	"P"	531	1638	1371	1e-04	0	"HG01123#1#JAGYYZ010000015.1_51528240_51935090_0"	"AMY2B-208"	"2B"	"1-2-5-2-4-2-5-4-3-0"	"1.0-2.0-5.1-2.1-4.0-2.0-5.0-4.0-3.0-0.0"	51528338	"HG01123#1#JAGYYZ010000015.1_51528240_51935090_0"	115030	123452
"ENST00000370083.9"	1785	2	1784	"+"	"HG01123#2#JAGYYY010000006.1_51579630_51892388_0"	312758	199614	208406	1769	8792	49	"P"	557	1686	1404	1e-04	0	"HG01123#2#JAGYYY010000006.1_51579630_51892388_0"	"AMY1A-201"	"1"	"1-2-5-4-3-0"	"1.0-2.0-5.0-4.0-3.0-0.0"	51579729	"HG01123#2#JAGYYY010000006.1_51579630_51892388_0"	199614	208406
"ENST00000414303.7"	1584	4	1583	"+"	"HG01123#2#JAGYYY010000006.1_51579630_51892388_0"	312758	161364	169634	1574	8270	30	"P"	491	1499	1342	1e-04	0	"HG01123#2#JAGYYY010000006.1_51579630_51892388_0"	"AMY2A-201"	"2A"	"1-2-5-4-3-0"	"1.0-2.0-5.0-4.0-3.0-0.0"	51579729	"HG01123#2#JAGYYY010000006.1_51579630_51892388_0"	161364	169634
"ENST00000610648.1"	1736	4	1733	"+"	"HG01123#2#JAGYYY010000006.1_51579630_51892388_0"	312758	115032	123456	1720	8424	50	"P"	531	1638	1358	1e-04	0	"HG01123#2#JAGYYY010000006.1_51579630_51892388_0"	"AMY2B-208"	"2B"	"1-2-5-4-3-0"	"1.0-2.0-5.0-4.0-3.0-0.0"	51579729	"HG01123#2#JAGYYY010000006.1_51579630_51892388_0"	115032	123456
"ENST00000370083.9"	1785	2	1784	"+"	"HG01175#1#JAHAMA010000003.1_33204707_33808232_1"	603525	490813	499587	1769	8774	0	"P"	557	1686	1686	1e-04	0	"HG01175#1#JAHAMA010000003.1_33204707_33808232_1"	"AMY1A-201"	"1"	"1-2-5-2-4-4-2-5-2-4-4-2-5-2-4-4-2-5-4-6-3-0"	"1.0-2.0-5.0-2.1-4.0-4.1-2.0-5.1-2.1-4.0-4.1-2.0-5.0-2.1-4.0-4.1-2.0-5.0-4.0-6.0-3.0-0.0"	33204861	"HG01175#1#JAHAMA010000003.1_33204707_33808232_1"	490813	499587
"ENST00000370083.9"	1785	2	1784	"+"	"HG01175#1#JAHAMA010000003.1_33204707_33808232_1"	603525	393774	402566	1769	8792	0	"S"	557	1686	NA	1e-04	0	"HG01175#1#JAHAMA010000003.1_33204707_33808232_1"	"AMY1A-201"	"1"	"1-2-5-2-4-4-2-5-2-4-4-2-5-2-4-4-2-5-4-6-3-0"	"1.0-2.0-5.0-2.1-4.0-4.1-2.0-5.1-2.1-4.0-4.1-2.0-5.0-2.1-4.0-4.1-2.0-5.0-4.0-6.0-3.0-0.0"	33204861	"HG01175#1#JAHAMA010000003.1_33204707_33808232_1"	393774	402566
"ENST00000370083.9"	1785	2	1784	"+"	"HG01175#1#JAHAMA010000003.1_33204707_33808232_1"	603525	199710	208500	1769	8790	0	"S"	557	1686	NA	1e-04	0	"HG01175#1#JAHAMA010000003.1_33204707_33808232_1"	"AMY1A-201"	"1"	"1-2-5-2-4-4-2-5-2-4-4-2-5-2-4-4-2-5-4-6-3-0"	"1.0-2.0-5.0-2.1-4.0-4.1-2.0-5.1-2.1-4.0-4.1-2.0-5.0-2.1-4.0-4.1-2.0-5.0-4.0-6.0-3.0-0.0"	33204861	"HG01175#1#JAHAMA010000003.1_33204707_33808232_1"	199710	208500
"ENST00000370083.9"	1785	2	1784	"-"	"HG01175#1#JAHAMA010000003.1_33204707_33808232_1"	603525	331273	340074	1767	8801	0	"S"	552	1684	NA	7e-04	0	"HG01175#1#JAHAMA010000003.1_33204707_33808232_1"	"AMY1A-201"	"1"	"1-2-5-2-4-4-2-5-2-4-4-2-5-2-4-4-2-5-4-6-3-0"	"1.0-2.0-5.0-2.1-4.0-4.1-2.0-5.1-2.1-4.0-4.1-2.0-5.0-2.1-4.0-4.1-2.0-5.0-4.0-6.0-3.0-0.0"	33204861	"HG01175#1#JAHAMA010000003.1_33204707_33808232_1"	331273	340074
"ENST00000370083.9"	1785	2	1784	"-"	"HG01175#1#JAHAMA010000003.1_33204707_33808232_1"	603525	428326	437116	1764	8790	0	"S"	546	1681	NA	0.0014	0	"HG01175#1#JAHAMA010000003.1_33204707_33808232_1"	"AMY1A-201"	"1"	"1-2-5-2-4-4-2-5-2-4-4-2-5-2-4-4-2-5-4-6-3-0"	"1.0-2.0-5.0-2.1-4.0-4.1-2.0-5.1-2.1-4.0-4.1-2.0-5.0-2.1-4.0-4.1-2.0-5.0-4.0-6.0-3.0-0.0"	33204861	"HG01175#1#JAHAMA010000003.1_33204707_33808232_1"	428326	437116
"ENST00000370083.9"	1785	2	1784	"-"	"HG01175#1#JAHAMA010000003.1_33204707_33808232_1"	603525	234263	243043	1763	8780	0	"S"	548	1680	NA	0.0012	0	"HG01175#1#JAHAMA010000003.1_33204707_33808232_1"	"AMY1A-201"	"1"	"1-2-5-2-4-4-2-5-2-4-4-2-5-2-4-4-2-5-4-6-3-0"	"1.0-2.0-5.0-2.1-4.0-4.1-2.0-5.1-2.1-4.0-4.1-2.0-5.0-2.1-4.0-4.1-2.0-5.0-4.0-6.0-3.0-0.0"	33204861	"HG01175#1#JAHAMA010000003.1_33204707_33808232_1"	234263	243043
"ENST00000370083.9"	1785	2	1784	"+"	"HG01175#1#JAHAMA010000003.1_33204707_33808232_1"	603525	296721	305511	1762	8791	0	"S"	547	1679	NA	0.0013	0	"HG01175#1#JAHAMA010000003.1_33204707_33808232_1"	"AMY1A-201"	"1"	"1-2-5-2-4-4-2-5-2-4-4-2-5-2-4-4-2-5-4-6-3-0"	"1.0-2.0-5.0-2.1-4.0-4.1-2.0-5.1-2.1-4.0-4.1-2.0-5.0-2.1-4.0-4.1-2.0-5.0-4.0-6.0-3.0-0.0"	33204861	"HG01175#1#JAHAMA010000003.1_33204707_33808232_1"	296721	305511
"ENST00000414303.7"	1584	4	1583	"+"	"HG01175#1#JAHAMA010000003.1_33204707_33808232_1"	603525	161440	169710	1563	8270	11	"P"	488	1488	1431	5e-04	0	"HG01175#1#JAHAMA010000003.1_33204707_33808232_1"	"AMY2A-201"	"2A"	"1-2-5-2-4-4-2-5-2-4-4-2-5-2-4-4-2-5-4-6-3-0"	"1.0-2.0-5.0-2.1-4.0-4.1-2.0-5.1-2.1-4.0-4.1-2.0-5.0-2.1-4.0-4.1-2.0-5.0-4.0-6.0-3.0-0.0"	33204861	"HG01175#1#JAHAMA010000003.1_33204707_33808232_1"	161440	169710
"ENST00000610648.1"	1736	4	1733	"+"	"HG01175#1#JAHAMA010000003.1_33204707_33808232_1"	603525	115103	123525	1718	8422	45	"P"	527	1636	1386	1e-04	0	"HG01175#1#JAHAMA010000003.1_33204707_33808232_1"	"AMY2B-208"	"2B"	"1-2-5-2-4-4-2-5-2-4-4-2-5-2-4-4-2-5-4-6-3-0"	"1.0-2.0-5.0-2.1-4.0-4.1-2.0-5.1-2.1-4.0-4.1-2.0-5.0-2.1-4.0-4.1-2.0-5.0-4.0-6.0-3.0-0.0"	33204861	"HG01175#1#JAHAMA010000003.1_33204707_33808232_1"	115103	123525
"ENST00000370083.9"	1785	2	1784	"-"	"HG01175#2#JAHALZ010000031.1_43072077_43478977_1"	406900	231298	240091	1769	8793	0	"P"	557	1686	1686	1e-04	0	"HG01175#2#JAHALZ010000031.1_43072077_43478977_1"	"AMY1A-201"	"1"	"1-2-5-2-6-4-2-5-4-3-0"	"1.0-2.0-5.0-2.1-6.1-4.1-2.0-5.0-4.0-3.0-0.0"	43072232	"HG01175#2#JAHALZ010000031.1_43072077_43478977_1"	231298	240091
"ENST00000370083.9"	1785	2	1784	"+"	"HG01175#2#JAHALZ010000031.1_43072077_43478977_1"	406900	293770	302562	1769	8792	0	"S"	557	1686	NA	1e-04	0	"HG01175#2#JAHALZ010000031.1_43072077_43478977_1"	"AMY1A-201"	"1"	"1-2-5-2-6-4-2-5-4-3-0"	"1.0-2.0-5.0-2.1-6.1-4.1-2.0-5.0-4.0-3.0-0.0"	43072232	"HG01175#2#JAHALZ010000031.1_43072077_43478977_1"	293770	302562
"ENST00000370083.9"	1785	2	1784	"+"	"HG01175#2#JAHALZ010000031.1_43072077_43478977_1"	406900	199642	208434	1769	8792	0	"S"	557	1686	NA	1e-04	0	"HG01175#2#JAHALZ010000031.1_43072077_43478977_1"	"AMY1A-201"	"1"	"1-2-5-2-6-4-2-5-4-3-0"	"1.0-2.0-5.0-2.1-6.1-4.1-2.0-5.0-4.0-3.0-0.0"	43072232	"HG01175#2#JAHALZ010000031.1_43072077_43478977_1"	199642	208434
"ENST00000414303.7"	1584	4	1583	"+"	"HG01175#2#JAHALZ010000031.1_43072077_43478977_1"	406900	161390	169660	1574	8270	30	"P"	491	1499	1342	1e-04	0	"HG01175#2#JAHALZ010000031.1_43072077_43478977_1"	"AMY2A-201"	"2A"	"1-2-5-2-6-4-2-5-4-3-0"	"1.0-2.0-5.0-2.1-6.1-4.1-2.0-5.0-4.0-3.0-0.0"	43072232	"HG01175#2#JAHALZ010000031.1_43072077_43478977_1"	161390	169660
"ENST00000610648.1"	1736	4	1733	"+"	"HG01175#2#JAHALZ010000031.1_43072077_43478977_1"	406900	115062	123486	1720	8424	48	"P"	531	1638	1371	1e-04	0	"HG01175#2#JAHALZ010000031.1_43072077_43478977_1"	"AMY2B-208"	"2B"	"1-2-5-2-6-4-2-5-4-3-0"	"1.0-2.0-5.0-2.1-6.1-4.1-2.0-5.0-4.0-3.0-0.0"	43072232	"HG01175#2#JAHALZ010000031.1_43072077_43478977_1"	115062	123486
"ENST00000370083.9"	1785	2	1784	"+"	"HG01243#1#JAHEOY010000013.1_90081_424495_0"	334414	221339	230129	1769	8790	0	"P"	557	1686	1686	1e-04	0	"HG01243#1#JAHEOY010000013.1_90081_424495_0"	"AMY1A-201"	"1"	"1-2-5-2-4-3-0"	"1.0-2.0-5.1-2.1-4.0-3.0-0.0"	90179	"HG01243#1#JAHEOY010000013.1_90081_424495_0"	221339	230129
"ENST00000370083.9"	1785	2	1784	"-"	"HG01243#1#JAHEOY010000013.1_90081_424495_0"	334414	158859	167652	1769	8793	0	"S"	557	1686	NA	1e-04	0	"HG01243#1#JAHEOY010000013.1_90081_424495_0"	"AMY1A-201"	"1"	"1-2-5-2-4-3-0"	"1.0-2.0-5.1-2.1-4.0-3.0-0.0"	90179	"HG01243#1#JAHEOY010000013.1_90081_424495_0"	158859	167652
"ENST00000610648.1"	1736	4	1733	"+"	"HG01243#1#JAHEOY010000013.1_90081_424495_0"	334414	115035	123457	1720	8422	48	"P"	531	1638	1371	1e-04	0	"HG01243#1#JAHEOY010000013.1_90081_424495_0"	"AMY2B-208"	"2B"	"1-2-5-2-4-3-0"	"1.0-2.0-5.1-2.1-4.0-3.0-0.0"	90179	"HG01243#1#JAHEOY010000013.1_90081_424495_0"	115035	123457
"ENST00000370083.9"	1785	2	1784	"+"	"HG01258#1#JAGYYV010000004.1_56955948_57456952_1"	501004	293820	302612	1769	8792	0	"P"	557	1686	1686	1e-04	0	"HG01258#1#JAGYYV010000004.1_56955948_57456952_1"	"AMY1A-201"	"1"	"1-2-5-2-4-2-5-2-4-2-5-4-3-0"	"1.0-2.0-5.0-2.1-4.0-2.0-5.0-2.1-4.1-2.0-5.0-4.0-3.0-0.0"	56956103	"HG01258#1#JAGYYV010000004.1_56955948_57456952_1"	293820	302612
"ENST00000370083.9"	1785	2	1784	"-"	"HG01258#1#JAGYYV010000004.1_56955948_57456952_1"	501004	325475	334268	1769	8793	0	"S"	557	1686	NA	1e-04	0	"HG01258#1#JAGYYV010000004.1_56955948_57456952_1"	"AMY1A-201"	"1"	"1-2-5-2-4-2-5-2-4-2-5-4-3-0"	"1.0-2.0-5.0-2.1-4.0-2.0-5.0-2.1-4.1-2.0-5.0-4.0-3.0-0.0"	56956103	"HG01258#1#JAGYYV010000004.1_56955948_57456952_1"	325475	334268
"ENST00000370083.9"	1785	2	1784	"+"	"HG01258#1#JAGYYV010000004.1_56955948_57456952_1"	501004	387949	396742	1769	8793	0	"S"	557	1686	NA	1e-04	0	"HG01258#1#JAGYYV010000004.1_56955948_57456952_1"	"AMY1A-201"	"1"	"1-2-5-2-4-2-5-2-4-2-5-4-3-0"	"1.0-2.0-5.0-2.1-4.0-2.0-5.0-2.1-4.1-2.0-5.0-4.0-3.0-0.0"	56956103	"HG01258#1#JAGYYV010000004.1_56955948_57456952_1"	387949	396742
"ENST00000370083.9"	1785	2	1784	"+"	"HG01258#1#JAGYYV010000004.1_56955948_57456952_1"	501004	199693	208487	1769	8794	0	"S"	557	1686	NA	1e-04	0	"HG01258#1#JAGYYV010000004.1_56955948_57456952_1"	"AMY1A-201"	"1"	"1-2-5-2-4-2-5-2-4-2-5-4-3-0"	"1.0-2.0-5.0-2.1-4.0-2.0-5.0-2.1-4.1-2.0-5.0-4.0-3.0-0.0"	56956103	"HG01258#1#JAGYYV010000004.1_56955948_57456952_1"	199693	208487
"ENST00000370083.9"	1785	2	1784	"-"	"HG01258#1#JAGYYV010000004.1_56955948_57456952_1"	501004	231352	240147	1768	8795	0	"S"	553	1685	NA	6e-04	0	"HG01258#1#JAGYYV010000004.1_56955948_57456952_1"	"AMY1A-201"	"1"	"1-2-5-2-4-2-5-2-4-2-5-4-3-0"	"1.0-2.0-5.0-2.1-4.0-2.0-5.0-2.1-4.1-2.0-5.0-4.0-3.0-0.0"	56956103	"HG01258#1#JAGYYV010000004.1_56955948_57456952_1"	231352	240147
"ENST00000414303.7"	1584	4	1583	"+"	"HG01258#1#JAGYYV010000004.1_56955948_57456952_1"	501004	161440	169710	1574	8270	13	"P"	491	1499	1431	1e-04	0	"HG01258#1#JAGYYV010000004.1_56955948_57456952_1"	"AMY2A-201"	"2A"	"1-2-5-2-4-2-5-2-4-2-5-4-3-0"	"1.0-2.0-5.0-2.1-4.0-2.0-5.0-2.1-4.1-2.0-5.0-4.0-3.0-0.0"	56956103	"HG01258#1#JAGYYV010000004.1_56955948_57456952_1"	161440	169710
"ENST00000610648.1"	1736	4	1733	"+"	"HG01258#1#JAGYYV010000004.1_56955948_57456952_1"	501004	115110	123534	1720	8424	48	"P"	531	1638	1371	1e-04	0	"HG01258#1#JAGYYV010000004.1_56955948_57456952_1"	"AMY2B-208"	"2B"	"1-2-5-2-4-2-5-2-4-2-5-4-3-0"	"1.0-2.0-5.0-2.1-4.0-2.0-5.0-2.1-4.1-2.0-5.0-4.0-3.0-0.0"	56956103	"HG01258#1#JAGYYV010000004.1_56955948_57456952_1"	115110	123534
"ENST00000370083.9"	1785	2	1784	"-"	"HG01258#2#JAGYYU010000072.1_51562603_51970395_0"	407792	231288	240081	1769	8793	0	"P"	557	1686	1686	1e-04	0	"HG01258#2#JAGYYU010000072.1_51562603_51970395_0"	"AMY1A-201"	"1"	"1-2-5-2-4-2-5-4-3-0"	"1.0-2.0-5.1-2.1-4.0-2.0-5.0-4.0-3.0-0.0"	51562701	"HG01258#2#JAGYYU010000072.1_51562603_51970395_0"	231288	240081
"ENST00000370083.9"	1785	2	1784	"+"	"HG01258#2#JAGYYU010000072.1_51562603_51970395_0"	407792	199634	208425	1769	8791	0	"S"	557	1686	NA	1e-04	0	"HG01258#2#JAGYYU010000072.1_51562603_51970395_0"	"AMY1A-201"	"1"	"1-2-5-2-4-2-5-4-3-0"	"1.0-2.0-5.1-2.1-4.0-2.0-5.0-4.0-3.0-0.0"	51562701	"HG01258#2#JAGYYU010000072.1_51562603_51970395_0"	199634	208425
"ENST00000370083.9"	1785	2	1784	"+"	"HG01258#2#JAGYYU010000072.1_51562603_51970395_0"	407792	293767	302561	1769	8794	0	"S"	557	1686	NA	1e-04	0	"HG01258#2#JAGYYU010000072.1_51562603_51970395_0"	"AMY1A-201"	"1"	"1-2-5-2-4-2-5-4-3-0"	"1.0-2.0-5.1-2.1-4.0-2.0-5.0-4.0-3.0-0.0"	51562701	"HG01258#2#JAGYYU010000072.1_51562603_51970395_0"	293767	302561
"ENST00000414303.7"	1584	4	1583	"+"	"HG01258#2#JAGYYU010000072.1_51562603_51970395_0"	407792	161380	169650	1574	8270	30	"P"	491	1499	1342	1e-04	0	"HG01258#2#JAGYYU010000072.1_51562603_51970395_0"	"AMY2A-201"	"2A"	"1-2-5-2-4-2-5-4-3-0"	"1.0-2.0-5.1-2.1-4.0-2.0-5.0-4.0-3.0-0.0"	51562701	"HG01258#2#JAGYYU010000072.1_51562603_51970395_0"	161380	169650
"ENST00000610648.1"	1736	4	1733	"+"	"HG01258#2#JAGYYU010000072.1_51562603_51970395_0"	407792	115043	123465	1720	8422	48	"P"	531	1638	1371	1e-04	0	"HG01258#2#JAGYYU010000072.1_51562603_51970395_0"	"AMY2B-208"	"2B"	"1-2-5-2-4-2-5-4-3-0"	"1.0-2.0-5.1-2.1-4.0-2.0-5.0-4.0-3.0-0.0"	51562701	"HG01258#2#JAGYYU010000072.1_51562603_51970395_0"	115043	123465
"ENST00000370083.9"	1785	2	1784	"+"	"HG01358#1#JAGYZB010000020.1_27445742_27855492_1"	409750	199685	208464	1769	8779	0	"P"	557	1686	1686	1e-04	0	"HG01358#1#JAGYZB010000020.1_27445742_27855492_1"	"AMY1A-201"	"1"	"1-2-5-2-4-4-2-5-4-6-3-0"	"1.0-2.0-5.1-2.1-4.0-4.1-2.0-5.0-4.0-6.0-3.0-0.0"	27445896	"HG01358#1#JAGYZB010000020.1_27445742_27855492_1"	199685	208464
"ENST00000370083.9"	1785	2	1784	"+"	"HG01358#1#JAGYZB010000020.1_27445742_27855492_1"	409750	296696	305486	1769	8790	0	"S"	557	1686	NA	1e-04	0	"HG01358#1#JAGYZB010000020.1_27445742_27855492_1"	"AMY1A-201"	"1"	"1-2-5-2-4-4-2-5-4-6-3-0"	"1.0-2.0-5.1-2.1-4.0-4.1-2.0-5.0-4.0-6.0-3.0-0.0"	27445896	"HG01358#1#JAGYZB010000020.1_27445742_27855492_1"	296696	305486
"ENST00000370083.9"	1785	2	1784	"-"	"HG01358#1#JAGYZB010000020.1_27445742_27855492_1"	409750	234224	243014	1769	8790	0	"S"	557	1686	NA	1e-04	0	"HG01358#1#JAGYZB010000020.1_27445742_27855492_1"	"AMY1A-201"	"1"	"1-2-5-2-4-4-2-5-4-6-3-0"	"1.0-2.0-5.1-2.1-4.0-4.1-2.0-5.0-4.0-6.0-3.0-0.0"	27445896	"HG01358#1#JAGYZB010000020.1_27445742_27855492_1"	234224	243014
"ENST00000414303.7"	1584	4	1583	"+"	"HG01358#1#JAGYZB010000020.1_27445742_27855492_1"	409750	161430	169700	1563	8270	32	"P"	488	1488	1324	5e-04	0	"HG01358#1#JAGYZB010000020.1_27445742_27855492_1"	"AMY2A-201"	"2A"	"1-2-5-2-4-4-2-5-4-6-3-0"	"1.0-2.0-5.1-2.1-4.0-4.1-2.0-5.0-4.0-6.0-3.0-0.0"	27445896	"HG01358#1#JAGYZB010000020.1_27445742_27855492_1"	161430	169700
"ENST00000610648.1"	1736	4	1733	"+"	"HG01358#1#JAGYZB010000020.1_27445742_27855492_1"	409750	115094	123516	1711	8422	46	"P"	518	1629	1371	0.0018	0	"HG01358#1#JAGYZB010000020.1_27445742_27855492_1"	"AMY2B-208"	"2B"	"1-2-5-2-4-4-2-5-4-6-3-0"	"1.0-2.0-5.1-2.1-4.0-4.1-2.0-5.0-4.0-6.0-3.0-0.0"	27445896	"HG01358#1#JAGYZB010000020.1_27445742_27855492_1"	115094	123516
"ENST00000370083.9"	1785	2	1784	"+"	"HG01358#2#JAGYZA010000086.1_556_316498_0"	315942	202735	211527	1769	8792	0	"P"	557	1686	1686	1e-04	0	"HG01358#2#JAGYZA010000086.1_556_316498_0"	"AMY1A-201"	"1"	"1-2-5-2-6-4-2-5-2-6-4-2"	"1.0-2.0-5.0-2.1-6.1-4.1-2.0-5.1-2.1-6.1-4.1-2.0"	681	"HG01358#2#JAGYZA010000086.1_556_316498_0"	202735	211527
"ENST00000370083.9"	1785	2	1784	"+"	"HG01358#2#JAGYZA010000086.1_556_316498_0"	315942	14436	23229	1769	8793	0	"S"	557	1686	NA	1e-04	0	"HG01358#2#JAGYZA010000086.1_556_316498_0"	"AMY1A-201"	"1"	"1-2-5-2-6-4-2-5-2-6-4-2"	"1.0-2.0-5.0-2.1-6.1-4.1-2.0-5.1-2.1-6.1-4.1-2.0"	681	"HG01358#2#JAGYZA010000086.1_556_316498_0"	14436	23229
"ENST00000370083.9"	1785	2	1784	"-"	"HG01358#2#JAGYZA010000086.1_556_316498_0"	315942	46097	54890	1769	8793	0	"S"	557	1686	NA	1e-04	0	"HG01358#2#JAGYZA010000086.1_556_316498_0"	"AMY1A-201"	"1"	"1-2-5-2-6-4-2-5-2-6-4-2"	"1.0-2.0-5.0-2.1-6.1-4.1-2.0-5.1-2.1-6.1-4.1-2.0"	681	"HG01358#2#JAGYZA010000086.1_556_316498_0"	46097	54890
"ENST00000370083.9"	1785	2	1784	"-"	"HG01358#2#JAGYZA010000086.1_556_316498_0"	315942	140246	149039	1769	8793	0	"S"	557	1686	NA	1e-04	0	"HG01358#2#JAGYZA010000086.1_556_316498_0"	"AMY1A-201"	"1"	"1-2-5-2-6-4-2-5-2-6-4-2"	"1.0-2.0-5.0-2.1-6.1-4.1-2.0-5.1-2.1-6.1-4.1-2.0"	681	"HG01358#2#JAGYZA010000086.1_556_316498_0"	140246	149039
"ENST00000370083.9"	1785	2	1784	"+"	"HG01358#2#JAGYZA010000086.1_556_316498_0"	315942	108592	117384	1769	8792	0	"S"	557	1686	NA	1e-04	0	"HG01358#2#JAGYZA010000086.1_556_316498_0"	"AMY1A-201"	"1"	"1-2-5-2-6-4-2-5-2-6-4-2"	"1.0-2.0-5.0-2.1-6.1-4.1-2.0-5.1-2.1-6.1-4.1-2.0"	681	"HG01358#2#JAGYZA010000086.1_556_316498_0"	108592	117384
"ENST00000370083.9"	1785	2	1784	"+"	"HG01361#1#JAGYYX010000012.1_51565085_51878780_0"	313695	199653	208444	1769	8791	50	"P"	557	1686	1397	1e-04	0	"HG01361#1#JAGYYX010000012.1_51565085_51878780_0"	"AMY1A-201"	"1"	"1-2-5-4-6-3-0"	"1.0-2.0-5.0-4.0-6.0-3.0-0.0"	51565183	"HG01361#1#JAGYYX010000012.1_51565085_51878780_0"	199653	208444
"ENST00000414303.7"	1584	4	1579	"+"	"HG01361#1#JAGYYX010000012.1_51565085_51878780_0"	313695	161394	169660	1563	8266	28	"P"	484	1488	1342	0.001	0	"HG01361#1#JAGYYX010000012.1_51565085_51878780_0"	"AMY2A-201"	"2A"	"1-2-5-4-6-3-0"	"1.0-2.0-5.0-4.0-6.0-3.0-0.0"	51565183	"HG01361#1#JAGYYX010000012.1_51565085_51878780_0"	161394	169660
"ENST00000610648.1"	1736	4	1733	"+"	"HG01361#1#JAGYYX010000012.1_51565085_51878780_0"	313695	115069	123491	1720	8422	51	"P"	531	1638	1351	1e-04	0	"HG01361#1#JAGYYX010000012.1_51565085_51878780_0"	"AMY2B-208"	"2B"	"1-2-5-4-6-3-0"	"1.0-2.0-5.0-4.0-6.0-3.0-0.0"	51565183	"HG01361#1#JAGYYX010000012.1_51565085_51878780_0"	115069	123491
"ENST00000370083.9"	1785	2	1784	"+"	"HG01361#2#JAGYYW010000015.1_51517456_51831163_0"	313707	199649	208440	1769	8791	51	"P"	557	1686	1393	1e-04	0	"HG01361#2#JAGYYW010000015.1_51517456_51831163_0"	"AMY1A-201"	"1"	"1-2-5-4-6-3-0"	"1.0-2.0-5.0-4.0-6.0-3.0-0.0"	51517554	"HG01361#2#JAGYYW010000015.1_51517456_51831163_0"	199649	208440
"ENST00000414303.7"	1584	4	1579	"+"	"HG01361#2#JAGYYW010000015.1_51517456_51831163_0"	313707	161390	169656	1559	8266	27	"P"	483	1484	1342	0.0011	0	"HG01361#2#JAGYYW010000015.1_51517456_51831163_0"	"AMY2A-201"	"2A"	"1-2-5-4-6-3-0"	"1.0-2.0-5.0-4.0-6.0-3.0-0.0"	51517554	"HG01361#2#JAGYYW010000015.1_51517456_51831163_0"	161390	169656
"ENST00000610648.1"	1736	4	1733	"+"	"HG01361#2#JAGYYW010000015.1_51517456_51831163_0"	313707	115070	123492	1720	8422	52	"P"	531	1638	1347	1e-04	0	"HG01361#2#JAGYYW010000015.1_51517456_51831163_0"	"AMY2B-208"	"2B"	"1-2-5-4-6-3-0"	"1.0-2.0-5.0-4.0-6.0-3.0-0.0"	51517554	"HG01361#2#JAGYYW010000015.1_51517456_51831163_0"	115070	123492
"ENST00000370083.9"	1785	2	1784	"+"	"HG01891#1#JAGYVO010000014.1_22855818_23168577_1"	312759	199682	208472	1769	8790	47	"P"	557	1686	1415	1e-04	0	"HG01891#1#JAGYVO010000014.1_22855818_23168577_1"	"AMY1A-201"	"1"	"1-2-5-4-6-3-0"	"1.0-2.0-5.0-4.0-6.0-3.0-0.0"	22855972	"HG01891#1#JAGYVO010000014.1_22855818_23168577_1"	199682	208472
"ENST00000414303.7"	1584	4	1583	"+"	"HG01891#1#JAGYVO010000014.1_22855818_23168577_1"	312759	161430	169693	1569	8263	29	"P"	486	1494	1342	1e-04	0	"HG01891#1#JAGYVO010000014.1_22855818_23168577_1"	"AMY2A-201"	"2A"	"1-2-5-4-6-3-0"	"1.0-2.0-5.0-4.0-6.0-3.0-0.0"	22855972	"HG01891#1#JAGYVO010000014.1_22855818_23168577_1"	161430	169693
"ENST00000610648.1"	1736	4	1733	"+"	"HG01891#1#JAGYVO010000014.1_22855818_23168577_1"	312759	115095	123517	1720	8422	50	"P"	531	1638	1360	1e-04	0	"HG01891#1#JAGYVO010000014.1_22855818_23168577_1"	"AMY2B-208"	"2B"	"1-2-5-4-6-3-0"	"1.0-2.0-5.0-4.0-6.0-3.0-0.0"	22855972	"HG01891#1#JAGYVO010000014.1_22855818_23168577_1"	115095	123517
"ENST00000370083.9"	1785	2	1784	"+"	"HG01928#1#JAGYVQ010000053.1_16676493_17083407_0"	406914	293749	302541	1769	8792	0	"P"	557	1686	1686	1e-04	0	"HG01928#1#JAGYVQ010000053.1_16676493_17083407_0"	"AMY1A-201"	"1"	"1-2-5-2-6-4-2-5-4-3-0"	"1.0-2.0-5.1-2.1-6.1-4.1-2.0-5.0-4.0-3.0-0.0"	16676592	"HG01928#1#JAGYVQ010000053.1_16676493_17083407_0"	293749	302541
"ENST00000370083.9"	1785	2	1784	"+"	"HG01928#1#JAGYVQ010000053.1_16676493_17083407_0"	406914	199597	208389	1769	8792	0	"S"	557	1686	NA	1e-04	0	"HG01928#1#JAGYVQ010000053.1_16676493_17083407_0"	"AMY1A-201"	"1"	"1-2-5-2-6-4-2-5-4-3-0"	"1.0-2.0-5.1-2.1-6.1-4.1-2.0-5.0-4.0-3.0-0.0"	16676592	"HG01928#1#JAGYVQ010000053.1_16676493_17083407_0"	199597	208389
"ENST00000370083.9"	1785	2	1784	"-"	"HG01928#1#JAGYVQ010000053.1_16676493_17083407_0"	406914	231255	240048	1769	8793	0	"S"	557	1686	NA	1e-04	0	"HG01928#1#JAGYVQ010000053.1_16676493_17083407_0"	"AMY1A-201"	"1"	"1-2-5-2-6-4-2-5-4-3-0"	"1.0-2.0-5.1-2.1-6.1-4.1-2.0-5.0-4.0-3.0-0.0"	16676592	"HG01928#1#JAGYVQ010000053.1_16676493_17083407_0"	231255	240048
"ENST00000414303.7"	1584	4	1583	"+"	"HG01928#1#JAGYVQ010000053.1_16676493_17083407_0"	406914	161343	169613	1574	8270	30	"P"	491	1499	1342	1e-04	0	"HG01928#1#JAGYVQ010000053.1_16676493_17083407_0"	"AMY2A-201"	"2A"	"1-2-5-2-6-4-2-5-4-3-0"	"1.0-2.0-5.1-2.1-6.1-4.1-2.0-5.0-4.0-3.0-0.0"	16676592	"HG01928#1#JAGYVQ010000053.1_16676493_17083407_0"	161343	169613
"ENST00000610648.1"	1736	4	1733	"+"	"HG01928#1#JAGYVQ010000053.1_16676493_17083407_0"	406914	115018	123438	1720	8420	48	"P"	531	1638	1371	1e-04	0	"HG01928#1#JAGYVQ010000053.1_16676493_17083407_0"	"AMY2B-208"	"2B"	"1-2-5-2-6-4-2-5-4-3-0"	"1.0-2.0-5.1-2.1-6.1-4.1-2.0-5.0-4.0-3.0-0.0"	16676592	"HG01928#1#JAGYVQ010000053.1_16676493_17083407_0"	115018	123438
"ENST00000370083.9"	1785	2	1784	"-"	"HG01928#1#JAGYVQ010000195.1_211_358290_0"	358079	185154	193947	1769	8793	0	"P"	557	1686	1686	1e-04	0	"HG01928#1#JAGYVQ010000195.1_211_358290_0"	"AMY1A-201"	"1"	"1-2-5-2-6-4-5-2-4-6-2-5-2-4-6-2-5-2"	"1.0-2.0-5.0-2.1-6.1-4.1-5.1-2.1-4.0-6.0-2.0-5.0-2.1-4.0-6.0-2.0-5.0-2.1"	1263	"HG01928#1#JAGYVQ010000195.1_211_358290_0"	185154	193947
"ENST00000370083.9"	1785	2	1784	"+"	"HG01928#1#JAGYVQ010000195.1_211_358290_0"	358079	153495	162288	1769	8793	0	"S"	557	1686	NA	1e-04	0	"HG01928#1#JAGYVQ010000195.1_211_358290_0"	"AMY1A-201"	"1"	"1-2-5-2-6-4-5-2-4-6-2-5-2-4-6-2-5-2"	"1.0-2.0-5.0-2.1-6.1-4.1-5.1-2.1-4.0-6.0-2.0-5.0-2.1-4.0-6.0-2.0-5.0-2.1"	1263	"HG01928#1#JAGYVQ010000195.1_211_358290_0"	153495	162288
"ENST00000370083.9"	1785	2	1784	"-"	"HG01928#1#JAGYVQ010000195.1_211_358290_0"	358079	257567	266361	1769	8794	0	"S"	557	1686	NA	1e-04	0	"HG01928#1#JAGYVQ010000195.1_211_358290_0"	"AMY1A-201"	"1"	"1-2-5-2-6-4-5-2-4-6-2-5-2-4-6-2-5-2"	"1.0-2.0-5.0-2.1-6.1-4.1-5.1-2.1-4.0-6.0-2.0-5.0-2.1-4.0-6.0-2.0-5.0-2.1"	1263	"HG01928#1#JAGYVQ010000195.1_211_358290_0"	257567	266361
"ENST00000370083.9"	1785	2	1784	"+"	"HG01928#1#JAGYVQ010000195.1_211_358290_0"	358079	59343	68137	1769	8794	0	"S"	557	1686	NA	1e-04	0	"HG01928#1#JAGYVQ010000195.1_211_358290_0"	"AMY1A-201"	"1"	"1-2-5-2-6-4-5-2-4-6-2-5-2-4-6-2-5-2"	"1.0-2.0-5.0-2.1-6.1-4.1-5.1-2.1-4.0-6.0-2.0-5.0-2.1-4.0-6.0-2.0-5.0-2.1"	1263	"HG01928#1#JAGYVQ010000195.1_211_358290_0"	59343	68137
"ENST00000370083.9"	1785	2	1784	"-"	"HG01928#1#JAGYVQ010000195.1_211_358290_0"	358079	90998	99792	1769	8794	0	"S"	557	1686	NA	1e-04	0	"HG01928#1#JAGYVQ010000195.1_211_358290_0"	"AMY1A-201"	"1"	"1-2-5-2-6-4-5-2-4-6-2-5-2-4-6-2-5-2"	"1.0-2.0-5.0-2.1-6.1-4.1-5.1-2.1-4.0-6.0-2.0-5.0-2.1-4.0-6.0-2.0-5.0-2.1"	1263	"HG01928#1#JAGYVQ010000195.1_211_358290_0"	90998	99792
"ENST00000370083.9"	1785	2	1784	"+"	"HG01928#1#JAGYVQ010000195.1_211_358290_0"	358079	320045	328837	1769	8792	0	"S"	557	1686	NA	1e-04	0	"HG01928#1#JAGYVQ010000195.1_211_358290_0"	"AMY1A-201"	"1"	"1-2-5-2-6-4-5-2-4-6-2-5-2-4-6-2-5-2"	"1.0-2.0-5.0-2.1-6.1-4.1-5.1-2.1-4.0-6.0-2.0-5.0-2.1-4.0-6.0-2.0-5.0-2.1"	1263	"HG01928#1#JAGYVQ010000195.1_211_358290_0"	320045	328837
"ENST00000414303.7"	1584	4	1583	"-"	"HG01928#1#JAGYVQ010000195.1_211_358290_0"	358079	223929	232199	1574	8270	12	"P"	491	1499	1435	1e-04	0	"HG01928#1#JAGYVQ010000195.1_211_358290_0"	"AMY2A-201"	"2A"	"1-2-5-2-6-4-5-2-4-6-2-5-2-4-6-2-5-2"	"1.0-2.0-5.0-2.1-6.1-4.1-5.1-2.1-4.0-6.0-2.0-5.0-2.1-4.0-6.0-2.0-5.0-2.1"	1263	"HG01928#1#JAGYVQ010000195.1_211_358290_0"	223929	232199
"ENST00000370083.9"	1785	2	1784	"+"	"HG01952#1#JAHAME010000077.1_16663592_16976329_0"	312737	199622	208412	1769	8790	49	"P"	557	1686	1404	1e-04	0	"HG01952#1#JAHAME010000077.1_16663592_16976329_0"	"AMY1A-201"	"1"	"1-2-5-4-3-0"	"1.0-2.0-5.0-4.0-3.0-0.0"	16663690	"HG01952#1#JAHAME010000077.1_16663592_16976329_0"	199622	208412
"ENST00000414303.7"	1584	4	1583	"+"	"HG01952#1#JAHAME010000077.1_16663592_16976329_0"	312737	161361	169631	1574	8270	30	"P"	491	1499	1342	1e-04	0	"HG01952#1#JAHAME010000077.1_16663592_16976329_0"	"AMY2A-201"	"2A"	"1-2-5-4-3-0"	"1.0-2.0-5.0-4.0-3.0-0.0"	16663690	"HG01952#1#JAHAME010000077.1_16663592_16976329_0"	161361	169631
"ENST00000610648.1"	1736	4	1733	"+"	"HG01952#1#JAHAME010000077.1_16663592_16976329_0"	312737	115044	123466	1720	8422	50	"P"	531	1638	1358	1e-04	0	"HG01952#1#JAHAME010000077.1_16663592_16976329_0"	"AMY2B-208"	"2B"	"1-2-5-4-3-0"	"1.0-2.0-5.0-4.0-3.0-0.0"	16663690	"HG01952#1#JAHAME010000077.1_16663592_16976329_0"	115044	123466
"ENST00000370083.9"	1785	2	1784	"+"	"HG01952#2#JAHAMD010000045.1_4381722_4883708_1"	501986	387940	396732	1769	8792	0	"P"	557	1686	1686	1e-04	0	"HG01952#2#JAHAMD010000045.1_4381722_4883708_1"	"AMY1A-201"	"1"	"1-2-5-2-4-6-2-5-2-6-4-2-5-4-3-0"	"1.0-2.0-5.0-2.1-4.0-6.0-2.0-5.1-2.1-6.1-4.1-2.0-5.0-4.0-3.0-0.0"	4381877	"HG01952#2#JAHAMD010000045.1_4381722_4883708_1"	387940	396732
"ENST00000370083.9"	1785	2	1784	"-"	"HG01952#2#JAHAMD010000045.1_4381722_4883708_1"	501986	325466	334258	1769	8792	0	"S"	557	1686	NA	1e-04	0	"HG01952#2#JAHAMD010000045.1_4381722_4883708_1"	"AMY1A-201"	"1"	"1-2-5-2-4-6-2-5-2-6-4-2-5-4-3-0"	"1.0-2.0-5.0-2.1-4.0-6.0-2.0-5.1-2.1-6.1-4.1-2.0-5.0-4.0-3.0-0.0"	4381877	"HG01952#2#JAHAMD010000045.1_4381722_4883708_1"	325466	334258
"ENST00000370083.9"	1785	2	1784	"-"	"HG01952#2#JAHAMD010000045.1_4381722_4883708_1"	501986	231313	240106	1769	8793	0	"S"	557	1686	NA	1e-04	0	"HG01952#2#JAHAMD010000045.1_4381722_4883708_1"	"AMY1A-201"	"1"	"1-2-5-2-4-6-2-5-2-6-4-2-5-4-3-0"	"1.0-2.0-5.0-2.1-4.0-6.0-2.0-5.1-2.1-6.1-4.1-2.0-5.0-4.0-3.0-0.0"	4381877	"HG01952#2#JAHAMD010000045.1_4381722_4883708_1"	231313	240106
"ENST00000370083.9"	1785	2	1784	"+"	"HG01952#2#JAHAMD010000045.1_4381722_4883708_1"	501986	199654	208447	1769	8793	0	"S"	557	1686	NA	1e-04	0	"HG01952#2#JAHAMD010000045.1_4381722_4883708_1"	"AMY1A-201"	"1"	"1-2-5-2-4-6-2-5-2-6-4-2-5-4-3-0"	"1.0-2.0-5.0-2.1-4.0-6.0-2.0-5.1-2.1-6.1-4.1-2.0-5.0-4.0-3.0-0.0"	4381877	"HG01952#2#JAHAMD010000045.1_4381722_4883708_1"	199654	208447
"ENST00000370083.9"	1785	2	1784	"+"	"HG01952#2#JAHAMD010000045.1_4381722_4883708_1"	501986	293809	302602	1761	8793	0	"S"	551	1678	NA	8e-04	0	"HG01952#2#JAHAMD010000045.1_4381722_4883708_1"	"AMY1A-201"	"1"	"1-2-5-2-4-6-2-5-2-6-4-2-5-4-3-0"	"1.0-2.0-5.0-2.1-4.0-6.0-2.0-5.1-2.1-6.1-4.1-2.0-5.0-4.0-3.0-0.0"	4381877	"HG01952#2#JAHAMD010000045.1_4381722_4883708_1"	293809	302602
"ENST00000414303.7"	1584	4	1583	"+"	"HG01952#2#JAHAMD010000045.1_4381722_4883708_1"	501986	161400	169670	1574	8270	12	"P"	491	1499	1435	1e-04	0	"HG01952#2#JAHAMD010000045.1_4381722_4883708_1"	"AMY2A-201"	"2A"	"1-2-5-2-4-6-2-5-2-6-4-2-5-4-3-0"	"1.0-2.0-5.0-2.1-4.0-6.0-2.0-5.1-2.1-6.1-4.1-2.0-5.0-4.0-3.0-0.0"	4381877	"HG01952#2#JAHAMD010000045.1_4381722_4883708_1"	161400	169670
"ENST00000610648.1"	1736	4	1733	"+"	"HG01952#2#JAHAMD010000045.1_4381722_4883708_1"	501986	115074	123496	1720	8422	48	"P"	531	1638	1371	1e-04	0	"HG01952#2#JAHAMD010000045.1_4381722_4883708_1"	"AMY2B-208"	"2B"	"1-2-5-2-4-6-2-5-2-6-4-2-5-4-3-0"	"1.0-2.0-5.0-2.1-4.0-6.0-2.0-5.1-2.1-6.1-4.1-2.0-5.0-4.0-3.0-0.0"	4381877	"HG01952#2#JAHAMD010000045.1_4381722_4883708_1"	115074	123496
"ENST00000370083.9"	1785	2	1784	"+"	"HG01978#1#JAGYVS010000002.1_51519970_52021951_0"	501981	293766	302558	1769	8792	0	"P"	557	1686	1686	1e-04	0	"HG01978#1#JAGYVS010000002.1_51519970_52021951_0"	"AMY1A-201"	"1"	"1-2-5-2-6-4-2-5-2-4-2-5-4-3-0"	"1.0-2.0-5.0-2.1-6.1-4.1-2.0-5.1-2.1-4.1-2.0-5.0-4.0-3.0-0.0"	51520069	"HG01978#1#JAGYVS010000002.1_51519970_52021951_0"	293766	302558
"ENST00000370083.9"	1785	2	1784	"+"	"HG01978#1#JAGYVS010000002.1_51519970_52021951_0"	501981	199615	208408	1769	8793	0	"S"	557	1686	NA	1e-04	0	"HG01978#1#JAGYVS010000002.1_51519970_52021951_0"	"AMY1A-201"	"1"	"1-2-5-2-6-4-2-5-2-4-2-5-4-3-0"	"1.0-2.0-5.0-2.1-6.1-4.1-2.0-5.1-2.1-4.1-2.0-5.0-4.0-3.0-0.0"	51520069	"HG01978#1#JAGYVS010000002.1_51519970_52021951_0"	199615	208408
"ENST00000370083.9"	1785	2	1784	"-"	"HG01978#1#JAGYVS010000002.1_51519970_52021951_0"	501981	325429	334220	1769	8791	0	"S"	557	1686	NA	1e-04	0	"HG01978#1#JAGYVS010000002.1_51519970_52021951_0"	"AMY1A-201"	"1"	"1-2-5-2-6-4-2-5-2-4-2-5-4-3-0"	"1.0-2.0-5.0-2.1-6.1-4.1-2.0-5.1-2.1-4.1-2.0-5.0-4.0-3.0-0.0"	51520069	"HG01978#1#JAGYVS010000002.1_51519970_52021951_0"	325429	334220
"ENST00000370083.9"	1785	2	1784	"+"	"HG01978#1#JAGYVS010000002.1_51519970_52021951_0"	501981	387895	396687	1769	8792	0	"S"	557	1686	NA	1e-04	0	"HG01978#1#JAGYVS010000002.1_51519970_52021951_0"	"AMY1A-201"	"1"	"1-2-5-2-6-4-2-5-2-4-2-5-4-3-0"	"1.0-2.0-5.0-2.1-6.1-4.1-2.0-5.1-2.1-4.1-2.0-5.0-4.0-3.0-0.0"	51520069	"HG01978#1#JAGYVS010000002.1_51519970_52021951_0"	387895	396687
"ENST00000370083.9"	1785	2	1784	"-"	"HG01978#1#JAGYVS010000002.1_51519970_52021951_0"	501981	231275	240068	1764	8793	0	"S"	552	1681	NA	7e-04	0	"HG01978#1#JAGYVS010000002.1_51519970_52021951_0"	"AMY1A-201"	"1"	"1-2-5-2-6-4-2-5-2-4-2-5-4-3-0"	"1.0-2.0-5.0-2.1-6.1-4.1-2.0-5.1-2.1-4.1-2.0-5.0-4.0-3.0-0.0"	51520069	"HG01978#1#JAGYVS010000002.1_51519970_52021951_0"	231275	240068
"ENST00000414303.7"	1584	4	1583	"+"	"HG01978#1#JAGYVS010000002.1_51519970_52021951_0"	501981	161364	169634	1574	8270	15	"P"	491	1499	1420	1e-04	0	"HG01978#1#JAGYVS010000002.1_51519970_52021951_0"	"AMY2A-201"	"2A"	"1-2-5-2-6-4-2-5-2-4-2-5-4-3-0"	"1.0-2.0-5.0-2.1-6.1-4.1-2.0-5.1-2.1-4.1-2.0-5.0-4.0-3.0-0.0"	51520069	"HG01978#1#JAGYVS010000002.1_51519970_52021951_0"	161364	169634
"ENST00000610648.1"	1736	4	1733	"+"	"HG01978#1#JAGYVS010000002.1_51519970_52021951_0"	501981	115037	123457	1720	8420	48	"P"	531	1638	1371	1e-04	0	"HG01978#1#JAGYVS010000002.1_51519970_52021951_0"	"AMY2B-208"	"2B"	"1-2-5-2-6-4-2-5-2-4-2-5-4-3-0"	"1.0-2.0-5.0-2.1-6.1-4.1-2.0-5.1-2.1-4.1-2.0-5.0-4.0-3.0-0.0"	51520069	"HG01978#1#JAGYVS010000002.1_51519970_52021951_0"	115037	123457
"ENST00000370083.9"	1785	2	1784	"-"	"HG01978#2#JAGYVR010000007.1_51532241_51939176_0"	406935	231280	240073	1769	8793	0	"P"	557	1686	1686	1e-04	0	"HG01978#2#JAGYVR010000007.1_51532241_51939176_0"	"AMY1A-201"	"1"	"1-2-5-2-6-4-2-5-4-3-0"	"1.0-2.0-5.1-2.1-6.1-4.1-2.0-5.0-4.0-3.0-0.0"	51532340	"HG01978#2#JAGYVR010000007.1_51532241_51939176_0"	231280	240073
"ENST00000370083.9"	1785	2	1784	"+"	"HG01978#2#JAGYVR010000007.1_51532241_51939176_0"	406935	293766	302558	1769	8792	0	"S"	557	1686	NA	1e-04	0	"HG01978#2#JAGYVR010000007.1_51532241_51939176_0"	"AMY1A-201"	"1"	"1-2-5-2-6-4-2-5-4-3-0"	"1.0-2.0-5.1-2.1-6.1-4.1-2.0-5.0-4.0-3.0-0.0"	51532340	"HG01978#2#JAGYVR010000007.1_51532241_51939176_0"	293766	302558
"ENST00000370083.9"	1785	2	1784	"+"	"HG01978#2#JAGYVR010000007.1_51532241_51939176_0"	406935	199617	208410	1769	8793	0	"S"	557	1686	NA	1e-04	0	"HG01978#2#JAGYVR010000007.1_51532241_51939176_0"	"AMY1A-201"	"1"	"1-2-5-2-6-4-2-5-4-3-0"	"1.0-2.0-5.1-2.1-6.1-4.1-2.0-5.0-4.0-3.0-0.0"	51532340	"HG01978#2#JAGYVR010000007.1_51532241_51939176_0"	199617	208410
"ENST00000414303.7"	1584	4	1583	"+"	"HG01978#2#JAGYVR010000007.1_51532241_51939176_0"	406935	161359	169629	1574	8270	30	"P"	491	1499	1342	1e-04	0	"HG01978#2#JAGYVR010000007.1_51532241_51939176_0"	"AMY2A-201"	"2A"	"1-2-5-2-6-4-2-5-4-3-0"	"1.0-2.0-5.1-2.1-6.1-4.1-2.0-5.0-4.0-3.0-0.0"	51532340	"HG01978#2#JAGYVR010000007.1_51532241_51939176_0"	161359	169629
"ENST00000610648.1"	1736	4	1733	"+"	"HG01978#2#JAGYVR010000007.1_51532241_51939176_0"	406935	115029	123449	1720	8420	48	"P"	531	1638	1371	1e-04	0	"HG01978#2#JAGYVR010000007.1_51532241_51939176_0"	"AMY2B-208"	"2B"	"1-2-5-2-6-4-2-5-4-3-0"	"1.0-2.0-5.1-2.1-6.1-4.1-2.0-5.0-4.0-3.0-0.0"	51532340	"HG01978#2#JAGYVR010000007.1_51532241_51939176_0"	115029	123449
"ENST00000370083.9"	1785	2	1784	"+"	"HG02055#2#JAHEPJ010000017.1_24870122_25298560_1"	428438	199653	208433	1769	8780	0	"P"	557	1686	1686	1e-04	0	"HG02055#2#JAHEPJ010000017.1_24870122_25298560_1"	"AMY1A-201"	"1"	"1-2-5-4-6-3-0-4-2-5-4-6-3-0"	"1.0-2.0-5.0-4.0-6.0-3.0-0.0-4.1-2.0-5.0-4.0-6.0-3.0-0.0"	24870276	"HG02055#2#JAHEPJ010000017.1_24870122_25298560_1"	199653	208433
"ENST00000370083.9"	1785	2	1784	"+"	"HG02055#2#JAHEPJ010000017.1_24870122_25298560_1"	428438	315399	324194	1769	8795	0	"S"	557	1686	NA	1e-04	0	"HG02055#2#JAHEPJ010000017.1_24870122_25298560_1"	"AMY1A-201"	"1"	"1-2-5-4-6-3-0-4-2-5-4-6-3-0"	"1.0-2.0-5.0-4.0-6.0-3.0-0.0-4.1-2.0-5.0-4.0-6.0-3.0-0.0"	24870276	"HG02055#2#JAHEPJ010000017.1_24870122_25298560_1"	315399	324194
"ENST00000414303.7"	1584	4	1583	"+"	"HG02055#2#JAHEPJ010000017.1_24870122_25298560_1"	428438	161393	169663	1563	8270	0	"P"	488	1488	1488	5e-04	0	"HG02055#2#JAHEPJ010000017.1_24870122_25298560_1"	"AMY2A-201"	"2A"	"1-2-5-4-6-3-0-4-2-5-4-6-3-0"	"1.0-2.0-5.0-4.0-6.0-3.0-0.0-4.1-2.0-5.0-4.0-6.0-3.0-0.0"	24870276	"HG02055#2#JAHEPJ010000017.1_24870122_25298560_1"	161393	169663
"ENST00000414303.7"	1584	4	1583	"+"	"HG02055#2#JAHEPJ010000017.1_24870122_25298560_1"	428438	277142	285412	1563	8270	0	"S"	488	1488	NA	5e-04	0	"HG02055#2#JAHEPJ010000017.1_24870122_25298560_1"	"AMY2A-201"	"2A"	"1-2-5-4-6-3-0-4-2-5-4-6-3-0"	"1.0-2.0-5.0-4.0-6.0-3.0-0.0-4.1-2.0-5.0-4.0-6.0-3.0-0.0"	24870276	"HG02055#2#JAHEPJ010000017.1_24870122_25298560_1"	277142	285412
"ENST00000610648.1"	1736	4	1733	"+"	"HG02055#2#JAHEPJ010000017.1_24870122_25298560_1"	428438	115054	123476	1720	8422	2	"P"	531	1638	1626	1e-04	0	"HG02055#2#JAHEPJ010000017.1_24870122_25298560_1"	"AMY2B-208"	"2B"	"1-2-5-4-6-3-0-4-2-5-4-6-3-0"	"1.0-2.0-5.0-4.0-6.0-3.0-0.0-4.1-2.0-5.0-4.0-6.0-3.0-0.0"	24870276	"HG02055#2#JAHEPJ010000017.1_24870122_25298560_1"	115054	123476
"ENST00000610648.1"	1736	4	1733	"+"	"HG02055#2#JAHEPJ010000017.1_24870122_25298560_1"	428438	230803	239225	1708	8422	0	"S"	527	1626	NA	6e-04	0	"HG02055#2#JAHEPJ010000017.1_24870122_25298560_1"	"AMY2B-208"	"2B"	"1-2-5-4-6-3-0-4-2-5-4-6-3-0"	"1.0-2.0-5.0-4.0-6.0-3.0-0.0-4.1-2.0-5.0-4.0-6.0-3.0-0.0"	24870276	"HG02055#2#JAHEPJ010000017.1_24870122_25298560_1"	230803	239225
"ENST00000370083.9"	1785	2	1784	"-"	"HG02080#1#JAHEOW010000048.1_16689583_17097287_0"	407704	231201	239992	1769	8791	0	"P"	557	1686	1686	1e-04	0	"HG02080#1#JAHEOW010000048.1_16689583_17097287_0"	"AMY1A-201"	"1"	"1-2-5-2-6-4-2-5-4-6-3-0"	"1.0-2.0-5.1-2.1-6.1-4.1-2.0-5.0-4.0-6.0-3.0-0.0"	16689681	"HG02080#1#JAHEOW010000048.1_16689583_17097287_0"	231201	239992
"ENST00000370083.9"	1785	2	1784	"+"	"HG02080#1#JAHEOW010000048.1_16689583_17097287_0"	407704	293662	302453	1769	8791	0	"S"	557	1686	NA	1e-04	0	"HG02080#1#JAHEOW010000048.1_16689583_17097287_0"	"AMY1A-201"	"1"	"1-2-5-2-6-4-2-5-4-6-3-0"	"1.0-2.0-5.1-2.1-6.1-4.1-2.0-5.0-4.0-6.0-3.0-0.0"	16689681	"HG02080#1#JAHEOW010000048.1_16689583_17097287_0"	293662	302453
"ENST00000370083.9"	1785	2	1784	"+"	"HG02080#1#JAHEOW010000048.1_16689583_17097287_0"	407704	199566	208357	1769	8791	0	"S"	557	1686	NA	1e-04	0	"HG02080#1#JAHEOW010000048.1_16689583_17097287_0"	"AMY1A-201"	"1"	"1-2-5-2-6-4-2-5-4-6-3-0"	"1.0-2.0-5.1-2.1-6.1-4.1-2.0-5.0-4.0-6.0-3.0-0.0"	16689681	"HG02080#1#JAHEOW010000048.1_16689583_17097287_0"	199566	208357
"ENST00000414303.7"	1584	4	1579	"+"	"HG02080#1#JAHEOW010000048.1_16689583_17097287_0"	407704	161314	169580	1563	8266	28	"P"	484	1488	1342	0.001	0	"HG02080#1#JAHEOW010000048.1_16689583_17097287_0"	"AMY2A-201"	"2A"	"1-2-5-2-6-4-2-5-4-6-3-0"	"1.0-2.0-5.1-2.1-6.1-4.1-2.0-5.0-4.0-6.0-3.0-0.0"	16689681	"HG02080#1#JAHEOW010000048.1_16689583_17097287_0"	161314	169580
"ENST00000610648.1"	1736	4	1733	"+"	"HG02080#1#JAHEOW010000048.1_16689583_17097287_0"	407704	114996	123418	1720	8422	48	"P"	531	1638	1371	1e-04	0	"HG02080#1#JAHEOW010000048.1_16689583_17097287_0"	"AMY2B-208"	"2B"	"1-2-5-2-6-4-2-5-4-6-3-0"	"1.0-2.0-5.1-2.1-6.1-4.1-2.0-5.0-4.0-6.0-3.0-0.0"	16689681	"HG02080#1#JAHEOW010000048.1_16689583_17097287_0"	114996	123418
"ENST00000370083.9"	1785	2	1784	"-"	"HG02080#2#JAHEOV010000017.1_16662177_17164189_0"	502012	231299	240092	1769	8793	0	"P"	557	1686	1686	1e-04	0	"HG02080#2#JAHEOV010000017.1_16662177_17164189_0"	"AMY1A-201"	"1"	"1-2-5-2-6-4-2-5-2-6-4-2-5-4-3-0"	"1.0-2.0-5.0-2.1-6.1-4.1-2.0-5.0-2.1-6.1-4.1-2.0-5.0-4.0-3.0-0.0"	16662276	"HG02080#2#JAHEOV010000017.1_16662177_17164189_0"	231299	240092
"ENST00000370083.9"	1785	2	1784	"-"	"HG02080#2#JAHEOV010000017.1_16662177_17164189_0"	502012	325429	334220	1769	8791	0	"S"	557	1686	NA	1e-04	0	"HG02080#2#JAHEOV010000017.1_16662177_17164189_0"	"AMY1A-201"	"1"	"1-2-5-2-6-4-2-5-2-6-4-2-5-4-3-0"	"1.0-2.0-5.0-2.1-6.1-4.1-2.0-5.0-2.1-6.1-4.1-2.0-5.0-4.0-3.0-0.0"	16662276	"HG02080#2#JAHEOV010000017.1_16662177_17164189_0"	325429	334220
"ENST00000370083.9"	1785	2	1784	"+"	"HG02080#2#JAHEOV010000017.1_16662177_17164189_0"	502012	293773	302565	1769	8792	0	"S"	557	1686	NA	1e-04	0	"HG02080#2#JAHEOV010000017.1_16662177_17164189_0"	"AMY1A-201"	"1"	"1-2-5-2-6-4-2-5-2-6-4-2-5-4-3-0"	"1.0-2.0-5.0-2.1-6.1-4.1-2.0-5.0-2.1-6.1-4.1-2.0-5.0-4.0-3.0-0.0"	16662276	"HG02080#2#JAHEOV010000017.1_16662177_17164189_0"	293773	302565
"ENST00000370083.9"	1785	2	1784	"+"	"HG02080#2#JAHEOV010000017.1_16662177_17164189_0"	502012	199639	208432	1769	8793	0	"S"	557	1686	NA	1e-04	0	"HG02080#2#JAHEOV010000017.1_16662177_17164189_0"	"AMY1A-201"	"1"	"1-2-5-2-6-4-2-5-2-6-4-2-5-4-3-0"	"1.0-2.0-5.0-2.1-6.1-4.1-2.0-5.0-2.1-6.1-4.1-2.0-5.0-4.0-3.0-0.0"	16662276	"HG02080#2#JAHEOV010000017.1_16662177_17164189_0"	199639	208432
"ENST00000370083.9"	1785	2	1784	"+"	"HG02080#2#JAHEOV010000017.1_16662177_17164189_0"	502012	387911	396703	1769	8792	0	"S"	557	1686	NA	1e-04	0	"HG02080#2#JAHEOV010000017.1_16662177_17164189_0"	"AMY1A-201"	"1"	"1-2-5-2-6-4-2-5-2-6-4-2-5-4-3-0"	"1.0-2.0-5.0-2.1-6.1-4.1-2.0-5.0-2.1-6.1-4.1-2.0-5.0-4.0-3.0-0.0"	16662276	"HG02080#2#JAHEOV010000017.1_16662177_17164189_0"	387911	396703
"ENST00000414303.7"	1584	4	1583	"+"	"HG02080#2#JAHEOV010000017.1_16662177_17164189_0"	502012	161384	169654	1574	8270	16	"P"	491	1499	1417	1e-04	0	"HG02080#2#JAHEOV010000017.1_16662177_17164189_0"	"AMY2A-201"	"2A"	"1-2-5-2-6-4-2-5-2-6-4-2-5-4-3-0"	"1.0-2.0-5.0-2.1-6.1-4.1-2.0-5.0-2.1-6.1-4.1-2.0-5.0-4.0-3.0-0.0"	16662276	"HG02080#2#JAHEOV010000017.1_16662177_17164189_0"	161384	169654
"ENST00000610648.1"	1736	4	1733	"+"	"HG02080#2#JAHEOV010000017.1_16662177_17164189_0"	502012	115059	123483	1720	8424	48	"P"	531	1638	1371	1e-04	0	"HG02080#2#JAHEOV010000017.1_16662177_17164189_0"	"AMY2B-208"	"2B"	"1-2-5-2-6-4-2-5-2-6-4-2-5-4-3-0"	"1.0-2.0-5.0-2.1-6.1-4.1-2.0-5.0-2.1-6.1-4.1-2.0-5.0-4.0-3.0-0.0"	16662276	"HG02080#2#JAHEOV010000017.1_16662177_17164189_0"	115059	123483
"ENST00000370083.9"	1785	2	1784	"+"	"HG02109#1#JAHEPG010000026.1_16673035_17080816_0"	407781	293735	302525	1769	8790	0	"P"	557	1686	1686	1e-04	0	"HG02109#1#JAHEPG010000026.1_16673035_17080816_0"	"AMY1A-201"	"1"	"1-2-5-2-6-4-2-5-4-6-3-0"	"1.0-2.0-5.1-2.1-6.1-4.1-2.0-5.0-4.0-6.0-3.0-0.0"	16673133	"HG02109#1#JAHEPG010000026.1_16673035_17080816_0"	293735	302525
"ENST00000370083.9"	1785	2	1784	"-"	"HG02109#1#JAHEPG010000026.1_16673035_17080816_0"	407781	231273	240066	1769	8793	0	"S"	557	1686	NA	1e-04	0	"HG02109#1#JAHEPG010000026.1_16673035_17080816_0"	"AMY1A-201"	"1"	"1-2-5-2-6-4-2-5-4-6-3-0"	"1.0-2.0-5.1-2.1-6.1-4.1-2.0-5.0-4.0-6.0-3.0-0.0"	16673133	"HG02109#1#JAHEPG010000026.1_16673035_17080816_0"	231273	240066
"ENST00000370083.9"	1785	2	1784	"+"	"HG02109#1#JAHEPG010000026.1_16673035_17080816_0"	407781	199620	208413	1769	8793	0	"S"	557	1686	NA	1e-04	0	"HG02109#1#JAHEPG010000026.1_16673035_17080816_0"	"AMY1A-201"	"1"	"1-2-5-2-6-4-2-5-4-6-3-0"	"1.0-2.0-5.1-2.1-6.1-4.1-2.0-5.0-4.0-6.0-3.0-0.0"	16673133	"HG02109#1#JAHEPG010000026.1_16673035_17080816_0"	199620	208413
"ENST00000414303.7"	1584	4	1583	"+"	"HG02109#1#JAHEPG010000026.1_16673035_17080816_0"	407781	161367	169637	1569	8270	29	"P"	486	1494	1342	8e-04	0	"HG02109#1#JAHEPG010000026.1_16673035_17080816_0"	"AMY2A-201"	"2A"	"1-2-5-2-6-4-2-5-4-6-3-0"	"1.0-2.0-5.1-2.1-6.1-4.1-2.0-5.0-4.0-6.0-3.0-0.0"	16673133	"HG02109#1#JAHEPG010000026.1_16673035_17080816_0"	161367	169637
"ENST00000610648.1"	1736	4	1733	"+"	"HG02109#1#JAHEPG010000026.1_16673035_17080816_0"	407781	115035	123455	1720	8420	48	"P"	531	1638	1371	1e-04	0	"HG02109#1#JAHEPG010000026.1_16673035_17080816_0"	"AMY2B-208"	"2B"	"1-2-5-2-6-4-2-5-4-6-3-0"	"1.0-2.0-5.1-2.1-6.1-4.1-2.0-5.0-4.0-6.0-3.0-0.0"	16673133	"HG02109#1#JAHEPG010000026.1_16673035_17080816_0"	115035	123455
"ENST00000370083.9"	1785	2	1784	"+"	"HG02109#2#JAHEPF010000078.1_16678387_16991144_0"	312757	199639	208429	1769	8790	51	"P"	557	1686	1393	1e-04	0	"HG02109#2#JAHEPF010000078.1_16678387_16991144_0"	"AMY1A-201"	"1"	"1-2-5-4-6-3-0"	"1.0-2.0-5.0-4.0-6.0-3.0-0.0"	16678485	"HG02109#2#JAHEPF010000078.1_16678387_16991144_0"	199639	208429
"ENST00000414303.7"	1584	4	1583	"+"	"HG02109#2#JAHEPF010000078.1_16678387_16991144_0"	312757	161385	169655	1563	8270	28	"P"	488	1488	1342	5e-04	0	"HG02109#2#JAHEPF010000078.1_16678387_16991144_0"	"AMY2A-201"	"2A"	"1-2-5-4-6-3-0"	"1.0-2.0-5.0-4.0-6.0-3.0-0.0"	16678485	"HG02109#2#JAHEPF010000078.1_16678387_16991144_0"	161385	169655
"ENST00000610648.1"	1736	4	1733	"+"	"HG02109#2#JAHEPF010000078.1_16678387_16991144_0"	312757	115051	123475	1720	8424	52	"P"	531	1638	1347	1e-04	0	"HG02109#2#JAHEPF010000078.1_16678387_16991144_0"	"AMY2B-208"	"2B"	"1-2-5-4-6-3-0"	"1.0-2.0-5.0-4.0-6.0-3.0-0.0"	16678485	"HG02109#2#JAHEPF010000078.1_16678387_16991144_0"	115051	123475
"ENST00000370083.9"	1785	2	1784	"+"	"HG02145#1#JAHKSG010000134.1_2102465_2647653_1"	545188	431198	439988	1769	8790	0	"P"	557	1686	1686	1e-04	0	"HG02145#1#JAHKSG010000134.1_2102465_2647653_1"	"AMY1A-201"	"1"	"1-2-5-4-6-3-0-4-2-5-4-6-3-0-4-2-5-4-6-3-0"	"1.0-2.0-5.0-4.0-6.0-3.0-0.0-4.1-2.0-5.0-4.0-6.0-3.0-0.0-4.1-2.0-5.0-4.0-6.0-3.0-0.0"	2102619	"HG02145#1#JAHKSG010000134.1_2102465_2647653_1"	431198	439988
"ENST00000370083.9"	1785	2	1784	"+"	"HG02145#1#JAHKSG010000134.1_2102465_2647653_1"	545188	315448	324228	1769	8780	0	"S"	557	1686	NA	1e-04	0	"HG02145#1#JAHKSG010000134.1_2102465_2647653_1"	"AMY1A-201"	"1"	"1-2-5-4-6-3-0-4-2-5-4-6-3-0-4-2-5-4-6-3-0"	"1.0-2.0-5.0-4.0-6.0-3.0-0.0-4.1-2.0-5.0-4.0-6.0-3.0-0.0-4.1-2.0-5.0-4.0-6.0-3.0-0.0"	2102619	"HG02145#1#JAHKSG010000134.1_2102465_2647653_1"	315448	324228
"ENST00000370083.9"	1785	2	1784	"+"	"HG02145#1#JAHKSG010000134.1_2102465_2647653_1"	545188	199706	208485	1769	8779	0	"S"	557	1686	NA	1e-04	0	"HG02145#1#JAHKSG010000134.1_2102465_2647653_1"	"AMY1A-201"	"1"	"1-2-5-4-6-3-0-4-2-5-4-6-3-0-4-2-5-4-6-3-0"	"1.0-2.0-5.0-4.0-6.0-3.0-0.0-4.1-2.0-5.0-4.0-6.0-3.0-0.0-4.1-2.0-5.0-4.0-6.0-3.0-0.0"	2102619	"HG02145#1#JAHKSG010000134.1_2102465_2647653_1"	199706	208485
"ENST00000414303.7"	1584	4	1583	"+"	"HG02145#1#JAHKSG010000134.1_2102465_2647653_1"	545188	277194	285464	1563	8270	0	"P"	488	1488	1488	5e-04	0	"HG02145#1#JAHKSG010000134.1_2102465_2647653_1"	"AMY2A-201"	"2A"	"1-2-5-4-6-3-0-4-2-5-4-6-3-0-4-2-5-4-6-3-0"	"1.0-2.0-5.0-4.0-6.0-3.0-0.0-4.1-2.0-5.0-4.0-6.0-3.0-0.0-4.1-2.0-5.0-4.0-6.0-3.0-0.0"	2102619	"HG02145#1#JAHKSG010000134.1_2102465_2647653_1"	277194	285464
"ENST00000414303.7"	1584	4	1583	"+"	"HG02145#1#JAHKSG010000134.1_2102465_2647653_1"	545188	161447	169717	1563	8270	0	"S"	488	1488	NA	5e-04	0	"HG02145#1#JAHKSG010000134.1_2102465_2647653_1"	"AMY2A-201"	"2A"	"1-2-5-4-6-3-0-4-2-5-4-6-3-0-4-2-5-4-6-3-0"	"1.0-2.0-5.0-4.0-6.0-3.0-0.0-4.1-2.0-5.0-4.0-6.0-3.0-0.0-4.1-2.0-5.0-4.0-6.0-3.0-0.0"	2102619	"HG02145#1#JAHKSG010000134.1_2102465_2647653_1"	161447	169717
"ENST00000414303.7"	1584	4	1583	"+"	"HG02145#1#JAHKSG010000134.1_2102465_2647653_1"	545188	392939	401209	1563	8270	0	"S"	488	1488	NA	5e-04	0	"HG02145#1#JAHKSG010000134.1_2102465_2647653_1"	"AMY2A-201"	"2A"	"1-2-5-4-6-3-0-4-2-5-4-6-3-0-4-2-5-4-6-3-0"	"1.0-2.0-5.0-4.0-6.0-3.0-0.0-4.1-2.0-5.0-4.0-6.0-3.0-0.0-4.1-2.0-5.0-4.0-6.0-3.0-0.0"	2102619	"HG02145#1#JAHKSG010000134.1_2102465_2647653_1"	392939	401209
"ENST00000610648.1"	1736	4	1733	"+"	"HG02145#1#JAHKSG010000134.1_2102465_2647653_1"	545188	346601	355023	1720	8422	0	"P"	531	1638	1638	1e-04	0	"HG02145#1#JAHKSG010000134.1_2102465_2647653_1"	"AMY2B-208"	"2B"	"1-2-5-4-6-3-0-4-2-5-4-6-3-0-4-2-5-4-6-3-0"	"1.0-2.0-5.0-4.0-6.0-3.0-0.0-4.1-2.0-5.0-4.0-6.0-3.0-0.0-4.1-2.0-5.0-4.0-6.0-3.0-0.0"	2102619	"HG02145#1#JAHKSG010000134.1_2102465_2647653_1"	346601	355023
"ENST00000610648.1"	1736	4	1733	"+"	"HG02145#1#JAHKSG010000134.1_2102465_2647653_1"	545188	230856	239278	1720	8422	0	"S"	531	1638	NA	1e-04	0	"HG02145#1#JAHKSG010000134.1_2102465_2647653_1"	"AMY2B-208"	"2B"	"1-2-5-4-6-3-0-4-2-5-4-6-3-0-4-2-5-4-6-3-0"	"1.0-2.0-5.0-4.0-6.0-3.0-0.0-4.1-2.0-5.0-4.0-6.0-3.0-0.0-4.1-2.0-5.0-4.0-6.0-3.0-0.0"	2102619	"HG02145#1#JAHKSG010000134.1_2102465_2647653_1"	230856	239278
"ENST00000610648.1"	1736	4	1733	"+"	"HG02145#1#JAHKSG010000134.1_2102465_2647653_1"	545188	115109	123531	1720	8422	0	"S"	531	1638	NA	1e-04	0	"HG02145#1#JAHKSG010000134.1_2102465_2647653_1"	"AMY2B-208"	"2B"	"1-2-5-4-6-3-0-4-2-5-4-6-3-0-4-2-5-4-6-3-0"	"1.0-2.0-5.0-4.0-6.0-3.0-0.0-4.1-2.0-5.0-4.0-6.0-3.0-0.0-4.1-2.0-5.0-4.0-6.0-3.0-0.0"	2102619	"HG02145#1#JAHKSG010000134.1_2102465_2647653_1"	115109	123531
"ENST00000370083.9"	1785	2	1784	"+"	"HG02145#2#JAHKSF010000206.1_1005292_1413195_1"	407903	293903	302694	1769	8791	0	"P"	557	1686	1686	1e-04	0	"HG02145#2#JAHKSF010000206.1_1005292_1413195_1"	"AMY1A-201"	"1"	"1-2-5-2-6-4-2-5-4-6-3-0"	"1.0-2.0-5.0-2.1-6.1-4.1-2.0-5.0-4.0-6.0-3.0-0.0"	1005446	"HG02145#2#JAHKSF010000206.1_1005292_1413195_1"	293903	302694
"ENST00000370083.9"	1785	2	1784	"+"	"HG02145#2#JAHKSF010000206.1_1005292_1413195_1"	407903	199791	208581	1769	8790	0	"S"	557	1686	NA	1e-04	0	"HG02145#2#JAHKSF010000206.1_1005292_1413195_1"	"AMY1A-201"	"1"	"1-2-5-2-6-4-2-5-4-6-3-0"	"1.0-2.0-5.0-2.1-6.1-4.1-2.0-5.0-4.0-6.0-3.0-0.0"	1005446	"HG02145#2#JAHKSF010000206.1_1005292_1413195_1"	199791	208581
"ENST00000370083.9"	1785	2	1784	"-"	"HG02145#2#JAHKSF010000206.1_1005292_1413195_1"	407903	231440	240231	1769	8791	0	"S"	557	1686	NA	1e-04	0	"HG02145#2#JAHKSF010000206.1_1005292_1413195_1"	"AMY1A-201"	"1"	"1-2-5-2-6-4-2-5-4-6-3-0"	"1.0-2.0-5.0-2.1-6.1-4.1-2.0-5.0-4.0-6.0-3.0-0.0"	1005446	"HG02145#2#JAHKSF010000206.1_1005292_1413195_1"	231440	240231
"ENST00000414303.7"	1584	4	1583	"+"	"HG02145#2#JAHKSF010000206.1_1005292_1413195_1"	407903	161472	169777	1568	8305	29	"P"	486	1493	1342	8e-04	0	"HG02145#2#JAHKSF010000206.1_1005292_1413195_1"	"AMY2A-201"	"2A"	"1-2-5-2-6-4-2-5-4-6-3-0"	"1.0-2.0-5.0-2.1-6.1-4.1-2.0-5.0-4.0-6.0-3.0-0.0"	1005446	"HG02145#2#JAHKSF010000206.1_1005292_1413195_1"	161472	169777
"ENST00000610648.1"	1736	4	1733	"+"	"HG02145#2#JAHKSF010000206.1_1005292_1413195_1"	407903	115130	123552	1720	8422	48	"P"	531	1638	1371	1e-04	0	"HG02145#2#JAHKSF010000206.1_1005292_1413195_1"	"AMY2B-208"	"2B"	"1-2-5-2-6-4-2-5-4-6-3-0"	"1.0-2.0-5.0-2.1-6.1-4.1-2.0-5.0-4.0-6.0-3.0-0.0"	1005446	"HG02145#2#JAHKSF010000206.1_1005292_1413195_1"	115130	123552
"ENST00000370083.9"	1785	2	1784	"+"	"HG02148#1#JAHAMG010000059.1_19799474_20206456_1"	406982	293840	302632	1769	8792	0	"P"	557	1686	1686	1e-04	0	"HG02148#1#JAHAMG010000059.1_19799474_20206456_1"	"AMY1A-201"	"1"	"1-2-5-2-6-4-2-5-4-3-0"	"1.0-2.0-5.0-2.1-6.1-4.1-2.0-5.0-4.0-3.0-0.0"	19799629	"HG02148#1#JAHAMG010000059.1_19799474_20206456_1"	293840	302632
"ENST00000370083.9"	1785	2	1784	"+"	"HG02148#1#JAHAMG010000059.1_19799474_20206456_1"	406982	199719	208512	1769	8793	0	"S"	557	1686	NA	1e-04	0	"HG02148#1#JAHAMG010000059.1_19799474_20206456_1"	"AMY1A-201"	"1"	"1-2-5-2-6-4-2-5-4-3-0"	"1.0-2.0-5.0-2.1-6.1-4.1-2.0-5.0-4.0-3.0-0.0"	19799629	"HG02148#1#JAHAMG010000059.1_19799474_20206456_1"	199719	208512
"ENST00000370083.9"	1785	2	1784	"-"	"HG02148#1#JAHAMG010000059.1_19799474_20206456_1"	406982	231376	240170	1769	8794	0	"S"	557	1686	NA	1e-04	0	"HG02148#1#JAHAMG010000059.1_19799474_20206456_1"	"AMY1A-201"	"1"	"1-2-5-2-6-4-2-5-4-3-0"	"1.0-2.0-5.0-2.1-6.1-4.1-2.0-5.0-4.0-3.0-0.0"	19799629	"HG02148#1#JAHAMG010000059.1_19799474_20206456_1"	231376	240170
"ENST00000414303.7"	1584	4	1583	"+"	"HG02148#1#JAHAMG010000059.1_19799474_20206456_1"	406982	161462	169732	1574	8270	30	"P"	491	1499	1342	1e-04	0	"HG02148#1#JAHAMG010000059.1_19799474_20206456_1"	"AMY2A-201"	"2A"	"1-2-5-2-6-4-2-5-4-3-0"	"1.0-2.0-5.0-2.1-6.1-4.1-2.0-5.0-4.0-3.0-0.0"	19799629	"HG02148#1#JAHAMG010000059.1_19799474_20206456_1"	161462	169732
"ENST00000610648.1"	1736	4	1733	"+"	"HG02148#1#JAHAMG010000059.1_19799474_20206456_1"	406982	115136	123558	1720	8422	48	"P"	531	1638	1371	1e-04	0	"HG02148#1#JAHAMG010000059.1_19799474_20206456_1"	"AMY2B-208"	"2B"	"1-2-5-2-6-4-2-5-4-3-0"	"1.0-2.0-5.0-2.1-6.1-4.1-2.0-5.0-4.0-3.0-0.0"	19799629	"HG02148#1#JAHAMG010000059.1_19799474_20206456_1"	115136	123558
"ENST00000370083.9"	1785	2	1784	"+"	"HG02148#2#JAHAMF010000050.1_19456870_19863761_1"	406891	293836	302626	1769	8790	0	"P"	557	1686	1686	1e-04	0	"HG02148#2#JAHAMF010000050.1_19456870_19863761_1"	"AMY1A-201"	"1"	"1-2-5-2-4-2-5-4-3-0"	"1.0-2.0-5.1-2.1-4.0-2.0-5.0-4.0-3.0-0.0"	19457024	"HG02148#2#JAHAMF010000050.1_19456870_19863761_1"	293836	302626
"ENST00000370083.9"	1785	2	1784	"+"	"HG02148#2#JAHAMF010000050.1_19456870_19863761_1"	406891	199696	208489	1769	8793	0	"S"	557	1686	NA	1e-04	0	"HG02148#2#JAHAMF010000050.1_19456870_19863761_1"	"AMY1A-201"	"1"	"1-2-5-2-4-2-5-4-3-0"	"1.0-2.0-5.1-2.1-4.0-2.0-5.0-4.0-3.0-0.0"	19457024	"HG02148#2#JAHAMF010000050.1_19456870_19863761_1"	199696	208489
"ENST00000370083.9"	1785	2	1784	"-"	"HG02148#2#JAHAMF010000050.1_19456870_19863761_1"	406891	231351	240144	1767	8793	0	"S"	552	1684	NA	7e-04	0	"HG02148#2#JAHAMF010000050.1_19456870_19863761_1"	"AMY1A-201"	"1"	"1-2-5-2-4-2-5-4-3-0"	"1.0-2.0-5.1-2.1-4.0-2.0-5.0-4.0-3.0-0.0"	19457024	"HG02148#2#JAHAMF010000050.1_19456870_19863761_1"	231351	240144
"ENST00000414303.7"	1584	4	1583	"+"	"HG02148#2#JAHAMF010000050.1_19456870_19863761_1"	406891	161430	169700	1574	8270	30	"P"	491	1499	1342	1e-04	0	"HG02148#2#JAHAMF010000050.1_19456870_19863761_1"	"AMY2A-201"	"2A"	"1-2-5-2-4-2-5-4-3-0"	"1.0-2.0-5.1-2.1-4.0-2.0-5.0-4.0-3.0-0.0"	19457024	"HG02148#2#JAHAMF010000050.1_19456870_19863761_1"	161430	169700
"ENST00000610648.1"	1736	4	1733	"+"	"HG02148#2#JAHAMF010000050.1_19456870_19863761_1"	406891	115113	123535	1720	8422	47	"P"	531	1638	1373	1e-04	0	"HG02148#2#JAHAMF010000050.1_19456870_19863761_1"	"AMY2B-208"	"2B"	"1-2-5-2-4-2-5-4-3-0"	"1.0-2.0-5.1-2.1-4.0-2.0-5.0-4.0-3.0-0.0"	19457024	"HG02148#2#JAHAMF010000050.1_19456870_19863761_1"	115113	123535
"ENST00000370083.9"	1785	2	1784	"+"	"HG02257#1#JAGYVI010000005.1_101835875_102242843_0"	406968	293786	302577	1769	8791	0	"P"	557	1686	1686	1e-04	0	"HG02257#1#JAGYVI010000005.1_101835875_102242843_0"	"AMY1A-201"	"1"	"1-2-5-2-6-4-2-5-4-6-3-0"	"1.0-2.0-5.0-2.1-6.1-4.1-2.0-5.0-4.0-6.0-3.0-0.0"	101835973	"HG02257#1#JAGYVI010000005.1_101835875_102242843_0"	293786	302577
"ENST00000370083.9"	1785	2	1784	"-"	"HG02257#1#JAGYVI010000005.1_101835875_102242843_0"	406968	231323	240114	1769	8791	0	"S"	557	1686	NA	1e-04	0	"HG02257#1#JAGYVI010000005.1_101835875_102242843_0"	"AMY1A-201"	"1"	"1-2-5-2-6-4-2-5-4-6-3-0"	"1.0-2.0-5.0-2.1-6.1-4.1-2.0-5.0-4.0-6.0-3.0-0.0"	101835973	"HG02257#1#JAGYVI010000005.1_101835875_102242843_0"	231323	240114
"ENST00000370083.9"	1785	2	1784	"+"	"HG02257#1#JAGYVI010000005.1_101835875_102242843_0"	406968	199673	208463	1769	8790	0	"S"	557	1686	NA	1e-04	0	"HG02257#1#JAGYVI010000005.1_101835875_102242843_0"	"AMY1A-201"	"1"	"1-2-5-2-6-4-2-5-4-6-3-0"	"1.0-2.0-5.0-2.1-6.1-4.1-2.0-5.0-4.0-6.0-3.0-0.0"	101835973	"HG02257#1#JAGYVI010000005.1_101835875_102242843_0"	199673	208463
"ENST00000414303.7"	1584	4	1583	"+"	"HG02257#1#JAGYVI010000005.1_101835875_102242843_0"	406968	161370	169675	1562	8305	28	"P"	480	1487	1342	0.0016	0	"HG02257#1#JAGYVI010000005.1_101835875_102242843_0"	"AMY2A-201"	"2A"	"1-2-5-2-6-4-2-5-4-6-3-0"	"1.0-2.0-5.0-2.1-6.1-4.1-2.0-5.0-4.0-6.0-3.0-0.0"	101835973	"HG02257#1#JAGYVI010000005.1_101835875_102242843_0"	161370	169675
"ENST00000610648.1"	1736	4	1733	"+"	"HG02257#1#JAGYVI010000005.1_101835875_102242843_0"	406968	115037	123459	1720	8422	48	"P"	531	1638	1371	1e-04	0	"HG02257#1#JAGYVI010000005.1_101835875_102242843_0"	"AMY2B-208"	"2B"	"1-2-5-2-6-4-2-5-4-6-3-0"	"1.0-2.0-5.0-2.1-6.1-4.1-2.0-5.0-4.0-6.0-3.0-0.0"	101835973	"HG02257#1#JAGYVI010000005.1_101835875_102242843_0"	115037	123459
"ENST00000370083.9"	1785	2	1784	"-"	"HG02257#2#JAGYVH010000034.1_98190388_98857961_0"	667573	325402	334193	1769	8791	0	"P"	557	1686	1686	1e-04	0	"HG02257#2#JAGYVH010000034.1_98190388_98857961_0"	"AMY1A-201"	"1"	"1-2-5-2-4-6-2-5-4-6-2-5-2-4-6-2-5-4-6-2-5-2-4-6-3-0"	"1.0-2.0-5.1-2.1-4.0-6.0-2.0-5.0-4.0-6.0-2.0-5.1-2.1-4.0-6.0-2.0-5.0-4.0-6.0-2.0-5.1-2.1-4.0-6.0-3.0-0.0"	98190486	"HG02257#2#JAGYVH010000034.1_98190388_98857961_0"	325402	334193
"ENST00000370083.9"	1785	2	1784	"+"	"HG02257#2#JAGYVH010000034.1_98190388_98857961_0"	667573	293751	302541	1769	8790	0	"S"	557	1686	NA	1e-04	0	"HG02257#2#JAGYVH010000034.1_98190388_98857961_0"	"AMY1A-201"	"1"	"1-2-5-2-4-6-2-5-4-6-2-5-2-4-6-2-5-4-6-2-5-2-4-6-3-0"	"1.0-2.0-5.1-2.1-4.0-6.0-2.0-5.0-4.0-6.0-2.0-5.1-2.1-4.0-6.0-2.0-5.0-4.0-6.0-2.0-5.1-2.1-4.0-6.0-3.0-0.0"	98190486	"HG02257#2#JAGYVH010000034.1_98190388_98857961_0"	293751	302541
"ENST00000370083.9"	1785	2	1784	"+"	"HG02257#2#JAGYVH010000034.1_98190388_98857961_0"	667573	387881	396672	1769	8791	0	"S"	557	1686	NA	1e-04	0	"HG02257#2#JAGYVH010000034.1_98190388_98857961_0"	"AMY1A-201"	"1"	"1-2-5-2-4-6-2-5-4-6-2-5-2-4-6-2-5-4-6-2-5-2-4-6-3-0"	"1.0-2.0-5.1-2.1-4.0-6.0-2.0-5.0-4.0-6.0-2.0-5.1-2.1-4.0-6.0-2.0-5.0-4.0-6.0-2.0-5.1-2.1-4.0-6.0-3.0-0.0"	98190486	"HG02257#2#JAGYVH010000034.1_98190388_98857961_0"	387881	396672
"ENST00000370083.9"	1785	2	1784	"+"	"HG02257#2#JAGYVH010000034.1_98190388_98857961_0"	667573	221330	230120	1769	8790	0	"S"	557	1686	NA	1e-04	0	"HG02257#2#JAGYVH010000034.1_98190388_98857961_0"	"AMY1A-201"	"1"	"1-2-5-2-4-6-2-5-4-6-2-5-2-4-6-2-5-4-6-2-5-2-4-6-3-0"	"1.0-2.0-5.1-2.1-4.0-6.0-2.0-5.0-4.0-6.0-2.0-5.1-2.1-4.0-6.0-2.0-5.0-4.0-6.0-2.0-5.1-2.1-4.0-6.0-3.0-0.0"	98190486	"HG02257#2#JAGYVH010000034.1_98190388_98857961_0"	221330	230120
"ENST00000370083.9"	1785	2	1784	"+"	"HG02257#2#JAGYVH010000034.1_98190388_98857961_0"	667573	554421	563213	1769	8792	0	"S"	557	1686	NA	1e-04	0	"HG02257#2#JAGYVH010000034.1_98190388_98857961_0"	"AMY1A-201"	"1"	"1-2-5-2-4-6-2-5-4-6-2-5-2-4-6-2-5-4-6-2-5-2-4-6-3-0"	"1.0-2.0-5.1-2.1-4.0-6.0-2.0-5.0-4.0-6.0-2.0-5.1-2.1-4.0-6.0-2.0-5.0-4.0-6.0-2.0-5.1-2.1-4.0-6.0-3.0-0.0"	98190486	"HG02257#2#JAGYVH010000034.1_98190388_98857961_0"	554421	563213
"ENST00000370083.9"	1785	2	1784	"-"	"HG02257#2#JAGYVH010000034.1_98190388_98857961_0"	667573	158850	167641	1769	8791	0	"S"	557	1686	NA	1e-04	0	"HG02257#2#JAGYVH010000034.1_98190388_98857961_0"	"AMY1A-201"	"1"	"1-2-5-2-4-6-2-5-4-6-2-5-2-4-6-2-5-4-6-2-5-2-4-6-3-0"	"1.0-2.0-5.1-2.1-4.0-6.0-2.0-5.0-4.0-6.0-2.0-5.1-2.1-4.0-6.0-2.0-5.0-4.0-6.0-2.0-5.1-2.1-4.0-6.0-3.0-0.0"	98190486	"HG02257#2#JAGYVH010000034.1_98190388_98857961_0"	158850	167641
"ENST00000370083.9"	1785	2	1784	"-"	"HG02257#2#JAGYVH010000034.1_98190388_98857961_0"	667573	491948	500739	1769	8791	0	"S"	557	1686	NA	1e-04	0	"HG02257#2#JAGYVH010000034.1_98190388_98857961_0"	"AMY1A-201"	"1"	"1-2-5-2-4-6-2-5-4-6-2-5-2-4-6-2-5-4-6-2-5-2-4-6-3-0"	"1.0-2.0-5.1-2.1-4.0-6.0-2.0-5.0-4.0-6.0-2.0-5.1-2.1-4.0-6.0-2.0-5.0-4.0-6.0-2.0-5.1-2.1-4.0-6.0-3.0-0.0"	98190486	"HG02257#2#JAGYVH010000034.1_98190388_98857961_0"	491948	500739
"ENST00000370083.9"	1785	2	1784	"+"	"HG02257#2#JAGYVH010000034.1_98190388_98857961_0"	667573	460291	469083	1769	8792	0	"S"	557	1686	NA	1e-04	0	"HG02257#2#JAGYVH010000034.1_98190388_98857961_0"	"AMY1A-201"	"1"	"1-2-5-2-4-6-2-5-4-6-2-5-2-4-6-2-5-4-6-2-5-2-4-6-3-0"	"1.0-2.0-5.1-2.1-4.0-6.0-2.0-5.0-4.0-6.0-2.0-5.1-2.1-4.0-6.0-2.0-5.0-4.0-6.0-2.0-5.1-2.1-4.0-6.0-3.0-0.0"	98190486	"HG02257#2#JAGYVH010000034.1_98190388_98857961_0"	460291	469083
"ENST00000414303.7"	1584	4	1583	"+"	"HG02257#2#JAGYVH010000034.1_98190388_98857961_0"	667573	422037	430300	1571	8263	0	"P"	486	1496	1494	8e-04	0	"HG02257#2#JAGYVH010000034.1_98190388_98857961_0"	"AMY2A-201"	"2A"	"1-2-5-2-4-6-2-5-4-6-2-5-2-4-6-2-5-4-6-2-5-2-4-6-3-0"	"1.0-2.0-5.1-2.1-4.0-6.0-2.0-5.0-4.0-6.0-2.0-5.1-2.1-4.0-6.0-2.0-5.0-4.0-6.0-2.0-5.1-2.1-4.0-6.0-3.0-0.0"	98190486	"HG02257#2#JAGYVH010000034.1_98190388_98857961_0"	422037	430300
"ENST00000414303.7"	1584	4	1583	"+"	"HG02257#2#JAGYVH010000034.1_98190388_98857961_0"	667573	255485	263755	1569	8270	0	"S"	486	1494	NA	8e-04	0	"HG02257#2#JAGYVH010000034.1_98190388_98857961_0"	"AMY2A-201"	"2A"	"1-2-5-2-4-6-2-5-4-6-2-5-2-4-6-2-5-4-6-2-5-2-4-6-3-0"	"1.0-2.0-5.1-2.1-4.0-6.0-2.0-5.0-4.0-6.0-2.0-5.1-2.1-4.0-6.0-2.0-5.0-4.0-6.0-2.0-5.1-2.1-4.0-6.0-3.0-0.0"	98190486	"HG02257#2#JAGYVH010000034.1_98190388_98857961_0"	255485	263755
"ENST00000610648.1"	1736	4	1733	"+"	"HG02257#2#JAGYVH010000034.1_98190388_98857961_0"	667573	115031	123453	1712	8422	37	"P"	526	1630	1422	6e-04	0	"HG02257#2#JAGYVH010000034.1_98190388_98857961_0"	"AMY2B-208"	"2B"	"1-2-5-2-4-6-2-5-4-6-2-5-2-4-6-2-5-4-6-2-5-2-4-6-3-0"	"1.0-2.0-5.1-2.1-4.0-6.0-2.0-5.0-4.0-6.0-2.0-5.1-2.1-4.0-6.0-2.0-5.0-4.0-6.0-2.0-5.1-2.1-4.0-6.0-3.0-0.0"	98190486	"HG02257#2#JAGYVH010000034.1_98190388_98857961_0"	115031	123453
"ENST00000370083.9"	1785	2	1784	"-"	"HG02486#1#JAGYVM010000007.1_28868414_29370339_1"	501925	231363	240155	1769	8792	0	"P"	557	1686	1686	1e-04	0	"HG02486#1#JAGYVM010000007.1_28868414_29370339_1"	"AMY1A-201"	"1"	"1-2-5-2-4-6-2-5-2-6-4-2-5-4-6-3-0"	"1.0-2.0-5.0-2.1-4.0-6.0-2.0-5.1-2.1-6.1-4.1-2.0-5.0-4.0-6.0-3.0-0.0"	28868568	"HG02486#1#JAGYVM010000007.1_28868414_29370339_1"	231363	240155
"ENST00000370083.9"	1785	2	1784	"+"	"HG02486#1#JAGYVM010000007.1_28868414_29370339_1"	501925	199695	208496	1769	8801	0	"S"	557	1686	NA	1e-04	0	"HG02486#1#JAGYVM010000007.1_28868414_29370339_1"	"AMY1A-201"	"1"	"1-2-5-2-4-6-2-5-2-6-4-2-5-4-6-3-0"	"1.0-2.0-5.0-2.1-4.0-6.0-2.0-5.1-2.1-6.1-4.1-2.0-5.0-4.0-6.0-3.0-0.0"	28868568	"HG02486#1#JAGYVM010000007.1_28868414_29370339_1"	199695	208496
"ENST00000370083.9"	1785	2	1784	"+"	"HG02486#1#JAGYVM010000007.1_28868414_29370339_1"	501925	387943	396733	1767	8790	0	"S"	552	1684	NA	7e-04	0	"HG02486#1#JAGYVM010000007.1_28868414_29370339_1"	"AMY1A-201"	"1"	"1-2-5-2-4-6-2-5-2-6-4-2-5-4-6-3-0"	"1.0-2.0-5.0-2.1-4.0-6.0-2.0-5.1-2.1-6.1-4.1-2.0-5.0-4.0-6.0-3.0-0.0"	28868568	"HG02486#1#JAGYVM010000007.1_28868414_29370339_1"	387943	396733
"ENST00000370083.9"	1785	2	1784	"+"	"HG02486#1#JAGYVM010000007.1_28868414_29370339_1"	501925	293837	302617	1765	8780	0	"S"	553	1682	NA	6e-04	0	"HG02486#1#JAGYVM010000007.1_28868414_29370339_1"	"AMY1A-201"	"1"	"1-2-5-2-4-6-2-5-2-6-4-2-5-4-6-3-0"	"1.0-2.0-5.0-2.1-4.0-6.0-2.0-5.1-2.1-6.1-4.1-2.0-5.0-4.0-6.0-3.0-0.0"	28868568	"HG02486#1#JAGYVM010000007.1_28868414_29370339_1"	293837	302617
"ENST00000370083.9"	1785	2	1784	"-"	"HG02486#1#JAGYVM010000007.1_28868414_29370339_1"	501925	325479	334259	1763	8780	0	"S"	548	1680	NA	0.0012	0	"HG02486#1#JAGYVM010000007.1_28868414_29370339_1"	"AMY1A-201"	"1"	"1-2-5-2-4-6-2-5-2-6-4-2-5-4-6-3-0"	"1.0-2.0-5.0-2.1-4.0-6.0-2.0-5.1-2.1-6.1-4.1-2.0-5.0-4.0-6.0-3.0-0.0"	28868568	"HG02486#1#JAGYVM010000007.1_28868414_29370339_1"	325479	334259
"ENST00000414303.7"	1584	4	1583	"+"	"HG02486#1#JAGYVM010000007.1_28868414_29370339_1"	501925	161440	169710	1563	8270	11	"P"	488	1488	1428	5e-04	0	"HG02486#1#JAGYVM010000007.1_28868414_29370339_1"	"AMY2A-201"	"2A"	"1-2-5-2-4-6-2-5-2-6-4-2-5-4-6-3-0"	"1.0-2.0-5.0-2.1-4.0-6.0-2.0-5.1-2.1-6.1-4.1-2.0-5.0-4.0-6.0-3.0-0.0"	28868568	"HG02486#1#JAGYVM010000007.1_28868414_29370339_1"	161440	169710
"ENST00000610648.1"	1736	4	1733	"+"	"HG02486#1#JAGYVM010000007.1_28868414_29370339_1"	501925	115098	123521	1720	8423	47	"P"	531	1638	1373	1e-04	0	"HG02486#1#JAGYVM010000007.1_28868414_29370339_1"	"AMY2B-208"	"2B"	"1-2-5-2-4-6-2-5-2-6-4-2-5-4-6-3-0"	"1.0-2.0-5.0-2.1-4.0-6.0-2.0-5.1-2.1-6.1-4.1-2.0-5.0-4.0-6.0-3.0-0.0"	28868568	"HG02486#1#JAGYVM010000007.1_28868414_29370339_1"	115098	123521
"ENST00000370083.9"	1785	2	1784	"+"	"HG02486#2#JAGYVL010000029.1_94163344_94570162_0"	406818	199588	208379	1769	8791	0	"P"	557	1686	1686	1e-04	0	"HG02486#2#JAGYVL010000029.1_94163344_94570162_0"	"AMY1A-201"	"1"	"1-2-5-2-4-6-2-5-4-6-3-0"	"1.0-2.0-5.1-2.1-4.0-6.0-2.0-5.0-4.0-6.0-3.0-0.0"	94163442	"HG02486#2#JAGYVL010000029.1_94163344_94570162_0"	199588	208379
"ENST00000370083.9"	1785	2	1784	"-"	"HG02486#2#JAGYVL010000029.1_94163344_94570162_0"	406818	231246	240038	1769	8792	0	"S"	557	1686	NA	1e-04	0	"HG02486#2#JAGYVL010000029.1_94163344_94570162_0"	"AMY1A-201"	"1"	"1-2-5-2-4-6-2-5-4-6-3-0"	"1.0-2.0-5.1-2.1-4.0-6.0-2.0-5.0-4.0-6.0-3.0-0.0"	94163442	"HG02486#2#JAGYVL010000029.1_94163344_94570162_0"	231246	240038
"ENST00000370083.9"	1785	2	1784	"+"	"HG02486#2#JAGYVL010000029.1_94163344_94570162_0"	406818	293712	302503	1769	8791	0	"S"	557	1686	NA	1e-04	0	"HG02486#2#JAGYVL010000029.1_94163344_94570162_0"	"AMY1A-201"	"1"	"1-2-5-2-4-6-2-5-4-6-3-0"	"1.0-2.0-5.1-2.1-4.0-6.0-2.0-5.0-4.0-6.0-3.0-0.0"	94163442	"HG02486#2#JAGYVL010000029.1_94163344_94570162_0"	293712	302503
"ENST00000414303.7"	1584	4	1583	"+"	"HG02486#2#JAGYVL010000029.1_94163344_94570162_0"	406818	161333	169603	1563	8270	28	"P"	488	1488	1342	5e-04	0	"HG02486#2#JAGYVL010000029.1_94163344_94570162_0"	"AMY2A-201"	"2A"	"1-2-5-2-4-6-2-5-4-6-3-0"	"1.0-2.0-5.1-2.1-4.0-6.0-2.0-5.0-4.0-6.0-3.0-0.0"	94163442	"HG02486#2#JAGYVL010000029.1_94163344_94570162_0"	161333	169603
"ENST00000610648.1"	1736	4	1733	"+"	"HG02486#2#JAGYVL010000029.1_94163344_94570162_0"	406818	114991	123414	1720	8423	48	"P"	531	1638	1371	1e-04	0	"HG02486#2#JAGYVL010000029.1_94163344_94570162_0"	"AMY2B-208"	"2B"	"1-2-5-2-4-6-2-5-4-6-3-0"	"1.0-2.0-5.1-2.1-4.0-6.0-2.0-5.0-4.0-6.0-3.0-0.0"	94163442	"HG02486#2#JAGYVL010000029.1_94163344_94570162_0"	114991	123414
"ENST00000370083.9"	1785	2	1784	"+"	"HG02559#1#JAGYVK010000012.1_51505852_51913611_0"	407759	199633	208425	1769	8792	0	"P"	557	1686	1686	1e-04	0	"HG02559#1#JAGYVK010000012.1_51505852_51913611_0"	"AMY1A-201"	"1"	"1-2-5-2-6-4-2-5-4-6-3-0"	"1.0-2.0-5.1-2.1-6.1-4.1-2.0-5.0-4.0-6.0-3.0-0.0"	51505950	"HG02559#1#JAGYVK010000012.1_51505852_51913611_0"	199633	208425
"ENST00000370083.9"	1785	2	1784	"+"	"HG02559#1#JAGYVK010000012.1_51505852_51913611_0"	407759	293761	302552	1769	8791	0	"S"	557	1686	NA	1e-04	0	"HG02559#1#JAGYVK010000012.1_51505852_51913611_0"	"AMY1A-201"	"1"	"1-2-5-2-6-4-2-5-4-6-3-0"	"1.0-2.0-5.1-2.1-6.1-4.1-2.0-5.0-4.0-6.0-3.0-0.0"	51505950	"HG02559#1#JAGYVK010000012.1_51505852_51913611_0"	293761	302552
"ENST00000370083.9"	1785	2	1784	"-"	"HG02559#1#JAGYVK010000012.1_51505852_51913611_0"	407759	231286	240078	1769	8792	0	"S"	557	1686	NA	1e-04	0	"HG02559#1#JAGYVK010000012.1_51505852_51913611_0"	"AMY1A-201"	"1"	"1-2-5-2-6-4-2-5-4-6-3-0"	"1.0-2.0-5.1-2.1-6.1-4.1-2.0-5.0-4.0-6.0-3.0-0.0"	51505950	"HG02559#1#JAGYVK010000012.1_51505852_51913611_0"	231286	240078
"ENST00000414303.7"	1584	4	1583	"+"	"HG02559#1#JAGYVK010000012.1_51505852_51913611_0"	407759	161373	169643	1563	8270	28	"P"	488	1488	1342	5e-04	0	"HG02559#1#JAGYVK010000012.1_51505852_51913611_0"	"AMY2A-201"	"2A"	"1-2-5-2-6-4-2-5-4-6-3-0"	"1.0-2.0-5.1-2.1-6.1-4.1-2.0-5.0-4.0-6.0-3.0-0.0"	51505950	"HG02559#1#JAGYVK010000012.1_51505852_51913611_0"	161373	169643
"ENST00000610648.1"	1736	4	1733	"+"	"HG02559#1#JAGYVK010000012.1_51505852_51913611_0"	407759	115044	123468	1720	8424	48	"P"	531	1638	1371	1e-04	0	"HG02559#1#JAGYVK010000012.1_51505852_51913611_0"	"AMY2B-208"	"2B"	"1-2-5-2-6-4-2-5-4-6-3-0"	"1.0-2.0-5.1-2.1-6.1-4.1-2.0-5.0-4.0-6.0-3.0-0.0"	51505950	"HG02559#1#JAGYVK010000012.1_51505852_51913611_0"	115044	123468
"ENST00000370083.9"	1785	2	1784	"+"	"HG02559#2#JAGYVJ010000037.1_52167780_52574597_1"	406817	199671	208462	1769	8791	0	"P"	557	1686	1686	1e-04	0	"HG02559#2#JAGYVJ010000037.1_52167780_52574597_1"	"AMY1A-201"	"1"	"1-2-5-2-6-4-2-5-4-6-3-0"	"1.0-2.0-5.1-2.1-6.1-4.1-2.0-5.0-4.0-6.0-3.0-0.0"	52167934	"HG02559#2#JAGYVJ010000037.1_52167780_52574597_1"	199671	208462
"ENST00000370083.9"	1785	2	1784	"-"	"HG02559#2#JAGYVJ010000037.1_52167780_52574597_1"	406817	231323	240114	1769	8791	0	"S"	557	1686	NA	1e-04	0	"HG02559#2#JAGYVJ010000037.1_52167780_52574597_1"	"AMY1A-201"	"1"	"1-2-5-2-6-4-2-5-4-6-3-0"	"1.0-2.0-5.1-2.1-6.1-4.1-2.0-5.0-4.0-6.0-3.0-0.0"	52167934	"HG02559#2#JAGYVJ010000037.1_52167780_52574597_1"	231323	240114
"ENST00000370083.9"	1785	2	1784	"+"	"HG02559#2#JAGYVJ010000037.1_52167780_52574597_1"	406817	293768	302559	1769	8791	0	"S"	557	1686	NA	1e-04	0	"HG02559#2#JAGYVJ010000037.1_52167780_52574597_1"	"AMY1A-201"	"1"	"1-2-5-2-6-4-2-5-4-6-3-0"	"1.0-2.0-5.1-2.1-6.1-4.1-2.0-5.0-4.0-6.0-3.0-0.0"	52167934	"HG02559#2#JAGYVJ010000037.1_52167780_52574597_1"	293768	302559
"ENST00000414303.7"	1584	4	1579	"+"	"HG02559#2#JAGYVJ010000037.1_52167780_52574597_1"	406817	161367	169633	1570	8266	30	"P"	490	1495	1339	1e-04	0	"HG02559#2#JAGYVJ010000037.1_52167780_52574597_1"	"AMY2A-201"	"2A"	"1-2-5-2-6-4-2-5-4-6-3-0"	"1.0-2.0-5.1-2.1-6.1-4.1-2.0-5.0-4.0-6.0-3.0-0.0"	52167934	"HG02559#2#JAGYVJ010000037.1_52167780_52574597_1"	161367	169633
"ENST00000610648.1"	1736	4	1733	"+"	"HG02559#2#JAGYVJ010000037.1_52167780_52574597_1"	406817	115051	123473	1717	8422	47	"P"	526	1635	1371	8e-04	0	"HG02559#2#JAGYVJ010000037.1_52167780_52574597_1"	"AMY2B-208"	"2B"	"1-2-5-2-6-4-2-5-4-6-3-0"	"1.0-2.0-5.1-2.1-6.1-4.1-2.0-5.0-4.0-6.0-3.0-0.0"	52167934	"HG02559#2#JAGYVJ010000037.1_52167780_52574597_1"	115051	123473
"ENST00000370083.9"	1785	2	1784	"+"	"HG02572#1#JAHAOW010000072.1_9428131_9835964_0"	407833	199607	208400	1769	8793	0	"P"	557	1686	1686	1e-04	0	"HG02572#1#JAHAOW010000072.1_9428131_9835964_0"	"AMY1A-201"	"1"	"1-2-5-2-6-4-2-5-4-3-0"	"1.0-2.0-5.0-2.1-6.1-4.1-2.0-5.0-4.0-3.0-0.0"	9428229	"HG02572#1#JAHAOW010000072.1_9428131_9835964_0"	199607	208400
"ENST00000370083.9"	1785	2	1784	"+"	"HG02572#1#JAHAOW010000072.1_9428131_9835964_0"	407833	293734	302526	1769	8792	0	"S"	557	1686	NA	1e-04	0	"HG02572#1#JAHAOW010000072.1_9428131_9835964_0"	"AMY1A-201"	"1"	"1-2-5-2-6-4-2-5-4-3-0"	"1.0-2.0-5.0-2.1-6.1-4.1-2.0-5.0-4.0-3.0-0.0"	9428229	"HG02572#1#JAHAOW010000072.1_9428131_9835964_0"	293734	302526
"ENST00000370083.9"	1785	2	1784	"-"	"HG02572#1#JAHAOW010000072.1_9428131_9835964_0"	407833	231263	240056	1769	8793	0	"S"	557	1686	NA	1e-04	0	"HG02572#1#JAHAOW010000072.1_9428131_9835964_0"	"AMY1A-201"	"1"	"1-2-5-2-6-4-2-5-4-3-0"	"1.0-2.0-5.0-2.1-6.1-4.1-2.0-5.0-4.0-3.0-0.0"	9428229	"HG02572#1#JAHAOW010000072.1_9428131_9835964_0"	231263	240056
"ENST00000414303.7"	1584	4	1583	"+"	"HG02572#1#JAHAOW010000072.1_9428131_9835964_0"	407833	161355	169625	1574	8270	30	"P"	491	1499	1342	1e-04	0	"HG02572#1#JAHAOW010000072.1_9428131_9835964_0"	"AMY2A-201"	"2A"	"1-2-5-2-6-4-2-5-4-3-0"	"1.0-2.0-5.0-2.1-6.1-4.1-2.0-5.0-4.0-3.0-0.0"	9428229	"HG02572#1#JAHAOW010000072.1_9428131_9835964_0"	161355	169625
"ENST00000610648.1"	1736	4	1733	"+"	"HG02572#1#JAHAOW010000072.1_9428131_9835964_0"	407833	115028	123450	1720	8422	48	"P"	531	1638	1371	1e-04	0	"HG02572#1#JAHAOW010000072.1_9428131_9835964_0"	"AMY2B-208"	"2B"	"1-2-5-2-6-4-2-5-4-3-0"	"1.0-2.0-5.0-2.1-6.1-4.1-2.0-5.0-4.0-3.0-0.0"	9428229	"HG02572#1#JAHAOW010000072.1_9428131_9835964_0"	115028	123450
"ENST00000370083.9"	1785	2	1784	"+"	"HG02572#2#JAHAOV010000024.1_4460979_4890404_1"	429425	315443	324233	1769	8790	0	"P"	557	1686	1686	1e-04	0	"HG02572#2#JAHAOV010000024.1_4460979_4890404_1"	"AMY1A-201"	"1"	"1-2-5-4-6-3-0-4-2-5-4-6-3-0"	"1.0-2.0-5.0-4.0-6.0-3.0-0.0-4.1-2.0-5.0-4.0-6.0-3.0-0.0"	4461133	"HG02572#2#JAHAOV010000024.1_4460979_4890404_1"	315443	324233
"ENST00000370083.9"	1785	2	1784	"+"	"HG02572#2#JAHAOV010000024.1_4460979_4890404_1"	429425	199692	208471	1769	8779	0	"S"	557	1686	NA	1e-04	0	"HG02572#2#JAHAOV010000024.1_4460979_4890404_1"	"AMY1A-201"	"1"	"1-2-5-4-6-3-0-4-2-5-4-6-3-0"	"1.0-2.0-5.0-4.0-6.0-3.0-0.0-4.1-2.0-5.0-4.0-6.0-3.0-0.0"	4461133	"HG02572#2#JAHAOV010000024.1_4460979_4890404_1"	199692	208471
"ENST00000414303.7"	1584	4	1583	"+"	"HG02572#2#JAHAOV010000024.1_4460979_4890404_1"	429425	277180	285450	1563	8270	0	"P"	488	1488	1488	5e-04	0	"HG02572#2#JAHAOV010000024.1_4460979_4890404_1"	"AMY2A-201"	"2A"	"1-2-5-4-6-3-0-4-2-5-4-6-3-0"	"1.0-2.0-5.0-4.0-6.0-3.0-0.0-4.1-2.0-5.0-4.0-6.0-3.0-0.0"	4461133	"HG02572#2#JAHAOV010000024.1_4460979_4890404_1"	277180	285450
"ENST00000414303.7"	1584	4	1583	"+"	"HG02572#2#JAHAOV010000024.1_4460979_4890404_1"	429425	161429	169699	1563	8270	0	"S"	488	1488	NA	5e-04	0	"HG02572#2#JAHAOV010000024.1_4460979_4890404_1"	"AMY2A-201"	"2A"	"1-2-5-4-6-3-0-4-2-5-4-6-3-0"	"1.0-2.0-5.0-4.0-6.0-3.0-0.0-4.1-2.0-5.0-4.0-6.0-3.0-0.0"	4461133	"HG02572#2#JAHAOV010000024.1_4460979_4890404_1"	161429	169699
"ENST00000610648.1"	1736	4	1733	"+"	"HG02572#2#JAHAOV010000024.1_4460979_4890404_1"	429425	115091	123513	1720	8422	0	"P"	531	1638	1638	1e-04	0	"HG02572#2#JAHAOV010000024.1_4460979_4890404_1"	"AMY2B-208"	"2B"	"1-2-5-4-6-3-0-4-2-5-4-6-3-0"	"1.0-2.0-5.0-4.0-6.0-3.0-0.0-4.1-2.0-5.0-4.0-6.0-3.0-0.0"	4461133	"HG02572#2#JAHAOV010000024.1_4460979_4890404_1"	115091	123513
"ENST00000610648.1"	1736	4	1733	"+"	"HG02572#2#JAHAOV010000024.1_4460979_4890404_1"	429425	230842	239264	1720	8422	0	"S"	531	1638	NA	1e-04	0	"HG02572#2#JAHAOV010000024.1_4460979_4890404_1"	"AMY2B-208"	"2B"	"1-2-5-4-6-3-0-4-2-5-4-6-3-0"	"1.0-2.0-5.0-4.0-6.0-3.0-0.0-4.1-2.0-5.0-4.0-6.0-3.0-0.0"	4461133	"HG02572#2#JAHAOV010000024.1_4460979_4890404_1"	230842	239264
"ENST00000370083.9"	1785	2	1784	"+"	"HG02622#1#JAHAOO010000002.1_16673678_17080663_0"	406985	199725	208515	1769	8790	0	"P"	557	1686	1686	1e-04	0	"HG02622#1#JAHAOO010000002.1_16673678_17080663_0"	"AMY1A-201"	"1"	"1-2-5-2-6-4-2-5-4-6-3-0"	"1.0-2.0-5.0-2.1-6.1-4.1-2.0-5.0-4.0-6.0-3.0-0.0"	16673776	"HG02622#1#JAHAOO010000002.1_16673678_17080663_0"	199725	208515
"ENST00000370083.9"	1785	2	1784	"+"	"HG02622#1#JAHAOO010000002.1_16673678_17080663_0"	406985	293847	302639	1769	8792	0	"S"	557	1686	NA	1e-04	0	"HG02622#1#JAHAOO010000002.1_16673678_17080663_0"	"AMY1A-201"	"1"	"1-2-5-2-6-4-2-5-4-6-3-0"	"1.0-2.0-5.0-2.1-6.1-4.1-2.0-5.0-4.0-6.0-3.0-0.0"	16673776	"HG02622#1#JAHAOO010000002.1_16673678_17080663_0"	293847	302639
"ENST00000370083.9"	1785	2	1784	"-"	"HG02622#1#JAHAOO010000002.1_16673678_17080663_0"	406985	231376	240167	1769	8791	0	"S"	557	1686	NA	1e-04	0	"HG02622#1#JAHAOO010000002.1_16673678_17080663_0"	"AMY1A-201"	"1"	"1-2-5-2-6-4-2-5-4-6-3-0"	"1.0-2.0-5.0-2.1-6.1-4.1-2.0-5.0-4.0-6.0-3.0-0.0"	16673776	"HG02622#1#JAHAOO010000002.1_16673678_17080663_0"	231376	240167
"ENST00000414303.7"	1584	4	1583	"+"	"HG02622#1#JAHAOO010000002.1_16673678_17080663_0"	406985	161427	169732	1568	8305	29	"P"	486	1493	1342	8e-04	0	"HG02622#1#JAHAOO010000002.1_16673678_17080663_0"	"AMY2A-201"	"2A"	"1-2-5-2-6-4-2-5-4-6-3-0"	"1.0-2.0-5.0-2.1-6.1-4.1-2.0-5.0-4.0-6.0-3.0-0.0"	16673776	"HG02622#1#JAHAOO010000002.1_16673678_17080663_0"	161427	169732
"ENST00000610648.1"	1736	4	1733	"+"	"HG02622#1#JAHAOO010000002.1_16673678_17080663_0"	406985	115072	123494	1720	8422	48	"P"	531	1638	1371	1e-04	0	"HG02622#1#JAHAOO010000002.1_16673678_17080663_0"	"AMY2B-208"	"2B"	"1-2-5-2-6-4-2-5-4-6-3-0"	"1.0-2.0-5.0-2.1-6.1-4.1-2.0-5.0-4.0-6.0-3.0-0.0"	16673776	"HG02622#1#JAHAOO010000002.1_16673678_17080663_0"	115072	123494
"ENST00000370083.9"	1785	2	1784	"+"	"HG02622#2#JAHAON010000012.1_51551779_52031001_0"	479222	366064	374855	1769	8791	0	"P"	557	1686	1686	1e-04	0	"HG02622#2#JAHAON010000012.1_51551779_52031001_0"	"AMY1A-201"	"1"	"1-2-5-2-6-4-5-2-4-6-2-5-4-6-3-0"	"1.0-2.0-5.0-2.1-6.1-4.1-5.1-2.1-4.0-6.0-2.0-5.0-4.0-6.0-3.0-0.0"	51551877	"HG02622#2#JAHAON010000012.1_51551779_52031001_0"	366064	374855
"ENST00000370083.9"	1785	2	1784	"-"	"HG02622#2#JAHAON010000012.1_51551779_52031001_0"	479222	303625	312417	1769	8792	0	"S"	557	1686	NA	1e-04	0	"HG02622#2#JAHAON010000012.1_51551779_52031001_0"	"AMY1A-201"	"1"	"1-2-5-2-6-4-5-2-4-6-2-5-4-6-3-0"	"1.0-2.0-5.0-2.1-6.1-4.1-5.1-2.1-4.0-6.0-2.0-5.0-4.0-6.0-3.0-0.0"	51551877	"HG02622#2#JAHAON010000012.1_51551779_52031001_0"	303625	312417
"ENST00000370083.9"	1785	2	1784	"+"	"HG02622#2#JAHAON010000012.1_51551779_52031001_0"	479222	199563	208355	1769	8792	0	"S"	557	1686	NA	1e-04	0	"HG02622#2#JAHAON010000012.1_51551779_52031001_0"	"AMY1A-201"	"1"	"1-2-5-2-6-4-5-2-4-6-2-5-4-6-3-0"	"1.0-2.0-5.0-2.1-6.1-4.1-5.1-2.1-4.0-6.0-2.0-5.0-4.0-6.0-3.0-0.0"	51551877	"HG02622#2#JAHAON010000012.1_51551779_52031001_0"	199563	208355
"ENST00000370083.9"	1785	2	1784	"-"	"HG02622#2#JAHAON010000012.1_51551779_52031001_0"	479222	231204	239995	1769	8791	0	"S"	557	1686	NA	1e-04	0	"HG02622#2#JAHAON010000012.1_51551779_52031001_0"	"AMY1A-201"	"1"	"1-2-5-2-6-4-5-2-4-6-2-5-4-6-3-0"	"1.0-2.0-5.0-2.1-6.1-4.1-5.1-2.1-4.0-6.0-2.0-5.0-4.0-6.0-3.0-0.0"	51551877	"HG02622#2#JAHAON010000012.1_51551779_52031001_0"	231204	239995
"ENST00000414303.7"	1584	4	1583	"-"	"HG02622#2#JAHAON010000012.1_51551779_52031001_0"	479222	269979	278249	1571	8270	0	"P"	486	1496	1494	8e-04	0	"HG02622#2#JAHAON010000012.1_51551779_52031001_0"	"AMY2A-201"	"2A"	"1-2-5-2-6-4-5-2-4-6-2-5-4-6-3-0"	"1.0-2.0-5.0-2.1-6.1-4.1-5.1-2.1-4.0-6.0-2.0-5.0-4.0-6.0-3.0-0.0"	51551877	"HG02622#2#JAHAON010000012.1_51551779_52031001_0"	269979	278249
"ENST00000414303.7"	1584	4	1583	"+"	"HG02622#2#JAHAON010000012.1_51551779_52031001_0"	479222	161309	169579	1569	8270	0	"S"	486	1494	NA	8e-04	0	"HG02622#2#JAHAON010000012.1_51551779_52031001_0"	"AMY2A-201"	"2A"	"1-2-5-2-6-4-5-2-4-6-2-5-4-6-3-0"	"1.0-2.0-5.0-2.1-6.1-4.1-5.1-2.1-4.0-6.0-2.0-5.0-4.0-6.0-3.0-0.0"	51551877	"HG02622#2#JAHAON010000012.1_51551779_52031001_0"	161309	169579
"ENST00000610648.1"	1736	4	1733	"+"	"HG02622#2#JAHAON010000012.1_51551779_52031001_0"	479222	114978	123389	1717	8411	40	"P"	524	1635	1411	9e-04	0	"HG02622#2#JAHAON010000012.1_51551779_52031001_0"	"AMY2B-208"	"2B"	"1-2-5-2-6-4-5-2-4-6-2-5-4-6-3-0"	"1.0-2.0-5.0-2.1-6.1-4.1-5.1-2.1-4.0-6.0-2.0-5.0-4.0-6.0-3.0-0.0"	51551877	"HG02622#2#JAHAON010000012.1_51551779_52031001_0"	114978	123389
"ENST00000370083.9"	1785	2	1784	"+"	"HG02630#1#JAHAOQ010000102.1_16672145_17079089_0"	406944	293812	302603	1769	8791	0	"P"	557	1686	1686	1e-04	0	"HG02630#1#JAHAOQ010000102.1_16672145_17079089_0"	"AMY1A-201"	"1"	"1-2-5-2-6-4-2-5-4-6-3-0"	"1.0-2.0-5.0-2.1-6.1-4.1-2.0-5.0-4.0-6.0-3.0-0.0"	16672243	"HG02630#1#JAHAOQ010000102.1_16672145_17079089_0"	293812	302603
"ENST00000370083.9"	1785	2	1784	"+"	"HG02630#1#JAHAOQ010000102.1_16672145_17079089_0"	406944	199709	208499	1769	8790	0	"S"	557	1686	NA	1e-04	0	"HG02630#1#JAHAOQ010000102.1_16672145_17079089_0"	"AMY1A-201"	"1"	"1-2-5-2-6-4-2-5-4-6-3-0"	"1.0-2.0-5.0-2.1-6.1-4.1-2.0-5.0-4.0-6.0-3.0-0.0"	16672243	"HG02630#1#JAHAOQ010000102.1_16672145_17079089_0"	199709	208499
"ENST00000370083.9"	1785	2	1784	"-"	"HG02630#1#JAHAOQ010000102.1_16672145_17079089_0"	406944	231359	240150	1769	8791	0	"S"	557	1686	NA	1e-04	0	"HG02630#1#JAHAOQ010000102.1_16672145_17079089_0"	"AMY1A-201"	"1"	"1-2-5-2-6-4-2-5-4-6-3-0"	"1.0-2.0-5.0-2.1-6.1-4.1-2.0-5.0-4.0-6.0-3.0-0.0"	16672243	"HG02630#1#JAHAOQ010000102.1_16672145_17079089_0"	231359	240150
"ENST00000414303.7"	1584	4	1583	"+"	"HG02630#1#JAHAOQ010000102.1_16672145_17079089_0"	406944	161389	169694	1568	8305	29	"P"	486	1493	1342	8e-04	0	"HG02630#1#JAHAOQ010000102.1_16672145_17079089_0"	"AMY2A-201"	"2A"	"1-2-5-2-6-4-2-5-4-6-3-0"	"1.0-2.0-5.0-2.1-6.1-4.1-2.0-5.0-4.0-6.0-3.0-0.0"	16672243	"HG02630#1#JAHAOQ010000102.1_16672145_17079089_0"	161389	169694
"ENST00000610648.1"	1736	4	1733	"+"	"HG02630#1#JAHAOQ010000102.1_16672145_17079089_0"	406944	115033	123455	1720	8422	48	"P"	531	1638	1371	1e-04	0	"HG02630#1#JAHAOQ010000102.1_16672145_17079089_0"	"AMY2B-208"	"2B"	"1-2-5-2-6-4-2-5-4-6-3-0"	"1.0-2.0-5.0-2.1-6.1-4.1-2.0-5.0-4.0-6.0-3.0-0.0"	16672243	"HG02630#1#JAHAOQ010000102.1_16672145_17079089_0"	115033	123455
"ENST00000370083.9"	1785	2	1784	"+"	"HG02630#2#JAHAOP010000089.1_16669255_17076135_0"	406880	293792	302580	1769	8788	0	"P"	557	1686	1686	1e-04	0	"HG02630#2#JAHAOP010000089.1_16669255_17076135_0"	"AMY1A-201"	"1"	"1-2-5-2-4-6-2-5-4-6-3-0"	"1.0-2.0-5.1-2.1-4.0-6.0-2.0-5.0-4.0-6.0-3.0-0.0"	16669353	"HG02630#2#JAHAOP010000089.1_16669255_17076135_0"	293792	302580
"ENST00000370083.9"	1785	2	1784	"+"	"HG02630#2#JAHAOP010000089.1_16669255_17076135_0"	406880	199641	208432	1769	8791	0	"S"	557	1686	NA	1e-04	0	"HG02630#2#JAHAOP010000089.1_16669255_17076135_0"	"AMY1A-201"	"1"	"1-2-5-2-4-6-2-5-4-6-3-0"	"1.0-2.0-5.1-2.1-4.0-6.0-2.0-5.0-4.0-6.0-3.0-0.0"	16669353	"HG02630#2#JAHAOP010000089.1_16669255_17076135_0"	199641	208432
"ENST00000370083.9"	1785	2	1784	"-"	"HG02630#2#JAHAOP010000089.1_16669255_17076135_0"	406880	231306	240098	1769	8792	0	"S"	557	1686	NA	1e-04	0	"HG02630#2#JAHAOP010000089.1_16669255_17076135_0"	"AMY1A-201"	"1"	"1-2-5-2-4-6-2-5-4-6-3-0"	"1.0-2.0-5.1-2.1-4.0-6.0-2.0-5.0-4.0-6.0-3.0-0.0"	16669353	"HG02630#2#JAHAOP010000089.1_16669255_17076135_0"	231306	240098
"ENST00000414303.7"	1584	4	1583	"+"	"HG02630#2#JAHAOP010000089.1_16669255_17076135_0"	406880	161373	169643	1563	8270	28	"P"	488	1488	1342	5e-04	0	"HG02630#2#JAHAOP010000089.1_16669255_17076135_0"	"AMY2A-201"	"2A"	"1-2-5-2-4-6-2-5-4-6-3-0"	"1.0-2.0-5.1-2.1-4.0-6.0-2.0-5.0-4.0-6.0-3.0-0.0"	16669353	"HG02630#2#JAHAOP010000089.1_16669255_17076135_0"	161373	169643
"ENST00000610648.1"	1736	4	1733	"+"	"HG02630#2#JAHAOP010000089.1_16669255_17076135_0"	406880	115038	123460	1720	8422	48	"P"	531	1638	1371	1e-04	0	"HG02630#2#JAHAOP010000089.1_16669255_17076135_0"	"AMY2B-208"	"2B"	"1-2-5-2-4-6-2-5-4-6-3-0"	"1.0-2.0-5.1-2.1-4.0-6.0-2.0-5.0-4.0-6.0-3.0-0.0"	16669353	"HG02630#2#JAHAOP010000089.1_16669255_17076135_0"	115038	123460
"ENST00000370083.9"	1785	2	1784	"+"	"HG02717#1#JAHAOS010000015.1_16660311_17067250_0"	406939	293749	302540	1769	8791	0	"P"	557	1686	1686	1e-04	0	"HG02717#1#JAHAOS010000015.1_16660311_17067250_0"	"AMY1A-201"	"1"	"1-2-5-2-6-4-2-5-4-6-3-0"	"1.0-2.0-5.0-2.1-6.1-4.1-2.0-5.0-4.0-6.0-3.0-0.0"	16660409	"HG02717#1#JAHAOS010000015.1_16660311_17067250_0"	293749	302540
"ENST00000370083.9"	1785	2	1784	"-"	"HG02717#1#JAHAOS010000015.1_16660311_17067250_0"	406939	231287	240077	1769	8790	0	"S"	557	1686	NA	1e-04	0	"HG02717#1#JAHAOS010000015.1_16660311_17067250_0"	"AMY1A-201"	"1"	"1-2-5-2-6-4-2-5-4-6-3-0"	"1.0-2.0-5.0-2.1-6.1-4.1-2.0-5.0-4.0-6.0-3.0-0.0"	16660409	"HG02717#1#JAHAOS010000015.1_16660311_17067250_0"	231287	240077
"ENST00000370083.9"	1785	2	1784	"+"	"HG02717#1#JAHAOS010000015.1_16660311_17067250_0"	406939	199637	208427	1761	8790	0	"S"	551	1678	NA	8e-04	0	"HG02717#1#JAHAOS010000015.1_16660311_17067250_0"	"AMY1A-201"	"1"	"1-2-5-2-6-4-2-5-4-6-3-0"	"1.0-2.0-5.0-2.1-6.1-4.1-2.0-5.0-4.0-6.0-3.0-0.0"	16660409	"HG02717#1#JAHAOS010000015.1_16660311_17067250_0"	199637	208427
"ENST00000414303.7"	1584	4	1583	"+"	"HG02717#1#JAHAOS010000015.1_16660311_17067250_0"	406939	161337	169642	1562	8305	28	"P"	480	1487	1342	0.0016	0	"HG02717#1#JAHAOS010000015.1_16660311_17067250_0"	"AMY2A-201"	"2A"	"1-2-5-2-6-4-2-5-4-6-3-0"	"1.0-2.0-5.0-2.1-6.1-4.1-2.0-5.0-4.0-6.0-3.0-0.0"	16660409	"HG02717#1#JAHAOS010000015.1_16660311_17067250_0"	161337	169642
"ENST00000610648.1"	1736	4	1733	"+"	"HG02717#1#JAHAOS010000015.1_16660311_17067250_0"	406939	115004	123426	1720	8422	48	"P"	531	1638	1371	1e-04	0	"HG02717#1#JAHAOS010000015.1_16660311_17067250_0"	"AMY2B-208"	"2B"	"1-2-5-2-6-4-2-5-4-6-3-0"	"1.0-2.0-5.0-2.1-6.1-4.1-2.0-5.0-4.0-6.0-3.0-0.0"	16660409	"HG02717#1#JAHAOS010000015.1_16660311_17067250_0"	115004	123426
"ENST00000370083.9"	1785	2	1784	"+"	"HG02717#2#JAHAOR010000006.1_19663827_20070693_1"	406866	293816	302606	1769	8790	0	"P"	557	1686	1686	1e-04	0	"HG02717#2#JAHAOR010000006.1_19663827_20070693_1"	"AMY1A-201"	"1"	"1-2-5-2-4-2-5-4-3-0"	"1.0-2.0-5.1-2.1-4.0-2.0-5.0-4.0-3.0-0.0"	19663981	"HG02717#2#JAHAOR010000006.1_19663827_20070693_1"	293816	302606
"ENST00000370083.9"	1785	2	1784	"-"	"HG02717#2#JAHAOR010000006.1_19663827_20070693_1"	406866	231342	240135	1769	8793	0	"S"	557	1686	NA	1e-04	0	"HG02717#2#JAHAOR010000006.1_19663827_20070693_1"	"AMY1A-201"	"1"	"1-2-5-2-4-2-5-4-3-0"	"1.0-2.0-5.1-2.1-4.0-2.0-5.0-4.0-3.0-0.0"	19663981	"HG02717#2#JAHAOR010000006.1_19663827_20070693_1"	231342	240135
"ENST00000370083.9"	1785	2	1784	"+"	"HG02717#2#JAHAOR010000006.1_19663827_20070693_1"	406866	199689	208480	1769	8791	0	"S"	557	1686	NA	1e-04	0	"HG02717#2#JAHAOR010000006.1_19663827_20070693_1"	"AMY1A-201"	"1"	"1-2-5-2-4-2-5-4-3-0"	"1.0-2.0-5.1-2.1-4.0-2.0-5.0-4.0-3.0-0.0"	19663981	"HG02717#2#JAHAOR010000006.1_19663827_20070693_1"	199689	208480
"ENST00000414303.7"	1584	4	1583	"+"	"HG02717#2#JAHAOR010000006.1_19663827_20070693_1"	406866	161431	169701	1563	8270	28	"P"	488	1488	1342	5e-04	0	"HG02717#2#JAHAOR010000006.1_19663827_20070693_1"	"AMY2A-201"	"2A"	"1-2-5-2-4-2-5-4-3-0"	"1.0-2.0-5.1-2.1-4.0-2.0-5.0-4.0-3.0-0.0"	19663981	"HG02717#2#JAHAOR010000006.1_19663827_20070693_1"	161431	169701
"ENST00000610648.1"	1736	4	1733	"+"	"HG02717#2#JAHAOR010000006.1_19663827_20070693_1"	406866	115094	123516	1720	8422	48	"P"	531	1638	1371	1e-04	0	"HG02717#2#JAHAOR010000006.1_19663827_20070693_1"	"AMY2B-208"	"2B"	"1-2-5-2-4-2-5-4-3-0"	"1.0-2.0-5.1-2.1-4.0-2.0-5.0-4.0-3.0-0.0"	19663981	"HG02717#2#JAHAOR010000006.1_19663827_20070693_1"	115094	123516
"ENST00000370083.9"	1785	2	1784	"+"	"HG02723#1#JAHEOU010000204.1_2102082_2414876_1"	312794	199716	208507	1769	8791	49	"P"	557	1686	1404	1e-04	0	"HG02723#1#JAHEOU010000204.1_2102082_2414876_1"	"AMY1A-201"	"1"	"1-2-5-4-6-3-0"	"1.0-2.0-5.0-4.0-6.0-3.0-0.0"	2102236	"HG02723#1#JAHEOU010000204.1_2102082_2414876_1"	199716	208507
"ENST00000414303.7"	1584	4	1583	"+"	"HG02723#1#JAHEOU010000204.1_2102082_2414876_1"	312794	161428	169733	1574	8305	30	"P"	491	1499	1342	1e-04	0	"HG02723#1#JAHEOU010000204.1_2102082_2414876_1"	"AMY2A-201"	"2A"	"1-2-5-4-6-3-0"	"1.0-2.0-5.0-4.0-6.0-3.0-0.0"	2102236	"HG02723#1#JAHEOU010000204.1_2102082_2414876_1"	161428	169733
"ENST00000610648.1"	1736	4	1733	"+"	"HG02723#1#JAHEOU010000204.1_2102082_2414876_1"	312794	115087	123511	1720	8424	50	"P"	531	1638	1358	1e-04	0	"HG02723#1#JAHEOU010000204.1_2102082_2414876_1"	"AMY2B-208"	"2B"	"1-2-5-4-6-3-0"	"1.0-2.0-5.0-4.0-6.0-3.0-0.0"	2102236	"HG02723#1#JAHEOU010000204.1_2102082_2414876_1"	115087	123511
"ENST00000370083.9"	1785	2	1784	"+"	"HG02723#2#JAHEOT010000034.1_19776337_20321518_1"	545181	315450	324229	1769	8779	0	"P"	557	1686	1686	1e-04	0	"HG02723#2#JAHEOT010000034.1_19776337_20321518_1"	"AMY1A-201"	"1"	"1-2-5-4-6-3-0-4-2-5-4-0-3-6-4-5-2-4-6-3-0"	"1.0-2.0-5.0-4.0-6.0-3.0-0.0-4.1-2.0-5.0-4.0-0.1-3.1-6.1-4.1-5.1-2.1-4.0-6.0-3.0-0.0"	19776491	"HG02723#2#JAHEOT010000034.1_19776337_20321518_1"	315450	324229
"ENST00000370083.9"	1785	2	1784	"-"	"HG02723#2#JAHEOT010000034.1_19776337_20321518_1"	545181	158935	167715	1769	8780	0	"S"	557	1686	NA	1e-04	0	"HG02723#2#JAHEOT010000034.1_19776337_20321518_1"	"AMY1A-201"	"1"	"1-2-5-4-6-3-0-4-2-5-4-0-3-6-4-5-2-4-6-3-0"	"1.0-2.0-5.0-4.0-6.0-3.0-0.0-4.1-2.0-5.0-4.0-0.1-3.1-6.1-4.1-5.1-2.1-4.0-6.0-3.0-0.0"	19776491	"HG02723#2#JAHEOT010000034.1_19776337_20321518_1"	158935	167715
"ENST00000370083.9"	1785	2	1784	"+"	"HG02723#2#JAHEOT010000034.1_19776337_20321518_1"	545181	431200	439991	1769	8791	0	"S"	557	1686	NA	1e-04	0	"HG02723#2#JAHEOT010000034.1_19776337_20321518_1"	"AMY1A-201"	"1"	"1-2-5-4-6-3-0-4-2-5-4-0-3-6-4-5-2-4-6-3-0"	"1.0-2.0-5.0-4.0-6.0-3.0-0.0-4.1-2.0-5.0-4.0-0.1-3.1-6.1-4.1-5.1-2.1-4.0-6.0-3.0-0.0"	19776491	"HG02723#2#JAHEOT010000034.1_19776337_20321518_1"	431200	439991
"ENST00000414303.7"	1584	4	1583	"-"	"HG02723#2#JAHEOT010000034.1_19776337_20321518_1"	545181	197698	205968	1563	8270	0	"P"	488	1488	1488	5e-04	0	"HG02723#2#JAHEOT010000034.1_19776337_20321518_1"	"AMY2A-201"	"2A"	"1-2-5-4-6-3-0-4-2-5-4-0-3-6-4-5-2-4-6-3-0"	"1.0-2.0-5.0-4.0-6.0-3.0-0.0-4.1-2.0-5.0-4.0-0.1-3.1-6.1-4.1-5.1-2.1-4.0-6.0-3.0-0.0"	19776491	"HG02723#2#JAHEOT010000034.1_19776337_20321518_1"	197698	205968
"ENST00000414303.7"	1584	4	1583	"+"	"HG02723#2#JAHEOT010000034.1_19776337_20321518_1"	545181	277190	285460	1563	8270	0	"S"	488	1488	NA	5e-04	0	"HG02723#2#JAHEOT010000034.1_19776337_20321518_1"	"AMY2A-201"	"2A"	"1-2-5-4-6-3-0-4-2-5-4-0-3-6-4-5-2-4-6-3-0"	"1.0-2.0-5.0-4.0-6.0-3.0-0.0-4.1-2.0-5.0-4.0-0.1-3.1-6.1-4.1-5.1-2.1-4.0-6.0-3.0-0.0"	19776491	"HG02723#2#JAHEOT010000034.1_19776337_20321518_1"	277190	285460
"ENST00000414303.7"	1584	4	1583	"+"	"HG02723#2#JAHEOT010000034.1_19776337_20321518_1"	545181	392941	401211	1563	8270	0	"S"	488	1488	NA	5e-04	0	"HG02723#2#JAHEOT010000034.1_19776337_20321518_1"	"AMY2A-201"	"2A"	"1-2-5-4-6-3-0-4-2-5-4-0-3-6-4-5-2-4-6-3-0"	"1.0-2.0-5.0-4.0-6.0-3.0-0.0-4.1-2.0-5.0-4.0-0.1-3.1-6.1-4.1-5.1-2.1-4.0-6.0-3.0-0.0"	19776491	"HG02723#2#JAHEOT010000034.1_19776337_20321518_1"	392941	401211
"ENST00000610648.1"	1736	4	1733	"-"	"HG02723#2#JAHEOT010000034.1_19776337_20321518_1"	545181	243882	252304	1720	8422	0	"P"	531	1638	1638	1e-04	0	"HG02723#2#JAHEOT010000034.1_19776337_20321518_1"	"AMY2B-208"	"2B"	"1-2-5-4-6-3-0-4-2-5-4-0-3-6-4-5-2-4-6-3-0"	"1.0-2.0-5.0-4.0-6.0-3.0-0.0-4.1-2.0-5.0-4.0-0.1-3.1-6.1-4.1-5.1-2.1-4.0-6.0-3.0-0.0"	19776491	"HG02723#2#JAHEOT010000034.1_19776337_20321518_1"	243882	252304
"ENST00000610648.1"	1736	4	1733	"+"	"HG02723#2#JAHEOT010000034.1_19776337_20321518_1"	545181	346605	355027	1720	8422	0	"S"	531	1638	NA	1e-04	0	"HG02723#2#JAHEOT010000034.1_19776337_20321518_1"	"AMY2B-208"	"2B"	"1-2-5-4-6-3-0-4-2-5-4-0-3-6-4-5-2-4-6-3-0"	"1.0-2.0-5.0-4.0-6.0-3.0-0.0-4.1-2.0-5.0-4.0-0.1-3.1-6.1-4.1-5.1-2.1-4.0-6.0-3.0-0.0"	19776491	"HG02723#2#JAHEOT010000034.1_19776337_20321518_1"	346605	355027
"ENST00000610648.1"	1736	4	1733	"+"	"HG02723#2#JAHEOT010000034.1_19776337_20321518_1"	545181	115110	123532	1720	8422	0	"S"	531	1638	NA	1e-04	0	"HG02723#2#JAHEOT010000034.1_19776337_20321518_1"	"AMY2B-208"	"2B"	"1-2-5-4-6-3-0-4-2-5-4-0-3-6-4-5-2-4-6-3-0"	"1.0-2.0-5.0-4.0-6.0-3.0-0.0-4.1-2.0-5.0-4.0-0.1-3.1-6.1-4.1-5.1-2.1-4.0-6.0-3.0-0.0"	19776491	"HG02723#2#JAHEOT010000034.1_19776337_20321518_1"	115110	123532
"ENST00000370083.9"	1785	2	1784	"+"	"HG02818#1#JAHEOS010000101.1_89626_496613_0"	406987	199738	208528	1769	8790	0	"P"	557	1686	1686	1e-04	0	"HG02818#1#JAHEOS010000101.1_89626_496613_0"	"AMY1A-201"	"1"	"1-2-5-2-6-4-2-5-4-6-3-0"	"1.0-2.0-5.0-2.1-6.1-4.1-2.0-5.0-4.0-6.0-3.0-0.0"	89724	"HG02818#1#JAHEOS010000101.1_89626_496613_0"	199738	208528
"ENST00000370083.9"	1785	2	1784	"+"	"HG02818#1#JAHEOS010000101.1_89626_496613_0"	406987	293852	302643	1769	8791	0	"S"	557	1686	NA	1e-04	0	"HG02818#1#JAHEOS010000101.1_89626_496613_0"	"AMY1A-201"	"1"	"1-2-5-2-6-4-2-5-4-6-3-0"	"1.0-2.0-5.0-2.1-6.1-4.1-2.0-5.0-4.0-6.0-3.0-0.0"	89724	"HG02818#1#JAHEOS010000101.1_89626_496613_0"	293852	302643
"ENST00000370083.9"	1785	2	1784	"-"	"HG02818#1#JAHEOS010000101.1_89626_496613_0"	406987	231387	240178	1769	8791	0	"S"	557	1686	NA	1e-04	0	"HG02818#1#JAHEOS010000101.1_89626_496613_0"	"AMY1A-201"	"1"	"1-2-5-2-6-4-2-5-4-6-3-0"	"1.0-2.0-5.0-2.1-6.1-4.1-2.0-5.0-4.0-6.0-3.0-0.0"	89724	"HG02818#1#JAHEOS010000101.1_89626_496613_0"	231387	240178
"ENST00000414303.7"	1584	4	1583	"+"	"HG02818#1#JAHEOS010000101.1_89626_496613_0"	406987	161417	169722	1568	8305	29	"P"	486	1493	1342	8e-04	0	"HG02818#1#JAHEOS010000101.1_89626_496613_0"	"AMY2A-201"	"2A"	"1-2-5-2-6-4-2-5-4-6-3-0"	"1.0-2.0-5.0-2.1-6.1-4.1-2.0-5.0-4.0-6.0-3.0-0.0"	89724	"HG02818#1#JAHEOS010000101.1_89626_496613_0"	161417	169722
"ENST00000610648.1"	1736	4	1733	"+"	"HG02818#1#JAHEOS010000101.1_89626_496613_0"	406987	115063	123485	1720	8422	48	"P"	531	1638	1371	1e-04	0	"HG02818#1#JAHEOS010000101.1_89626_496613_0"	"AMY2B-208"	"2B"	"1-2-5-2-6-4-2-5-4-6-3-0"	"1.0-2.0-5.0-2.1-6.1-4.1-2.0-5.0-4.0-6.0-3.0-0.0"	89724	"HG02818#1#JAHEOS010000101.1_89626_496613_0"	115063	123485
"ENST00000370083.9"	1785	2	1784	"-"	"HG02818#2#JAHEOR010000010.1_31775319_32183091_1"	407772	231351	240143	1769	8792	0	"P"	557	1686	1686	1e-04	0	"HG02818#2#JAHEOR010000010.1_31775319_32183091_1"	"AMY1A-201"	"1"	"1-2-5-2-6-4-2-5-4-6-3-0"	"1.0-2.0-5.0-2.1-6.1-4.1-2.0-5.0-4.0-6.0-3.0-0.0"	31775473	"HG02818#2#JAHEOR010000010.1_31775319_32183091_1"	231351	240143
"ENST00000370083.9"	1785	2	1784	"+"	"HG02818#2#JAHEOR010000010.1_31775319_32183091_1"	407772	293830	302621	1769	8791	0	"S"	557	1686	NA	1e-04	0	"HG02818#2#JAHEOR010000010.1_31775319_32183091_1"	"AMY1A-201"	"1"	"1-2-5-2-6-4-2-5-4-6-3-0"	"1.0-2.0-5.0-2.1-6.1-4.1-2.0-5.0-4.0-6.0-3.0-0.0"	31775473	"HG02818#2#JAHEOR010000010.1_31775319_32183091_1"	293830	302621
"ENST00000370083.9"	1785	2	1784	"+"	"HG02818#2#JAHEOR010000010.1_31775319_32183091_1"	407772	199708	208500	1769	8792	0	"S"	557	1686	NA	1e-04	0	"HG02818#2#JAHEOR010000010.1_31775319_32183091_1"	"AMY1A-201"	"1"	"1-2-5-2-6-4-2-5-4-6-3-0"	"1.0-2.0-5.0-2.1-6.1-4.1-2.0-5.0-4.0-6.0-3.0-0.0"	31775473	"HG02818#2#JAHEOR010000010.1_31775319_32183091_1"	199708	208500
"ENST00000414303.7"	1584	4	1583	"+"	"HG02818#2#JAHEOR010000010.1_31775319_32183091_1"	407772	161409	169713	1563	8304	28	"P"	488	1488	1342	5e-04	0	"HG02818#2#JAHEOR010000010.1_31775319_32183091_1"	"AMY2A-201"	"2A"	"1-2-5-2-6-4-2-5-4-6-3-0"	"1.0-2.0-5.0-2.1-6.1-4.1-2.0-5.0-4.0-6.0-3.0-0.0"	31775473	"HG02818#2#JAHEOR010000010.1_31775319_32183091_1"	161409	169713
"ENST00000610648.1"	1736	4	1733	"+"	"HG02818#2#JAHEOR010000010.1_31775319_32183091_1"	407772	115078	123502	1720	8424	48	"P"	531	1638	1371	1e-04	0	"HG02818#2#JAHEOR010000010.1_31775319_32183091_1"	"AMY2B-208"	"2B"	"1-2-5-2-6-4-2-5-4-6-3-0"	"1.0-2.0-5.0-2.1-6.1-4.1-2.0-5.0-4.0-6.0-3.0-0.0"	31775473	"HG02818#2#JAHEOR010000010.1_31775319_32183091_1"	115078	123502
"ENST00000370083.9"	1785	2	1784	"-"	"HG02886#1#JAHAOU010000178.1_62411_469262_0"	406851	231276	240068	1769	8792	0	"P"	557	1686	1686	1e-04	0	"HG02886#1#JAHAOU010000178.1_62411_469262_0"	"AMY1A-201"	"1"	"1-2-5-2-6-4-2-5-4-6-3-0"	"1.0-2.0-5.1-2.1-6.1-4.1-2.0-5.0-4.0-6.0-3.0-0.0"	62509	"HG02886#1#JAHAOU010000178.1_62411_469262_0"	231276	240068
"ENST00000370083.9"	1785	2	1784	"+"	"HG02886#1#JAHAOU010000178.1_62411_469262_0"	406851	293745	302536	1769	8791	0	"S"	557	1686	NA	1e-04	0	"HG02886#1#JAHAOU010000178.1_62411_469262_0"	"AMY1A-201"	"1"	"1-2-5-2-6-4-2-5-4-6-3-0"	"1.0-2.0-5.1-2.1-6.1-4.1-2.0-5.0-4.0-6.0-3.0-0.0"	62509	"HG02886#1#JAHAOU010000178.1_62411_469262_0"	293745	302536
"ENST00000370083.9"	1785	2	1784	"+"	"HG02886#1#JAHAOU010000178.1_62411_469262_0"	406851	199618	208409	1769	8791	0	"S"	557	1686	NA	1e-04	0	"HG02886#1#JAHAOU010000178.1_62411_469262_0"	"AMY1A-201"	"1"	"1-2-5-2-6-4-2-5-4-6-3-0"	"1.0-2.0-5.1-2.1-6.1-4.1-2.0-5.0-4.0-6.0-3.0-0.0"	62509	"HG02886#1#JAHAOU010000178.1_62411_469262_0"	199618	208409
"ENST00000414303.7"	1584	4	1583	"+"	"HG02886#1#JAHAOU010000178.1_62411_469262_0"	406851	161366	169636	1563	8270	28	"P"	488	1488	1342	5e-04	0	"HG02886#1#JAHAOU010000178.1_62411_469262_0"	"AMY2A-201"	"2A"	"1-2-5-2-6-4-2-5-4-6-3-0"	"1.0-2.0-5.1-2.1-6.1-4.1-2.0-5.0-4.0-6.0-3.0-0.0"	62509	"HG02886#1#JAHAOU010000178.1_62411_469262_0"	161366	169636
"ENST00000610648.1"	1736	4	1733	"+"	"HG02886#1#JAHAOU010000178.1_62411_469262_0"	406851	115023	123447	1720	8424	48	"P"	531	1638	1371	1e-04	0	"HG02886#1#JAHAOU010000178.1_62411_469262_0"	"AMY2B-208"	"2B"	"1-2-5-2-6-4-2-5-4-6-3-0"	"1.0-2.0-5.1-2.1-6.1-4.1-2.0-5.0-4.0-6.0-3.0-0.0"	62509	"HG02886#1#JAHAOU010000178.1_62411_469262_0"	115023	123447
"ENST00000370083.9"	1785	2	1784	"+"	"HG02886#2#JAHAOT010000031.1_87393_401061_0"	313668	199623	208414	1769	8791	50	"P"	557	1686	1398	1e-04	0	"HG02886#2#JAHAOT010000031.1_87393_401061_0"	"AMY1A-201"	"1"	"1-2-5-4-6-3-0"	"1.0-2.0-5.0-4.0-6.0-3.0-0.0"	87491	"HG02886#2#JAHAOT010000031.1_87393_401061_0"	199623	208414
"ENST00000414303.7"	1584	4	1579	"+"	"HG02886#2#JAHAOT010000031.1_87393_401061_0"	313668	161362	169628	1563	8266	28	"P"	484	1488	1342	0.001	0	"HG02886#2#JAHAOT010000031.1_87393_401061_0"	"AMY2A-201"	"2A"	"1-2-5-4-6-3-0"	"1.0-2.0-5.0-4.0-6.0-3.0-0.0"	87491	"HG02886#2#JAHAOT010000031.1_87393_401061_0"	161362	169628
"ENST00000610648.1"	1736	4	1733	"+"	"HG02886#2#JAHAOT010000031.1_87393_401061_0"	313668	115034	123456	1720	8422	51	"P"	531	1638	1351	1e-04	0	"HG02886#2#JAHAOT010000031.1_87393_401061_0"	"AMY2B-208"	"2B"	"1-2-5-4-6-3-0"	"1.0-2.0-5.0-4.0-6.0-3.0-0.0"	87491	"HG02886#2#JAHAOT010000031.1_87393_401061_0"	115034	123456
"ENST00000370083.9"	1785	2	1784	"+"	"HG03098#1#JAHEPM010000059.1_16676208_17105596_0"	429388	315351	324145	1769	8794	1	"P"	557	1686	1679	1e-04	0	"HG03098#1#JAHEPM010000059.1_16676208_17105596_0"	"AMY1A-201"	"1"	"1-2-5-4-6-3-0-4-2-5-4-6-3-0"	"1.0-2.0-5.0-4.0-6.0-3.0-0.0-4.1-2.0-5.0-4.0-6.0-3.0-0.0"	16676306	"HG03098#1#JAHEPM010000059.1_16676208_17105596_0"	315351	324145
"ENST00000370083.9"	1785	2	1784	"+"	"HG03098#1#JAHEPM010000059.1_16676208_17105596_0"	429388	199605	208385	1762	8780	0	"S"	545	1679	NA	0.0016	0	"HG03098#1#JAHEPM010000059.1_16676208_17105596_0"	"AMY1A-201"	"1"	"1-2-5-4-6-3-0-4-2-5-4-6-3-0"	"1.0-2.0-5.0-4.0-6.0-3.0-0.0-4.1-2.0-5.0-4.0-6.0-3.0-0.0"	16676306	"HG03098#1#JAHEPM010000059.1_16676208_17105596_0"	199605	208385
"ENST00000414303.7"	1584	4	1583	"+"	"HG03098#1#JAHEPM010000059.1_16676208_17105596_0"	429388	161342	169612	1563	8270	0	"P"	488	1488	1488	5e-04	0	"HG03098#1#JAHEPM010000059.1_16676208_17105596_0"	"AMY2A-201"	"2A"	"1-2-5-4-6-3-0-4-2-5-4-6-3-0"	"1.0-2.0-5.0-4.0-6.0-3.0-0.0-4.1-2.0-5.0-4.0-6.0-3.0-0.0"	16676306	"HG03098#1#JAHEPM010000059.1_16676208_17105596_0"	161342	169612
"ENST00000414303.7"	1584	4	1583	"+"	"HG03098#1#JAHEPM010000059.1_16676208_17105596_0"	429388	277092	285362	1563	8270	0	"S"	488	1488	NA	5e-04	0	"HG03098#1#JAHEPM010000059.1_16676208_17105596_0"	"AMY2A-201"	"2A"	"1-2-5-4-6-3-0-4-2-5-4-6-3-0"	"1.0-2.0-5.0-4.0-6.0-3.0-0.0-4.1-2.0-5.0-4.0-6.0-3.0-0.0"	16676306	"HG03098#1#JAHEPM010000059.1_16676208_17105596_0"	277092	285362
"ENST00000610648.1"	1736	4	1733	"+"	"HG03098#1#JAHEPM010000059.1_16676208_17105596_0"	429388	115005	123427	1720	8422	2	"P"	531	1638	1626	1e-04	0	"HG03098#1#JAHEPM010000059.1_16676208_17105596_0"	"AMY2B-208"	"2B"	"1-2-5-4-6-3-0-4-2-5-4-6-3-0"	"1.0-2.0-5.0-4.0-6.0-3.0-0.0-4.1-2.0-5.0-4.0-6.0-3.0-0.0"	16676306	"HG03098#1#JAHEPM010000059.1_16676208_17105596_0"	115005	123427
"ENST00000610648.1"	1736	4	1733	"+"	"HG03098#1#JAHEPM010000059.1_16676208_17105596_0"	429388	230755	239177	1708	8422	0	"S"	527	1626	NA	6e-04	0	"HG03098#1#JAHEPM010000059.1_16676208_17105596_0"	"AMY2B-208"	"2B"	"1-2-5-4-6-3-0-4-2-5-4-6-3-0"	"1.0-2.0-5.0-4.0-6.0-3.0-0.0-4.1-2.0-5.0-4.0-6.0-3.0-0.0"	16676306	"HG03098#1#JAHEPM010000059.1_16676208_17105596_0"	230755	239177
"ENST00000370083.9"	1785	2	1784	"+"	"HG03098#2#JAHEPL010000003.1_93803759_94117426_0"	313667	199667	208458	1769	8791	51	"P"	557	1686	1393	1e-04	0	"HG03098#2#JAHEPL010000003.1_93803759_94117426_0"	"AMY1A-201"	"1"	"1-2-5-4-6-3-0"	"1.0-2.0-5.0-4.0-6.0-3.0-0.0"	93803857	"HG03098#2#JAHEPL010000003.1_93803759_94117426_0"	199667	208458
"ENST00000414303.7"	1584	4	1583	"+"	"HG03098#2#JAHEPL010000003.1_93803759_94117426_0"	313667	161369	169673	1563	8304	28	"P"	488	1488	1342	5e-04	0	"HG03098#2#JAHEPL010000003.1_93803759_94117426_0"	"AMY2A-201"	"2A"	"1-2-5-4-6-3-0"	"1.0-2.0-5.0-4.0-6.0-3.0-0.0"	93803857	"HG03098#2#JAHEPL010000003.1_93803759_94117426_0"	161369	169673
"ENST00000610648.1"	1736	4	1733	"+"	"HG03098#2#JAHEPL010000003.1_93803759_94117426_0"	313667	115040	123464	1720	8424	52	"P"	531	1638	1347	1e-04	0	"HG03098#2#JAHEPL010000003.1_93803759_94117426_0"	"AMY2B-208"	"2B"	"1-2-5-4-6-3-0"	"1.0-2.0-5.0-4.0-6.0-3.0-0.0"	93803857	"HG03098#2#JAHEPL010000003.1_93803759_94117426_0"	115040	123464
"ENST00000370083.9"	1785	2	1784	"+"	"HG03453#1#JAGYVW010000157.1_2105722_2585000_1"	479278	272074	280867	1769	8793	0	"P"	557	1686	1686	1e-04	0	"HG03453#1#JAGYVW010000157.1_2105722_2585000_1"	"AMY1A-201"	"1"	"1-2-5-2-4-6-2-5-4-6-2-5-4-6-3-0"	"1.0-2.0-5.0-2.1-4.0-6.0-2.0-5.0-4.0-6.0-2.0-5.0-4.0-6.0-3.0-0.0"	2105876	"HG03453#1#JAGYVW010000157.1_2105722_2585000_1"	272074	280867
"ENST00000370083.9"	1785	2	1784	"+"	"HG03453#1#JAGYVW010000157.1_2105722_2585000_1"	479278	366208	374998	1769	8790	0	"S"	557	1686	NA	1e-04	0	"HG03453#1#JAGYVW010000157.1_2105722_2585000_1"	"AMY1A-201"	"1"	"1-2-5-2-4-6-2-5-4-6-2-5-4-6-3-0"	"1.0-2.0-5.0-2.1-4.0-6.0-2.0-5.0-4.0-6.0-2.0-5.0-4.0-6.0-3.0-0.0"	2105876	"HG03453#1#JAGYVW010000157.1_2105722_2585000_1"	366208	374998
"ENST00000370083.9"	1785	2	1784	"+"	"HG03453#1#JAGYVW010000157.1_2105722_2585000_1"	479278	199652	208444	1769	8792	0	"S"	557	1686	NA	1e-04	0	"HG03453#1#JAGYVW010000157.1_2105722_2585000_1"	"AMY1A-201"	"1"	"1-2-5-2-4-6-2-5-4-6-2-5-4-6-3-0"	"1.0-2.0-5.0-2.1-4.0-6.0-2.0-5.0-4.0-6.0-2.0-5.0-4.0-6.0-3.0-0.0"	2105876	"HG03453#1#JAGYVW010000157.1_2105722_2585000_1"	199652	208444
"ENST00000370083.9"	1785	2	1784	"-"	"HG03453#1#JAGYVW010000157.1_2105722_2585000_1"	479278	303727	312519	1769	8792	0	"S"	557	1686	NA	1e-04	0	"HG03453#1#JAGYVW010000157.1_2105722_2585000_1"	"AMY1A-201"	"1"	"1-2-5-2-4-6-2-5-4-6-2-5-4-6-3-0"	"1.0-2.0-5.0-2.1-4.0-6.0-2.0-5.0-4.0-6.0-2.0-5.0-4.0-6.0-3.0-0.0"	2105876	"HG03453#1#JAGYVW010000157.1_2105722_2585000_1"	303727	312519
"ENST00000414303.7"	1584	4	1583	"+"	"HG03453#1#JAGYVW010000157.1_2105722_2585000_1"	479278	161392	169662	1569	8270	0	"P"	486	1494	1494	8e-04	0	"HG03453#1#JAGYVW010000157.1_2105722_2585000_1"	"AMY2A-201"	"2A"	"1-2-5-2-4-6-2-5-4-6-2-5-4-6-3-0"	"1.0-2.0-5.0-2.1-4.0-6.0-2.0-5.0-4.0-6.0-2.0-5.0-4.0-6.0-3.0-0.0"	2105876	"HG03453#1#JAGYVW010000157.1_2105722_2585000_1"	161392	169662
"ENST00000414303.7"	1584	4	1583	"+"	"HG03453#1#JAGYVW010000157.1_2105722_2585000_1"	479278	233814	242084	1569	8270	0	"S"	486	1494	NA	8e-04	0	"HG03453#1#JAGYVW010000157.1_2105722_2585000_1"	"AMY2A-201"	"2A"	"1-2-5-2-4-6-2-5-4-6-2-5-4-6-3-0"	"1.0-2.0-5.0-2.1-4.0-6.0-2.0-5.0-4.0-6.0-2.0-5.0-4.0-6.0-3.0-0.0"	2105876	"HG03453#1#JAGYVW010000157.1_2105722_2585000_1"	233814	242084
"ENST00000610648.1"	1736	4	1733	"+"	"HG03453#1#JAGYVW010000157.1_2105722_2585000_1"	479278	115063	123481	1720	8418	46	"P"	531	1638	1382	1e-04	0	"HG03453#1#JAGYVW010000157.1_2105722_2585000_1"	"AMY2B-208"	"2B"	"1-2-5-2-4-6-2-5-4-6-2-5-4-6-3-0"	"1.0-2.0-5.0-2.1-4.0-6.0-2.0-5.0-4.0-6.0-2.0-5.0-4.0-6.0-3.0-0.0"	2105876	"HG03453#1#JAGYVW010000157.1_2105722_2585000_1"	115063	123481
"ENST00000370083.9"	1785	2	1784	"-"	"HG03453#2#JAGYVV010000088.1_22597550_23005370_1"	407820	231339	240133	1769	8794	0	"P"	557	1686	1686	1e-04	0	"HG03453#2#JAGYVV010000088.1_22597550_23005370_1"	"AMY1A-201"	"1"	"1-2-5-2-4-6-2-5-4-3-0"	"1.0-2.0-5.1-2.1-4.0-6.0-2.0-5.0-4.0-3.0-0.0"	22597704	"HG03453#2#JAGYVV010000088.1_22597550_23005370_1"	231339	240133
"ENST00000370083.9"	1785	2	1784	"+"	"HG03453#2#JAGYVV010000088.1_22597550_23005370_1"	407820	293811	302602	1769	8791	0	"S"	557	1686	NA	1e-04	0	"HG03453#2#JAGYVV010000088.1_22597550_23005370_1"	"AMY1A-201"	"1"	"1-2-5-2-4-6-2-5-4-3-0"	"1.0-2.0-5.1-2.1-4.0-6.0-2.0-5.0-4.0-3.0-0.0"	22597704	"HG03453#2#JAGYVV010000088.1_22597550_23005370_1"	293811	302602
"ENST00000370083.9"	1785	2	1784	"+"	"HG03453#2#JAGYVV010000088.1_22597550_23005370_1"	407820	199680	208474	1767	8794	0	"S"	553	1684	NA	6e-04	0	"HG03453#2#JAGYVV010000088.1_22597550_23005370_1"	"AMY1A-201"	"1"	"1-2-5-2-4-6-2-5-4-3-0"	"1.0-2.0-5.1-2.1-4.0-6.0-2.0-5.0-4.0-3.0-0.0"	22597704	"HG03453#2#JAGYVV010000088.1_22597550_23005370_1"	199680	208474
"ENST00000414303.7"	1584	4	1583	"+"	"HG03453#2#JAGYVV010000088.1_22597550_23005370_1"	407820	161420	169690	1566	8270	29	"P"	486	1491	1342	8e-04	0	"HG03453#2#JAGYVV010000088.1_22597550_23005370_1"	"AMY2A-201"	"2A"	"1-2-5-2-4-6-2-5-4-3-0"	"1.0-2.0-5.1-2.1-4.0-6.0-2.0-5.0-4.0-3.0-0.0"	22597704	"HG03453#2#JAGYVV010000088.1_22597550_23005370_1"	161420	169690
"ENST00000610648.1"	1736	4	1733	"+"	"HG03453#2#JAGYVV010000088.1_22597550_23005370_1"	407820	115095	123517	1720	8422	48	"P"	531	1638	1371	1e-04	0	"HG03453#2#JAGYVV010000088.1_22597550_23005370_1"	"AMY2B-208"	"2B"	"1-2-5-2-4-6-2-5-4-3-0"	"1.0-2.0-5.1-2.1-4.0-6.0-2.0-5.0-4.0-3.0-0.0"	22597704	"HG03453#2#JAGYVV010000088.1_22597550_23005370_1"	115095	123517
"ENST00000370083.9"	1785	2	1784	"+"	"HG03486#1#JAHEOQ010000123.1_16677696_17085575_0"	407879	199649	208441	1769	8792	0	"P"	557	1686	1686	1e-04	0	"HG03486#1#JAHEOQ010000123.1_16677696_17085575_0"	"AMY1A-201"	"1"	"1-2-5-2-6-4-2-5-4-3-0"	"1.0-2.0-5.0-2.1-6.1-4.1-2.0-5.0-4.0-3.0-0.0"	16677795	"HG03486#1#JAHEOQ010000123.1_16677696_17085575_0"	199649	208441
"ENST00000370083.9"	1785	2	1784	"-"	"HG03486#1#JAHEOQ010000123.1_16677696_17085575_0"	407879	231305	240098	1769	8793	0	"S"	557	1686	NA	1e-04	0	"HG03486#1#JAHEOQ010000123.1_16677696_17085575_0"	"AMY1A-201"	"1"	"1-2-5-2-6-4-2-5-4-3-0"	"1.0-2.0-5.0-2.1-6.1-4.1-2.0-5.0-4.0-3.0-0.0"	16677795	"HG03486#1#JAHEOQ010000123.1_16677696_17085575_0"	231305	240098
"ENST00000370083.9"	1785	2	1784	"+"	"HG03486#1#JAHEOQ010000123.1_16677696_17085575_0"	407879	293776	302568	1769	8792	0	"S"	557	1686	NA	1e-04	0	"HG03486#1#JAHEOQ010000123.1_16677696_17085575_0"	"AMY1A-201"	"1"	"1-2-5-2-6-4-2-5-4-3-0"	"1.0-2.0-5.0-2.1-6.1-4.1-2.0-5.0-4.0-3.0-0.0"	16677795	"HG03486#1#JAHEOQ010000123.1_16677696_17085575_0"	293776	302568
"ENST00000414303.7"	1584	4	1583	"+"	"HG03486#1#JAHEOQ010000123.1_16677696_17085575_0"	407879	161395	169665	1574	8270	30	"P"	491	1499	1342	1e-04	0	"HG03486#1#JAHEOQ010000123.1_16677696_17085575_0"	"AMY2A-201"	"2A"	"1-2-5-2-6-4-2-5-4-3-0"	"1.0-2.0-5.0-2.1-6.1-4.1-2.0-5.0-4.0-3.0-0.0"	16677795	"HG03486#1#JAHEOQ010000123.1_16677696_17085575_0"	161395	169665
"ENST00000610648.1"	1736	4	1733	"+"	"HG03486#1#JAHEOQ010000123.1_16677696_17085575_0"	407879	115071	123493	1720	8422	48	"P"	531	1638	1371	1e-04	0	"HG03486#1#JAHEOQ010000123.1_16677696_17085575_0"	"AMY2B-208"	"2B"	"1-2-5-2-6-4-2-5-4-3-0"	"1.0-2.0-5.0-2.1-6.1-4.1-2.0-5.0-4.0-3.0-0.0"	16677795	"HG03486#1#JAHEOQ010000123.1_16677696_17085575_0"	115071	123493
"ENST00000370083.9"	1785	2	1784	"+"	"HG03486#2#JAHEOP010000248.1_2105565_2584784_1"	479219	199638	208430	1769	8792	0	"P"	557	1686	1686	1e-04	0	"HG03486#2#JAHEOP010000248.1_2105565_2584784_1"	"AMY1A-201"	"1"	"1-2-5-2-4-6-2-5-4-6-2-5-4-6-3-0"	"1.0-2.0-5.1-2.1-4.0-6.0-2.0-5.0-4.0-6.0-2.0-5.0-4.0-6.0-3.0-0.0"	2105719	"HG03486#2#JAHEOP010000248.1_2105565_2584784_1"	199638	208430
"ENST00000370083.9"	1785	2	1784	"+"	"HG03486#2#JAHEOP010000248.1_2105565_2584784_1"	479219	272048	280840	1769	8792	0	"S"	557	1686	NA	1e-04	0	"HG03486#2#JAHEOP010000248.1_2105565_2584784_1"	"AMY1A-201"	"1"	"1-2-5-2-4-6-2-5-4-6-2-5-4-6-3-0"	"1.0-2.0-5.1-2.1-4.0-6.0-2.0-5.0-4.0-6.0-2.0-5.0-4.0-6.0-3.0-0.0"	2105719	"HG03486#2#JAHEOP010000248.1_2105565_2584784_1"	272048	280840
"ENST00000370083.9"	1785	2	1784	"-"	"HG03486#2#JAHEOP010000248.1_2105565_2584784_1"	479219	303702	312493	1769	8791	0	"S"	557	1686	NA	1e-04	0	"HG03486#2#JAHEOP010000248.1_2105565_2584784_1"	"AMY1A-201"	"1"	"1-2-5-2-4-6-2-5-4-6-2-5-4-6-3-0"	"1.0-2.0-5.1-2.1-4.0-6.0-2.0-5.0-4.0-6.0-2.0-5.0-4.0-6.0-3.0-0.0"	2105719	"HG03486#2#JAHEOP010000248.1_2105565_2584784_1"	303702	312493
"ENST00000370083.9"	1785	2	1784	"+"	"HG03486#2#JAHEOP010000248.1_2105565_2584784_1"	479219	366167	374956	1769	8789	0	"S"	557	1686	NA	1e-04	0	"HG03486#2#JAHEOP010000248.1_2105565_2584784_1"	"AMY1A-201"	"1"	"1-2-5-2-4-6-2-5-4-6-2-5-4-6-3-0"	"1.0-2.0-5.1-2.1-4.0-6.0-2.0-5.0-4.0-6.0-2.0-5.0-4.0-6.0-3.0-0.0"	2105719	"HG03486#2#JAHEOP010000248.1_2105565_2584784_1"	366167	374956
"ENST00000414303.7"	1584	4	1583	"+"	"HG03486#2#JAHEOP010000248.1_2105565_2584784_1"	479219	233799	242069	1569	8270	0	"P"	486	1494	1494	8e-04	0	"HG03486#2#JAHEOP010000248.1_2105565_2584784_1"	"AMY2A-201"	"2A"	"1-2-5-2-4-6-2-5-4-6-2-5-4-6-3-0"	"1.0-2.0-5.1-2.1-4.0-6.0-2.0-5.0-4.0-6.0-2.0-5.0-4.0-6.0-3.0-0.0"	2105719	"HG03486#2#JAHEOP010000248.1_2105565_2584784_1"	233799	242069
"ENST00000414303.7"	1584	4	1583	"+"	"HG03486#2#JAHEOP010000248.1_2105565_2584784_1"	479219	161381	169651	1569	8270	0	"S"	486	1494	NA	8e-04	0	"HG03486#2#JAHEOP010000248.1_2105565_2584784_1"	"AMY2A-201"	"2A"	"1-2-5-2-4-6-2-5-4-6-2-5-4-6-3-0"	"1.0-2.0-5.1-2.1-4.0-6.0-2.0-5.0-4.0-6.0-2.0-5.0-4.0-6.0-3.0-0.0"	2105719	"HG03486#2#JAHEOP010000248.1_2105565_2584784_1"	161381	169651
"ENST00000610648.1"	1736	4	1733	"+"	"HG03486#2#JAHEOP010000248.1_2105565_2584784_1"	479219	115050	123470	1720	8420	48	"P"	531	1638	1371	1e-04	0	"HG03486#2#JAHEOP010000248.1_2105565_2584784_1"	"AMY2B-208"	"2B"	"1-2-5-2-4-6-2-5-4-6-2-5-4-6-3-0"	"1.0-2.0-5.1-2.1-4.0-6.0-2.0-5.0-4.0-6.0-2.0-5.0-4.0-6.0-3.0-0.0"	2105719	"HG03486#2#JAHEOP010000248.1_2105565_2584784_1"	115050	123470
"ENST00000370083.9"	1785	2	1784	"+"	"HG03492#1#JAHEPI010000180.1_2103395_2543326_1"	439931	199686	208477	1769	8791	0	"P"	557	1686	1686	1e-04	0	"HG03492#1#JAHEPI010000180.1_2103395_2543326_1"	"AMY1A-201"	"1"	"1-2-5-2-2-5-4-2-5-4-3-0"	"1.0-2.0-5.1-2.1-2.0-5.0-4.0-2.0-5.0-4.0-3.0-0.0"	2103549	"HG03492#1#JAHEPI010000180.1_2103395_2543326_1"	199686	208477
"ENST00000370083.9"	1785	2	1784	"+"	"HG03492#1#JAHEPI010000180.1_2103395_2543326_1"	439931	325964	334755	1769	8791	0	"S"	557	1686	NA	1e-04	0	"HG03492#1#JAHEPI010000180.1_2103395_2543326_1"	"AMY1A-201"	"1"	"1-2-5-2-2-5-4-2-5-4-3-0"	"1.0-2.0-5.1-2.1-2.0-5.0-4.0-2.0-5.0-4.0-3.0-0.0"	2103549	"HG03492#1#JAHEPI010000180.1_2103395_2543326_1"	325964	334755
"ENST00000370083.9"	1785	2	1784	"-"	"HG03492#1#JAHEPI010000180.1_2103395_2543326_1"	439931	263489	272282	1769	8793	0	"S"	557	1686	NA	1e-04	0	"HG03492#1#JAHEPI010000180.1_2103395_2543326_1"	"AMY1A-201"	"1"	"1-2-5-2-2-5-4-2-5-4-3-0"	"1.0-2.0-5.1-2.1-2.0-5.0-4.0-2.0-5.0-4.0-3.0-0.0"	2103549	"HG03492#1#JAHEPI010000180.1_2103395_2543326_1"	263489	272282
"ENST00000414303.7"	1584	4	1583	"+"	"HG03492#1#JAHEPI010000180.1_2103395_2543326_1"	439931	161421	169691	1574	8270	1	"P"	491	1499	1493	1e-04	0	"HG03492#1#JAHEPI010000180.1_2103395_2543326_1"	"AMY2A-201"	"2A"	"1-2-5-2-2-5-4-2-5-4-3-0"	"1.0-2.0-5.1-2.1-2.0-5.0-4.0-2.0-5.0-4.0-3.0-0.0"	2103549	"HG03492#1#JAHEPI010000180.1_2103395_2543326_1"	161421	169691
"ENST00000414303.7"	1584	4	1583	"+"	"HG03492#1#JAHEPI010000180.1_2103395_2543326_1"	439931	233842	242112	1568	8270	0	"S"	485	1493	NA	0.001	0	"HG03492#1#JAHEPI010000180.1_2103395_2543326_1"	"AMY2A-201"	"2A"	"1-2-5-2-2-5-4-2-5-4-3-0"	"1.0-2.0-5.1-2.1-2.0-5.0-4.0-2.0-5.0-4.0-3.0-0.0"	2103549	"HG03492#1#JAHEPI010000180.1_2103395_2543326_1"	233842	242112
"ENST00000610648.1"	1736	4	1733	"+"	"HG03492#1#JAHEPI010000180.1_2103395_2543326_1"	439931	115093	123515	1720	8422	48	"P"	531	1638	1371	1e-04	0	"HG03492#1#JAHEPI010000180.1_2103395_2543326_1"	"AMY2B-208"	"2B"	"1-2-5-2-2-5-4-2-5-4-3-0"	"1.0-2.0-5.1-2.1-2.0-5.0-4.0-2.0-5.0-4.0-3.0-0.0"	2103549	"HG03492#1#JAHEPI010000180.1_2103395_2543326_1"	115093	123515
"ENST00000370083.9"	1785	2	1784	"+"	"HG03492#2#JAHEPH010000288.1_2098270_2432686_1"	334416	221393	230184	1769	8791	0	"P"	557	1686	1686	1e-04	0	"HG03492#2#JAHEPH010000288.1_2098270_2432686_1"	"AMY1A-201"	"1"	"1-2-5-2-4-3-0"	"1.0-2.0-5.1-2.1-4.0-3.0-0.0"	2098424	"HG03492#2#JAHEPH010000288.1_2098270_2432686_1"	221393	230184
"ENST00000370083.9"	1785	2	1784	"-"	"HG03492#2#JAHEPH010000288.1_2098270_2432686_1"	334416	158917	167710	1769	8793	0	"S"	557	1686	NA	1e-04	0	"HG03492#2#JAHEPH010000288.1_2098270_2432686_1"	"AMY1A-201"	"1"	"1-2-5-2-4-3-0"	"1.0-2.0-5.1-2.1-4.0-3.0-0.0"	2098424	"HG03492#2#JAHEPH010000288.1_2098270_2432686_1"	158917	167710
"ENST00000610648.1"	1736	4	1733	"+"	"HG03492#2#JAHEPH010000288.1_2098270_2432686_1"	334416	115091	123515	1720	8424	48	"P"	531	1638	1371	1e-04	0	"HG03492#2#JAHEPH010000288.1_2098270_2432686_1"	"AMY2B-208"	"2B"	"1-2-5-2-4-3-0"	"1.0-2.0-5.1-2.1-4.0-3.0-0.0"	2098424	"HG03492#2#JAHEPH010000288.1_2098270_2432686_1"	115091	123515
"ENST00000370083.9"	1785	2	1784	"+"	"HG03516#1#JAGYYT010000012.1_24170958_24578778_1"	407820	199699	208490	1769	8791	0	"P"	557	1686	1686	1e-04	0	"HG03516#1#JAGYYT010000012.1_24170958_24578778_1"	"AMY1A-201"	"1"	"1-2-5-2-4-6-2-5-4-6-3-0"	"1.0-2.0-5.1-2.1-4.0-6.0-2.0-5.0-4.0-6.0-3.0-0.0"	24171112	"HG03516#1#JAGYYT010000012.1_24170958_24578778_1"	199699	208490
"ENST00000370083.9"	1785	2	1784	"+"	"HG03516#1#JAGYYT010000012.1_24170958_24578778_1"	407820	293821	302612	1769	8791	0	"S"	557	1686	NA	1e-04	0	"HG03516#1#JAGYYT010000012.1_24170958_24578778_1"	"AMY1A-201"	"1"	"1-2-5-2-4-6-2-5-4-6-3-0"	"1.0-2.0-5.1-2.1-4.0-6.0-2.0-5.0-4.0-6.0-3.0-0.0"	24171112	"HG03516#1#JAGYYT010000012.1_24170958_24578778_1"	293821	302612
"ENST00000370083.9"	1785	2	1784	"-"	"HG03516#1#JAGYYT010000012.1_24170958_24578778_1"	407820	231348	240139	1769	8791	0	"S"	557	1686	NA	1e-04	0	"HG03516#1#JAGYYT010000012.1_24170958_24578778_1"	"AMY1A-201"	"1"	"1-2-5-2-4-6-2-5-4-6-3-0"	"1.0-2.0-5.1-2.1-4.0-6.0-2.0-5.0-4.0-6.0-3.0-0.0"	24171112	"HG03516#1#JAGYYT010000012.1_24170958_24578778_1"	231348	240139
"ENST00000414303.7"	1584	4	1579	"+"	"HG03516#1#JAGYYT010000012.1_24170958_24578778_1"	407820	161446	169712	1563	8266	28	"P"	484	1488	1342	0.001	0	"HG03516#1#JAGYYT010000012.1_24170958_24578778_1"	"AMY2A-201"	"2A"	"1-2-5-2-4-6-2-5-4-6-3-0"	"1.0-2.0-5.1-2.1-4.0-6.0-2.0-5.0-4.0-6.0-3.0-0.0"	24171112	"HG03516#1#JAGYYT010000012.1_24170958_24578778_1"	161446	169712
"ENST00000610648.1"	1736	4	1733	"+"	"HG03516#1#JAGYYT010000012.1_24170958_24578778_1"	407820	115129	123551	1720	8422	48	"P"	531	1638	1371	1e-04	0	"HG03516#1#JAGYYT010000012.1_24170958_24578778_1"	"AMY2B-208"	"2B"	"1-2-5-2-4-6-2-5-4-6-3-0"	"1.0-2.0-5.1-2.1-4.0-6.0-2.0-5.0-4.0-6.0-3.0-0.0"	24171112	"HG03516#1#JAGYYT010000012.1_24170958_24578778_1"	115129	123551
"ENST00000370083.9"	1785	2	1784	"+"	"HG03516#2#JAGYYS010000004.1_24452130_24859892_1"	407762	293812	302603	1769	8791	0	"P"	557	1686	1686	1e-04	0	"HG03516#2#JAGYYS010000004.1_24452130_24859892_1"	"AMY1A-201"	"1"	"1-2-5-2-6-4-2-5-4-6-3-0"	"1.0-2.0-5.1-2.1-6.1-4.1-2.0-5.0-4.0-6.0-3.0-0.0"	24452284	"HG03516#2#JAGYYS010000004.1_24452130_24859892_1"	293812	302603
"ENST00000370083.9"	1785	2	1784	"+"	"HG03516#2#JAGYYS010000004.1_24452130_24859892_1"	407762	199690	208482	1769	8792	0	"S"	557	1686	NA	1e-04	0	"HG03516#2#JAGYYS010000004.1_24452130_24859892_1"	"AMY1A-201"	"1"	"1-2-5-2-6-4-2-5-4-6-3-0"	"1.0-2.0-5.1-2.1-6.1-4.1-2.0-5.0-4.0-6.0-3.0-0.0"	24452284	"HG03516#2#JAGYYS010000004.1_24452130_24859892_1"	199690	208482
"ENST00000370083.9"	1785	2	1784	"-"	"HG03516#2#JAGYYS010000004.1_24452130_24859892_1"	407762	231342	240134	1769	8792	0	"S"	557	1686	NA	1e-04	0	"HG03516#2#JAGYYS010000004.1_24452130_24859892_1"	"AMY1A-201"	"1"	"1-2-5-2-6-4-2-5-4-6-3-0"	"1.0-2.0-5.1-2.1-6.1-4.1-2.0-5.0-4.0-6.0-3.0-0.0"	24452284	"HG03516#2#JAGYYS010000004.1_24452130_24859892_1"	231342	240134
"ENST00000414303.7"	1584	4	1583	"+"	"HG03516#2#JAGYYS010000004.1_24452130_24859892_1"	407762	161429	169699	1563	8270	29	"P"	488	1488	1336	5e-04	0	"HG03516#2#JAGYYS010000004.1_24452130_24859892_1"	"AMY2A-201"	"2A"	"1-2-5-2-6-4-2-5-4-6-3-0"	"1.0-2.0-5.1-2.1-6.1-4.1-2.0-5.0-4.0-6.0-3.0-0.0"	24452284	"HG03516#2#JAGYYS010000004.1_24452130_24859892_1"	161429	169699
"ENST00000610648.1"	1736	4	1733	"+"	"HG03516#2#JAGYYS010000004.1_24452130_24859892_1"	407762	115101	123523	1714	8422	47	"P"	525	1632	1371	9e-04	0	"HG03516#2#JAGYYS010000004.1_24452130_24859892_1"	"AMY2B-208"	"2B"	"1-2-5-2-6-4-2-5-4-6-3-0"	"1.0-2.0-5.1-2.1-6.1-4.1-2.0-5.0-4.0-6.0-3.0-0.0"	24452284	"HG03516#2#JAGYYS010000004.1_24452130_24859892_1"	115101	123523
"ENST00000370083.9"	1785	2	1784	"+"	"HG03540#1#JAGYVY010000208.1_95187_596142_0"	500955	293744	302536	1769	8792	0	"P"	557	1686	1686	1e-04	0	"HG03540#1#JAGYVY010000208.1_95187_596142_0"	"AMY1A-201"	"1"	"1-2-5-2-6-4-2-5-2-6-4-2-5-4-6-3-0"	"1.0-2.0-5.1-2.1-6.1-4.1-2.0-5.0-2.1-6.1-4.1-2.0-5.0-4.0-6.0-3.0-0.0"	95285	"HG03540#1#JAGYVY010000208.1_95187_596142_0"	293744	302536
"ENST00000370083.9"	1785	2	1784	"+"	"HG03540#1#JAGYVY010000208.1_95187_596142_0"	500955	199606	208399	1769	8793	0	"S"	557	1686	NA	1e-04	0	"HG03540#1#JAGYVY010000208.1_95187_596142_0"	"AMY1A-201"	"1"	"1-2-5-2-6-4-2-5-2-6-4-2-5-4-6-3-0"	"1.0-2.0-5.1-2.1-6.1-4.1-2.0-5.0-2.1-6.1-4.1-2.0-5.0-4.0-6.0-3.0-0.0"	95285	"HG03540#1#JAGYVY010000208.1_95187_596142_0"	199606	208399
"ENST00000370083.9"	1785	2	1784	"+"	"HG03540#1#JAGYVY010000208.1_95187_596142_0"	500955	387871	396662	1769	8791	0	"S"	557	1686	NA	1e-04	0	"HG03540#1#JAGYVY010000208.1_95187_596142_0"	"AMY1A-201"	"1"	"1-2-5-2-6-4-2-5-2-6-4-2-5-4-6-3-0"	"1.0-2.0-5.1-2.1-6.1-4.1-2.0-5.0-2.1-6.1-4.1-2.0-5.0-4.0-6.0-3.0-0.0"	95285	"HG03540#1#JAGYVY010000208.1_95187_596142_0"	387871	396662
"ENST00000370083.9"	1785	2	1784	"-"	"HG03540#1#JAGYVY010000208.1_95187_596142_0"	500955	325397	334189	1769	8792	0	"S"	557	1686	NA	1e-04	0	"HG03540#1#JAGYVY010000208.1_95187_596142_0"	"AMY1A-201"	"1"	"1-2-5-2-6-4-2-5-2-6-4-2-5-4-6-3-0"	"1.0-2.0-5.1-2.1-6.1-4.1-2.0-5.0-2.1-6.1-4.1-2.0-5.0-4.0-6.0-3.0-0.0"	95285	"HG03540#1#JAGYVY010000208.1_95187_596142_0"	325397	334189
"ENST00000370083.9"	1785	2	1784	"-"	"HG03540#1#JAGYVY010000208.1_95187_596142_0"	500955	231262	240054	1769	8792	0	"S"	557	1686	NA	1e-04	0	"HG03540#1#JAGYVY010000208.1_95187_596142_0"	"AMY1A-201"	"1"	"1-2-5-2-6-4-2-5-2-6-4-2-5-4-6-3-0"	"1.0-2.0-5.1-2.1-6.1-4.1-2.0-5.0-2.1-6.1-4.1-2.0-5.0-4.0-6.0-3.0-0.0"	95285	"HG03540#1#JAGYVY010000208.1_95187_596142_0"	231262	240054
"ENST00000414303.7"	1584	4	1583	"+"	"HG03540#1#JAGYVY010000208.1_95187_596142_0"	500955	161341	169611	1563	8270	28	"P"	488	1488	1342	5e-04	0	"HG03540#1#JAGYVY010000208.1_95187_596142_0"	"AMY2A-201"	"2A"	"1-2-5-2-6-4-2-5-2-6-4-2-5-4-6-3-0"	"1.0-2.0-5.1-2.1-6.1-4.1-2.0-5.0-2.1-6.1-4.1-2.0-5.0-4.0-6.0-3.0-0.0"	95285	"HG03540#1#JAGYVY010000208.1_95187_596142_0"	161341	169611
"ENST00000610648.1"	1736	4	1733	"+"	"HG03540#1#JAGYVY010000208.1_95187_596142_0"	500955	115011	123435	1720	8424	48	"P"	531	1638	1371	1e-04	0	"HG03540#1#JAGYVY010000208.1_95187_596142_0"	"AMY2B-208"	"2B"	"1-2-5-2-6-4-2-5-2-6-4-2-5-4-6-3-0"	"1.0-2.0-5.1-2.1-6.1-4.1-2.0-5.0-2.1-6.1-4.1-2.0-5.0-4.0-6.0-3.0-0.0"	95285	"HG03540#1#JAGYVY010000208.1_95187_596142_0"	115011	123435
"ENST00000370083.9"	1785	2	1784	"-"	"HG03540#2#JAGYVX010000148.1_1368955_1877115_0"	508160	331592	340383	1769	8791	0	"P"	557	1686	1686	1e-04	0	"HG03540#2#JAGYVX010000148.1_1368955_1877115_0"	"AMY1A-201"	"1"	"1-2-5-2-4-4-2-5-2-4-4-2-5-4-6-3-0"	"1.0-2.0-5.1-2.1-4.0-4.1-2.0-5.0-2.1-4.0-4.1-2.0-5.0-4.0-6.0-3.0-0.0"	1369053	"HG03540#2#JAGYVX010000148.1_1368955_1877115_0"	331592	340383
"ENST00000370083.9"	1785	2	1784	"+"	"HG03540#2#JAGYVX010000148.1_1368955_1877115_0"	508160	394069	402861	1769	8792	0	"S"	557	1686	NA	1e-04	0	"HG03540#2#JAGYVX010000148.1_1368955_1877115_0"	"AMY1A-201"	"1"	"1-2-5-2-4-4-2-5-2-4-4-2-5-4-6-3-0"	"1.0-2.0-5.1-2.1-4.0-4.1-2.0-5.0-2.1-4.0-4.1-2.0-5.0-4.0-6.0-3.0-0.0"	1369053	"HG03540#2#JAGYVX010000148.1_1368955_1877115_0"	394069	402861
"ENST00000370083.9"	1785	2	1784	"+"	"HG03540#2#JAGYVX010000148.1_1368955_1877115_0"	508160	200028	208819	1769	8791	0	"S"	557	1686	NA	1e-04	0	"HG03540#2#JAGYVX010000148.1_1368955_1877115_0"	"AMY1A-201"	"1"	"1-2-5-2-4-4-2-5-2-4-4-2-5-4-6-3-0"	"1.0-2.0-5.1-2.1-4.0-4.1-2.0-5.0-2.1-4.0-4.1-2.0-5.0-4.0-6.0-3.0-0.0"	1369053	"HG03540#2#JAGYVX010000148.1_1368955_1877115_0"	200028	208819
"ENST00000370083.9"	1785	2	1784	"+"	"HG03540#2#JAGYVX010000148.1_1368955_1877115_0"	508160	297032	305832	1767	8800	0	"S"	552	1684	NA	7e-04	0	"HG03540#2#JAGYVX010000148.1_1368955_1877115_0"	"AMY1A-201"	"1"	"1-2-5-2-4-4-2-5-2-4-4-2-5-4-6-3-0"	"1.0-2.0-5.1-2.1-4.0-4.1-2.0-5.0-2.1-4.0-4.1-2.0-5.0-4.0-6.0-3.0-0.0"	1369053	"HG03540#2#JAGYVX010000148.1_1368955_1877115_0"	297032	305832
"ENST00000370083.9"	1785	2	1784	"-"	"HG03540#2#JAGYVX010000148.1_1368955_1877115_0"	508160	234573	243352	1759	8779	0	"S"	546	1676	NA	0.0014	0	"HG03540#2#JAGYVX010000148.1_1368955_1877115_0"	"AMY1A-201"	"1"	"1-2-5-2-4-4-2-5-2-4-4-2-5-4-6-3-0"	"1.0-2.0-5.1-2.1-4.0-4.1-2.0-5.0-2.1-4.0-4.1-2.0-5.0-4.0-6.0-3.0-0.0"	1369053	"HG03540#2#JAGYVX010000148.1_1368955_1877115_0"	234573	243352
"ENST00000414303.7"	1584	4	1583	"+"	"HG03540#2#JAGYVX010000148.1_1368955_1877115_0"	508160	161767	170037	1563	8270	27	"P"	488	1488	1348	5e-04	0	"HG03540#2#JAGYVX010000148.1_1368955_1877115_0"	"AMY2A-201"	"2A"	"1-2-5-2-4-4-2-5-2-4-4-2-5-4-6-3-0"	"1.0-2.0-5.1-2.1-4.0-4.1-2.0-5.0-2.1-4.0-4.1-2.0-5.0-4.0-6.0-3.0-0.0"	1369053	"HG03540#2#JAGYVX010000148.1_1368955_1877115_0"	161767	170037
"ENST00000610648.1"	1736	4	1733	"+"	"HG03540#2#JAGYVX010000148.1_1368955_1877115_0"	508160	115090	123512	1718	8422	47	"P"	527	1636	1371	1e-04	0	"HG03540#2#JAGYVX010000148.1_1368955_1877115_0"	"AMY2B-208"	"2B"	"1-2-5-2-4-4-2-5-2-4-4-2-5-4-6-3-0"	"1.0-2.0-5.1-2.1-4.0-4.1-2.0-5.0-2.1-4.0-4.1-2.0-5.0-4.0-6.0-3.0-0.0"	1369053	"HG03540#2#JAGYVX010000148.1_1368955_1877115_0"	115090	123512
"ENST00000370083.9"	1785	2	1784	"-"	"HG03579#1#JAGYVU010000029.1_91404_499180_0"	407776	231299	240091	1769	8792	0	"P"	557	1686	1686	1e-04	0	"HG03579#1#JAGYVU010000029.1_91404_499180_0"	"AMY1A-201"	"1"	"1-2-5-2-4-6-2-5-4-6-3-0"	"1.0-2.0-5.1-2.1-4.0-6.0-2.0-5.0-4.0-6.0-3.0-0.0"	91502	"HG03579#1#JAGYVU010000029.1_91404_499180_0"	231299	240091
"ENST00000370083.9"	1785	2	1784	"+"	"HG03579#1#JAGYVU010000029.1_91404_499180_0"	407776	293777	302568	1769	8791	0	"S"	557	1686	NA	1e-04	0	"HG03579#1#JAGYVU010000029.1_91404_499180_0"	"AMY1A-201"	"1"	"1-2-5-2-4-6-2-5-4-6-3-0"	"1.0-2.0-5.1-2.1-4.0-6.0-2.0-5.0-4.0-6.0-3.0-0.0"	91502	"HG03579#1#JAGYVU010000029.1_91404_499180_0"	293777	302568
"ENST00000370083.9"	1785	2	1784	"+"	"HG03579#1#JAGYVU010000029.1_91404_499180_0"	407776	199645	208437	1769	8792	0	"S"	557	1686	NA	1e-04	0	"HG03579#1#JAGYVU010000029.1_91404_499180_0"	"AMY1A-201"	"1"	"1-2-5-2-4-6-2-5-4-6-3-0"	"1.0-2.0-5.1-2.1-4.0-6.0-2.0-5.0-4.0-6.0-3.0-0.0"	91502	"HG03579#1#JAGYVU010000029.1_91404_499180_0"	199645	208437
"ENST00000414303.7"	1584	4	1583	"+"	"HG03579#1#JAGYVU010000029.1_91404_499180_0"	407776	161386	169656	1563	8270	29	"P"	488	1488	1336	5e-04	0	"HG03579#1#JAGYVU010000029.1_91404_499180_0"	"AMY2A-201"	"2A"	"1-2-5-2-4-6-2-5-4-6-3-0"	"1.0-2.0-5.1-2.1-4.0-6.0-2.0-5.0-4.0-6.0-3.0-0.0"	91502	"HG03579#1#JAGYVU010000029.1_91404_499180_0"	161386	169656
"ENST00000610648.1"	1736	4	1733	"+"	"HG03579#1#JAGYVU010000029.1_91404_499180_0"	407776	115060	123482	1714	8422	47	"P"	525	1632	1371	9e-04	0	"HG03579#1#JAGYVU010000029.1_91404_499180_0"	"AMY2B-208"	"2B"	"1-2-5-2-4-6-2-5-4-6-3-0"	"1.0-2.0-5.1-2.1-4.0-6.0-2.0-5.0-4.0-6.0-3.0-0.0"	91502	"HG03579#1#JAGYVU010000029.1_91404_499180_0"	115060	123482
"ENST00000370083.9"	1785	2	1784	"+"	"HG03579#2#JAGYVT010000094.1_51581892_51895531_0"	313639	199590	208380	1753	8790	45	"P"	553	1670	1415	6e-04	0	"HG03579#2#JAGYVT010000094.1_51581892_51895531_0"	"AMY1A-201"	"1"	"1-2-5-4-6-3-0"	"1.0-2.0-5.0-4.0-6.0-3.0-0.0"	51581990	"HG03579#2#JAGYVT010000094.1_51581892_51895531_0"	199590	208380
"ENST00000414303.7"	1584	4	1583	"+"	"HG03579#2#JAGYVT010000094.1_51581892_51895531_0"	313639	161331	169601	1569	8270	29	"P"	486	1494	1342	1e-04	0	"HG03579#2#JAGYVT010000094.1_51581892_51895531_0"	"AMY2A-201"	"2A"	"1-2-5-4-6-3-0"	"1.0-2.0-5.0-4.0-6.0-3.0-0.0"	51581990	"HG03579#2#JAGYVT010000094.1_51581892_51895531_0"	161331	169601
"ENST00000610648.1"	1736	4	1733	"+"	"HG03579#2#JAGYVT010000094.1_51581892_51895531_0"	313639	115005	123426	1720	8421	50	"P"	531	1638	1360	1e-04	0	"HG03579#2#JAGYVT010000094.1_51581892_51895531_0"	"AMY2B-208"	"2B"	"1-2-5-4-6-3-0"	"1.0-2.0-5.0-4.0-6.0-3.0-0.0"	51581990	"HG03579#2#JAGYVT010000094.1_51581892_51895531_0"	115005	123426
"ENST00000370083.9"	1785	2	1784	"-"	"NA18906#1#JAHEOO010000054.1_2103477_2510435_1"	406958	231417	240208	1769	8791	0	"P"	557	1686	1686	1e-04	0	"NA18906#1#JAHEOO010000054.1_2103477_2510435_1"	"AMY1A-201"	"1"	"1-2-5-2-6-4-2-5-4-6-3-0"	"1.0-2.0-5.0-2.1-6.1-4.1-2.0-5.0-4.0-6.0-3.0-0.0"	2103631	"NA18906#1#JAHEOO010000054.1_2103477_2510435_1"	231417	240208
"ENST00000370083.9"	1785	2	1784	"+"	"NA18906#1#JAHEOO010000054.1_2103477_2510435_1"	406958	293881	302672	1769	8791	0	"S"	557	1686	NA	1e-04	0	"NA18906#1#JAHEOO010000054.1_2103477_2510435_1"	"AMY1A-201"	"1"	"1-2-5-2-6-4-2-5-4-6-3-0"	"1.0-2.0-5.0-2.1-6.1-4.1-2.0-5.0-4.0-6.0-3.0-0.0"	2103631	"NA18906#1#JAHEOO010000054.1_2103477_2510435_1"	293881	302672
"ENST00000370083.9"	1785	2	1784	"+"	"NA18906#1#JAHEOO010000054.1_2103477_2510435_1"	406958	199767	208557	1769	8790	0	"S"	557	1686	NA	1e-04	0	"NA18906#1#JAHEOO010000054.1_2103477_2510435_1"	"AMY1A-201"	"1"	"1-2-5-2-6-4-2-5-4-6-3-0"	"1.0-2.0-5.0-2.1-6.1-4.1-2.0-5.0-4.0-6.0-3.0-0.0"	2103631	"NA18906#1#JAHEOO010000054.1_2103477_2510435_1"	199767	208557
"ENST00000414303.7"	1584	4	1583	"+"	"NA18906#1#JAHEOO010000054.1_2103477_2510435_1"	406958	161455	169760	1568	8305	29	"P"	486	1493	1342	8e-04	0	"NA18906#1#JAHEOO010000054.1_2103477_2510435_1"	"AMY2A-201"	"2A"	"1-2-5-2-6-4-2-5-4-6-3-0"	"1.0-2.0-5.0-2.1-6.1-4.1-2.0-5.0-4.0-6.0-3.0-0.0"	2103631	"NA18906#1#JAHEOO010000054.1_2103477_2510435_1"	161455	169760
"ENST00000610648.1"	1736	4	1733	"+"	"NA18906#1#JAHEOO010000054.1_2103477_2510435_1"	406958	115097	123519	1720	8422	48	"P"	531	1638	1371	1e-04	0	"NA18906#1#JAHEOO010000054.1_2103477_2510435_1"	"AMY2B-208"	"2B"	"1-2-5-2-6-4-2-5-4-6-3-0"	"1.0-2.0-5.0-2.1-6.1-4.1-2.0-5.0-4.0-6.0-3.0-0.0"	2103631	"NA18906#1#JAHEOO010000054.1_2103477_2510435_1"	115097	123519
"ENST00000370083.9"	1785	2	1784	"-"	"NA18906#2#JAHEON010000009.1_93748295_94249275_0"	500980	325356	334149	1769	8793	0	"P"	557	1686	1686	1e-04	0	"NA18906#2#JAHEON010000009.1_93748295_94249275_0"	"AMY1A-201"	"1"	"1-2-5-2-6-4-2-5-2-6-4-2-5-4-6-3-0"	"1.0-2.0-5.1-2.1-6.1-4.1-2.0-5.0-2.1-6.1-4.1-2.0-5.0-4.0-6.0-3.0-0.0"	93748393	"NA18906#2#JAHEON010000009.1_93748295_94249275_0"	325356	334149
"ENST00000370083.9"	1785	2	1784	"+"	"NA18906#2#JAHEON010000009.1_93748295_94249275_0"	500980	199586	208378	1769	8792	0	"S"	557	1686	NA	1e-04	0	"NA18906#2#JAHEON010000009.1_93748295_94249275_0"	"AMY1A-201"	"1"	"1-2-5-2-6-4-2-5-2-6-4-2-5-4-6-3-0"	"1.0-2.0-5.1-2.1-6.1-4.1-2.0-5.0-2.1-6.1-4.1-2.0-5.0-4.0-6.0-3.0-0.0"	93748393	"NA18906#2#JAHEON010000009.1_93748295_94249275_0"	199586	208378
"ENST00000370083.9"	1785	2	1784	"+"	"NA18906#2#JAHEON010000009.1_93748295_94249275_0"	500980	293700	302492	1769	8792	0	"S"	557	1686	NA	1e-04	0	"NA18906#2#JAHEON010000009.1_93748295_94249275_0"	"AMY1A-201"	"1"	"1-2-5-2-6-4-2-5-2-6-4-2-5-4-6-3-0"	"1.0-2.0-5.1-2.1-6.1-4.1-2.0-5.0-2.1-6.1-4.1-2.0-5.0-4.0-6.0-3.0-0.0"	93748393	"NA18906#2#JAHEON010000009.1_93748295_94249275_0"	293700	302492
"ENST00000370083.9"	1785	2	1784	"+"	"NA18906#2#JAHEON010000009.1_93748295_94249275_0"	500980	387830	396622	1769	8792	0	"S"	557	1686	NA	1e-04	0	"NA18906#2#JAHEON010000009.1_93748295_94249275_0"	"AMY1A-201"	"1"	"1-2-5-2-6-4-2-5-2-6-4-2-5-4-6-3-0"	"1.0-2.0-5.1-2.1-6.1-4.1-2.0-5.0-2.1-6.1-4.1-2.0-5.0-4.0-6.0-3.0-0.0"	93748393	"NA18906#2#JAHEON010000009.1_93748295_94249275_0"	387830	396622
"ENST00000370083.9"	1785	2	1784	"-"	"NA18906#2#JAHEON010000009.1_93748295_94249275_0"	500980	231242	240034	1769	8792	0	"S"	557	1686	NA	1e-04	0	"NA18906#2#JAHEON010000009.1_93748295_94249275_0"	"AMY1A-201"	"1"	"1-2-5-2-6-4-2-5-2-6-4-2-5-4-6-3-0"	"1.0-2.0-5.1-2.1-6.1-4.1-2.0-5.0-2.1-6.1-4.1-2.0-5.0-4.0-6.0-3.0-0.0"	93748393	"NA18906#2#JAHEON010000009.1_93748295_94249275_0"	231242	240034
"ENST00000414303.7"	1584	4	1583	"+"	"NA18906#2#JAHEON010000009.1_93748295_94249275_0"	500980	161333	169596	1569	8263	29	"P"	486	1494	1342	8e-04	0	"NA18906#2#JAHEON010000009.1_93748295_94249275_0"	"AMY2A-201"	"2A"	"1-2-5-2-6-4-2-5-2-6-4-2-5-4-6-3-0"	"1.0-2.0-5.1-2.1-6.1-4.1-2.0-5.0-2.1-6.1-4.1-2.0-5.0-4.0-6.0-3.0-0.0"	93748393	"NA18906#2#JAHEON010000009.1_93748295_94249275_0"	161333	169596
"ENST00000610648.1"	1736	4	1733	"+"	"NA18906#2#JAHEON010000009.1_93748295_94249275_0"	500980	115014	123434	1720	8420	48	"P"	531	1638	1371	1e-04	0	"NA18906#2#JAHEON010000009.1_93748295_94249275_0"	"AMY2B-208"	"2B"	"1-2-5-2-6-4-2-5-2-6-4-2-5-4-6-3-0"	"1.0-2.0-5.1-2.1-6.1-4.1-2.0-5.0-2.1-6.1-4.1-2.0-5.0-4.0-6.0-3.0-0.0"	93748393	"NA18906#2#JAHEON010000009.1_93748295_94249275_0"	115014	123434
"ENST00000370083.9"	1785	2	1784	"+"	"NA19240#1#JAHEOM010000047.1_30103390_30511199_1"	407809	199725	208517	1769	8792	0	"P"	557	1686	1686	1e-04	0	"NA19240#1#JAHEOM010000047.1_30103390_30511199_1"	"AMY1A-201"	"1"	"1-2-5-2-6-4-2-5-4-6-3-0"	"1.0-2.0-5.1-2.1-6.1-4.1-2.0-5.0-4.0-6.0-3.0-0.0"	30103544	"NA19240#1#JAHEOM010000047.1_30103390_30511199_1"	199725	208517
"ENST00000370083.9"	1785	2	1784	"+"	"NA19240#1#JAHEOM010000047.1_30103390_30511199_1"	407809	293861	302652	1769	8791	0	"S"	557	1686	NA	1e-04	0	"NA19240#1#JAHEOM010000047.1_30103390_30511199_1"	"AMY1A-201"	"1"	"1-2-5-2-6-4-2-5-4-6-3-0"	"1.0-2.0-5.1-2.1-6.1-4.1-2.0-5.0-4.0-6.0-3.0-0.0"	30103544	"NA19240#1#JAHEOM010000047.1_30103390_30511199_1"	293861	302652
"ENST00000370083.9"	1785	2	1784	"-"	"NA19240#1#JAHEOM010000047.1_30103390_30511199_1"	407809	231382	240174	1769	8792	0	"S"	557	1686	NA	1e-04	0	"NA19240#1#JAHEOM010000047.1_30103390_30511199_1"	"AMY1A-201"	"1"	"1-2-5-2-6-4-2-5-4-6-3-0"	"1.0-2.0-5.1-2.1-6.1-4.1-2.0-5.0-4.0-6.0-3.0-0.0"	30103544	"NA19240#1#JAHEOM010000047.1_30103390_30511199_1"	231382	240174
"ENST00000414303.7"	1584	4	1583	"+"	"NA19240#1#JAHEOM010000047.1_30103390_30511199_1"	407809	161463	169734	1574	8271	30	"P"	491	1499	1342	1e-04	0	"NA19240#1#JAHEOM010000047.1_30103390_30511199_1"	"AMY2A-201"	"2A"	"1-2-5-2-6-4-2-5-4-6-3-0"	"1.0-2.0-5.1-2.1-6.1-4.1-2.0-5.0-4.0-6.0-3.0-0.0"	30103544	"NA19240#1#JAHEOM010000047.1_30103390_30511199_1"	161463	169734
"ENST00000610648.1"	1736	4	1733	"+"	"NA19240#1#JAHEOM010000047.1_30103390_30511199_1"	407809	115135	123559	1720	8424	48	"P"	531	1638	1371	1e-04	0	"NA19240#1#JAHEOM010000047.1_30103390_30511199_1"	"AMY2B-208"	"2B"	"1-2-5-2-6-4-2-5-4-6-3-0"	"1.0-2.0-5.1-2.1-6.1-4.1-2.0-5.0-4.0-6.0-3.0-0.0"	30103544	"NA19240#1#JAHEOM010000047.1_30103390_30511199_1"	115135	123559
"ENST00000370083.9"	1785	2	1784	"+"	"NA19240#2#JAHEOL010000010.1_37445323_37853017_0"	407694	293642	302433	1769	8791	0	"P"	557	1686	1686	1e-04	0	"NA19240#2#JAHEOL010000010.1_37445323_37853017_0"	"AMY1A-201"	"1"	"1-2-5-2-4-6-2-5-4-6-3-0"	"1.0-2.0-5.1-2.1-4.0-6.0-2.0-5.0-4.0-6.0-3.0-0.0"	37445421	"NA19240#2#JAHEOL010000010.1_37445323_37853017_0"	293642	302433
"ENST00000370083.9"	1785	2	1784	"+"	"NA19240#2#JAHEOL010000010.1_37445323_37853017_0"	407694	199559	208350	1769	8791	0	"S"	557	1686	NA	1e-04	0	"NA19240#2#JAHEOL010000010.1_37445323_37853017_0"	"AMY1A-201"	"1"	"1-2-5-2-4-6-2-5-4-6-3-0"	"1.0-2.0-5.1-2.1-4.0-6.0-2.0-5.0-4.0-6.0-3.0-0.0"	37445421	"NA19240#2#JAHEOL010000010.1_37445323_37853017_0"	199559	208350
"ENST00000370083.9"	1785	2	1784	"-"	"NA19240#2#JAHEOL010000010.1_37445323_37853017_0"	407694	231208	239999	1769	8791	0	"S"	557	1686	NA	1e-04	0	"NA19240#2#JAHEOL010000010.1_37445323_37853017_0"	"AMY1A-201"	"1"	"1-2-5-2-4-6-2-5-4-6-3-0"	"1.0-2.0-5.1-2.1-4.0-6.0-2.0-5.0-4.0-6.0-3.0-0.0"	37445421	"NA19240#2#JAHEOL010000010.1_37445323_37853017_0"	231208	239999
"ENST00000414303.7"	1584	4	1579	"+"	"NA19240#2#JAHEOL010000010.1_37445323_37853017_0"	407694	161309	169575	1552	8266	26	"P"	481	1477	1342	0.0014	0	"NA19240#2#JAHEOL010000010.1_37445323_37853017_0"	"AMY2A-201"	"2A"	"1-2-5-2-4-6-2-5-4-6-3-0"	"1.0-2.0-5.1-2.1-4.0-6.0-2.0-5.0-4.0-6.0-3.0-0.0"	37445421	"NA19240#2#JAHEOL010000010.1_37445323_37853017_0"	161309	169575
"ENST00000610648.1"	1736	4	1733	"+"	"NA19240#2#JAHEOL010000010.1_37445323_37853017_0"	407694	114993	123415	1720	8422	48	"P"	531	1638	1371	1e-04	0	"NA19240#2#JAHEOL010000010.1_37445323_37853017_0"	"AMY2B-208"	"2B"	"1-2-5-2-4-6-2-5-4-6-3-0"	"1.0-2.0-5.1-2.1-4.0-6.0-2.0-5.0-4.0-6.0-3.0-0.0"	37445421	"NA19240#2#JAHEOL010000010.1_37445323_37853017_0"	114993	123415
"ENST00000370083.9"	1785	2	1784	"-"	"NA20129#2#JAHEPD010000155.1_90039_569275_0"	479236	231221	240012	1769	8791	0	"P"	557	1686	1686	1e-04	0	"NA20129#2#JAHEPD010000155.1_90039_569275_0"	"AMY1A-201"	"1"	"1-2-5-2-6-4-5-2-4-6-2-5-4-6-3-0"	"1.0-2.0-5.0-2.1-6.1-4.1-5.1-2.1-4.0-6.0-2.0-5.0-4.0-6.0-3.0-0.0"	90137	"NA20129#2#JAHEPD010000155.1_90039_569275_0"	231221	240012
"ENST00000370083.9"	1785	2	1784	"+"	"NA20129#2#JAHEPD010000155.1_90039_569275_0"	479236	366081	374872	1769	8791	0	"S"	557	1686	NA	1e-04	0	"NA20129#2#JAHEPD010000155.1_90039_569275_0"	"AMY1A-201"	"1"	"1-2-5-2-6-4-5-2-4-6-2-5-4-6-3-0"	"1.0-2.0-5.0-2.1-6.1-4.1-5.1-2.1-4.0-6.0-2.0-5.0-4.0-6.0-3.0-0.0"	90137	"NA20129#2#JAHEPD010000155.1_90039_569275_0"	366081	374872
"ENST00000370083.9"	1785	2	1784	"+"	"NA20129#2#JAHEPD010000155.1_90039_569275_0"	479236	199566	208358	1769	8792	0	"S"	557	1686	NA	1e-04	0	"NA20129#2#JAHEPD010000155.1_90039_569275_0"	"AMY1A-201"	"1"	"1-2-5-2-6-4-5-2-4-6-2-5-4-6-3-0"	"1.0-2.0-5.0-2.1-6.1-4.1-5.1-2.1-4.0-6.0-2.0-5.0-4.0-6.0-3.0-0.0"	90137	"NA20129#2#JAHEPD010000155.1_90039_569275_0"	199566	208358
"ENST00000370083.9"	1785	2	1784	"-"	"NA20129#2#JAHEPD010000155.1_90039_569275_0"	479236	303638	312430	1769	8792	0	"S"	557	1686	NA	1e-04	0	"NA20129#2#JAHEPD010000155.1_90039_569275_0"	"AMY1A-201"	"1"	"1-2-5-2-6-4-5-2-4-6-2-5-4-6-3-0"	"1.0-2.0-5.0-2.1-6.1-4.1-5.1-2.1-4.0-6.0-2.0-5.0-4.0-6.0-3.0-0.0"	90137	"NA20129#2#JAHEPD010000155.1_90039_569275_0"	303638	312430
"ENST00000414303.7"	1584	4	1583	"-"	"NA20129#2#JAHEPD010000155.1_90039_569275_0"	479236	269995	278265	1571	8270	0	"P"	486	1496	1494	8e-04	0	"NA20129#2#JAHEPD010000155.1_90039_569275_0"	"AMY2A-201"	"2A"	"1-2-5-2-6-4-5-2-4-6-2-5-4-6-3-0"	"1.0-2.0-5.0-2.1-6.1-4.1-5.1-2.1-4.0-6.0-2.0-5.0-4.0-6.0-3.0-0.0"	90137	"NA20129#2#JAHEPD010000155.1_90039_569275_0"	269995	278265
"ENST00000414303.7"	1584	4	1583	"+"	"NA20129#2#JAHEPD010000155.1_90039_569275_0"	479236	161308	169578	1569	8270	0	"S"	486	1494	NA	8e-04	0	"NA20129#2#JAHEPD010000155.1_90039_569275_0"	"AMY2A-201"	"2A"	"1-2-5-2-6-4-5-2-4-6-2-5-4-6-3-0"	"1.0-2.0-5.0-2.1-6.1-4.1-5.1-2.1-4.0-6.0-2.0-5.0-4.0-6.0-3.0-0.0"	90137	"NA20129#2#JAHEPD010000155.1_90039_569275_0"	161308	169578
"ENST00000610648.1"	1736	4	1733	"+"	"NA20129#2#JAHEPD010000155.1_90039_569275_0"	479236	114981	123392	1717	8411	40	"P"	524	1635	1411	9e-04	0	"NA20129#2#JAHEPD010000155.1_90039_569275_0"	"AMY2B-208"	"2B"	"1-2-5-2-6-4-5-2-4-6-2-5-4-6-3-0"	"1.0-2.0-5.0-2.1-6.1-4.1-5.1-2.1-4.0-6.0-2.0-5.0-4.0-6.0-3.0-0.0"	90137	"NA20129#2#JAHEPD010000155.1_90039_569275_0"	114981	123392
"ENST00000370083.9"	1785	2	1784	"+"	"chr1_chm13_103304997_103901127_0"	596130	387907	396697	1769	8790	0	"P"	557	1686	1686	1e-04	0	"chr1_chm13_103304997_103901127_0"	"AMY1A-201"	"1"	"1-2-5-2-6-4-2-5-2-6-4-2-5-2-4-2-5-4-3-0"	"1.0-2.0-5.0-2.1-6.1-4.1-2.0-5.0-2.1-6.1-4.1-2.0-5.1-2.1-4.1-2.0-5.0-4.0-3.0-0.0"	103305096	"chr1_chm13_103304997_103901127_0"	387907	396697
"ENST00000370083.9"	1785	2	1784	"+"	"chr1_chm13_103304997_103901127_0"	596130	482041	490833	1769	8792	0	"S"	557	1686	NA	1e-04	0	"chr1_chm13_103304997_103901127_0"	"AMY1A-201"	"1"	"1-2-5-2-6-4-2-5-2-6-4-2-5-2-4-2-5-4-3-0"	"1.0-2.0-5.0-2.1-6.1-4.1-2.0-5.0-2.1-6.1-4.1-2.0-5.1-2.1-4.1-2.0-5.0-4.0-3.0-0.0"	103305096	"chr1_chm13_103304997_103901127_0"	482041	490833
"ENST00000370083.9"	1785	2	1784	"-"	"chr1_chm13_103304997_103901127_0"	596130	231284	240077	1769	8793	0	"S"	557	1686	NA	1e-04	0	"chr1_chm13_103304997_103901127_0"	"AMY1A-201"	"1"	"1-2-5-2-6-4-2-5-2-6-4-2-5-2-4-2-5-4-3-0"	"1.0-2.0-5.0-2.1-6.1-4.1-2.0-5.0-2.1-6.1-4.1-2.0-5.1-2.1-4.1-2.0-5.0-4.0-3.0-0.0"	103305096	"chr1_chm13_103304997_103901127_0"	231284	240077
"ENST00000370083.9"	1785	2	1784	"-"	"chr1_chm13_103304997_103901127_0"	596130	419562	428353	1769	8791	0	"S"	557	1686	NA	1e-04	0	"chr1_chm13_103304997_103901127_0"	"AMY1A-201"	"1"	"1-2-5-2-6-4-2-5-2-6-4-2-5-2-4-2-5-4-3-0"	"1.0-2.0-5.0-2.1-6.1-4.1-2.0-5.0-2.1-6.1-4.1-2.0-5.1-2.1-4.1-2.0-5.0-4.0-3.0-0.0"	103305096	"chr1_chm13_103304997_103901127_0"	419562	428353
"ENST00000370083.9"	1785	2	1784	"+"	"chr1_chm13_103304997_103901127_0"	596130	293773	302564	1769	8791	0	"S"	557	1686	NA	1e-04	0	"chr1_chm13_103304997_103901127_0"	"AMY1A-201"	"1"	"1-2-5-2-6-4-2-5-2-6-4-2-5-2-4-2-5-4-3-0"	"1.0-2.0-5.0-2.1-6.1-4.1-2.0-5.0-2.1-6.1-4.1-2.0-5.1-2.1-4.1-2.0-5.0-4.0-3.0-0.0"	103305096	"chr1_chm13_103304997_103901127_0"	293773	302564
"ENST00000370083.9"	1785	2	1784	"+"	"chr1_chm13_103304997_103901127_0"	596130	199630	208423	1769	8793	0	"S"	557	1686	NA	1e-04	0	"chr1_chm13_103304997_103901127_0"	"AMY1A-201"	"1"	"1-2-5-2-6-4-2-5-2-6-4-2-5-2-4-2-5-4-3-0"	"1.0-2.0-5.0-2.1-6.1-4.1-2.0-5.0-2.1-6.1-4.1-2.0-5.1-2.1-4.1-2.0-5.0-4.0-3.0-0.0"	103305096	"chr1_chm13_103304997_103901127_0"	199630	208423
"ENST00000370083.9"	1785	2	1784	"-"	"chr1_chm13_103304997_103901127_0"	596130	325430	334221	1769	8791	0	"S"	557	1686	NA	1e-04	0	"chr1_chm13_103304997_103901127_0"	"AMY1A-201"	"1"	"1-2-5-2-6-4-2-5-2-6-4-2-5-2-4-2-5-4-3-0"	"1.0-2.0-5.0-2.1-6.1-4.1-2.0-5.0-2.1-6.1-4.1-2.0-5.1-2.1-4.1-2.0-5.0-4.0-3.0-0.0"	103305096	"chr1_chm13_103304997_103901127_0"	325430	334221
"ENST00000414303.7"	1584	4	1583	"+"	"chr1_chm13_103304997_103901127_0"	596130	161379	169649	1574	8270	15	"P"	491	1499	1420	1e-04	0	"chr1_chm13_103304997_103901127_0"	"AMY2A-201"	"2A"	"1-2-5-2-6-4-2-5-2-6-4-2-5-2-4-2-5-4-3-0"	"1.0-2.0-5.0-2.1-6.1-4.1-2.0-5.0-2.1-6.1-4.1-2.0-5.1-2.1-4.1-2.0-5.0-4.0-3.0-0.0"	103305096	"chr1_chm13_103304997_103901127_0"	161379	169649
"ENST00000610648.1"	1736	4	1733	"+"	"chr1_chm13_103304997_103901127_0"	596130	115049	123473	1720	8424	44	"P"	531	1638	1394	1e-04	0	"chr1_chm13_103304997_103901127_0"	"AMY2B-208"	"2B"	"1-2-5-2-6-4-2-5-2-6-4-2-5-2-4-2-5-4-3-0"	"1.0-2.0-5.0-2.1-6.1-4.1-2.0-5.0-2.1-6.1-4.1-2.0-5.1-2.1-4.1-2.0-5.0-4.0-3.0-0.0"	103305096	"chr1_chm13_103304997_103901127_0"	115049	123473
"ENST00000370083.9"	1785	2	1784	"+"	"chr1_hg19_103998686_104406594_0"	407908	199697	208489	1769	8792	0	"P"	557	1686	1686	1e-04	0	"chr1_hg19_103998686_104406594_0"	"AMY1A-201"	"1"	"1-2-5-2-6-4-2-5-4-3-0"	"1.0-2.0-5.0-2.1-6.1-4.1-2.0-5.0-4.0-3.0-0.0"	103998785	"chr1_hg19_103998686_104406594_0"	199697	208489
"ENST00000370083.9"	1785	2	1784	"-"	"chr1_hg19_103998686_104406594_0"	407908	231351	240144	1769	8793	0	"S"	557	1686	NA	1e-04	0	"chr1_hg19_103998686_104406594_0"	"AMY1A-201"	"1"	"1-2-5-2-6-4-2-5-4-3-0"	"1.0-2.0-5.0-2.1-6.1-4.1-2.0-5.0-4.0-3.0-0.0"	103998785	"chr1_hg19_103998686_104406594_0"	231351	240144
"ENST00000370083.9"	1785	2	1784	"+"	"chr1_hg19_103998686_104406594_0"	407908	293835	302627	1769	8792	0	"S"	557	1686	NA	1e-04	0	"chr1_hg19_103998686_104406594_0"	"AMY1A-201"	"1"	"1-2-5-2-6-4-2-5-4-3-0"	"1.0-2.0-5.0-2.1-6.1-4.1-2.0-5.0-4.0-3.0-0.0"	103998785	"chr1_hg19_103998686_104406594_0"	293835	302627
"ENST00000414303.7"	1584	4	1583	"+"	"chr1_hg19_103998686_104406594_0"	407908	161366	169715	1574	8349	30	"P"	491	1499	1342	1e-04	0	"chr1_hg19_103998686_104406594_0"	"AMY2A-201"	"2A"	"1-2-5-2-6-4-2-5-4-3-0"	"1.0-2.0-5.0-2.1-6.1-4.1-2.0-5.0-4.0-3.0-0.0"	103998785	"chr1_hg19_103998686_104406594_0"	161366	169715
"ENST00000610648.1"	1736	4	1733	"+"	"chr1_hg19_103998686_104406594_0"	407908	115039	123463	1720	8424	48	"P"	531	1638	1371	1e-04	0	"chr1_hg19_103998686_104406594_0"	"AMY2B-208"	"2B"	"1-2-5-2-6-4-2-5-4-3-0"	"1.0-2.0-5.0-2.1-6.1-4.1-2.0-5.0-4.0-3.0-0.0"	103998785	"chr1_hg19_103998686_104406594_0"	115039	123463
"ENST00000370083.9"	1785	2	1784	"+"	"chr1_hg38_103456064_103863972_0"	407908	199697	208489	1769	8792	0	"P"	557	1686	1686	1e-04	0	"chr1_hg38_103456064_103863972_0"	"AMY1A-201"	"1"	"1-2-5-2-6-4-2-5-4-3-0"	"1.0-2.0-5.0-2.1-6.1-4.1-2.0-5.0-4.0-3.0-0.0"	103456163	"chr1_hg38_103456064_103863972_0"	199697	208489
"ENST00000370083.9"	1785	2	1784	"-"	"chr1_hg38_103456064_103863972_0"	407908	231351	240144	1769	8793	0	"S"	557	1686	NA	1e-04	0	"chr1_hg38_103456064_103863972_0"	"AMY1A-201"	"1"	"1-2-5-2-6-4-2-5-4-3-0"	"1.0-2.0-5.0-2.1-6.1-4.1-2.0-5.0-4.0-3.0-0.0"	103456163	"chr1_hg38_103456064_103863972_0"	231351	240144
"ENST00000370083.9"	1785	2	1784	"+"	"chr1_hg38_103456064_103863972_0"	407908	293835	302627	1769	8792	0	"S"	557	1686	NA	1e-04	0	"chr1_hg38_103456064_103863972_0"	"AMY1A-201"	"1"	"1-2-5-2-6-4-2-5-4-3-0"	"1.0-2.0-5.0-2.1-6.1-4.1-2.0-5.0-4.0-3.0-0.0"	103456163	"chr1_hg38_103456064_103863972_0"	293835	302627
"ENST00000414303.7"	1584	4	1583	"+"	"chr1_hg38_103456064_103863972_0"	407908	161366	169715	1574	8349	30	"P"	491	1499	1342	1e-04	0	"chr1_hg38_103456064_103863972_0"	"AMY2A-201"	"2A"	"1-2-5-2-6-4-2-5-4-3-0"	"1.0-2.0-5.0-2.1-6.1-4.1-2.0-5.0-4.0-3.0-0.0"	103456163	"chr1_hg38_103456064_103863972_0"	161366	169715
"ENST00000610648.1"	1736	4	1733	"+"	"chr1_hg38_103456064_103863972_0"	407908	115039	123463	1720	8424	48	"P"	531	1638	1371	1e-04	0	"chr1_hg38_103456064_103863972_0"	"AMY2B-208"	"2B"	"1-2-5-2-6-4-2-5-4-3-0"	"1.0-2.0-5.0-2.1-6.1-4.1-2.0-5.0-4.0-3.0-0.0"	103456163	"chr1_hg38_103456064_103863972_0"	115039	123463
"AMYP1-201"	1023	4	1022	"-"	"HG01243#1#JAHEOY010000013.1_90081_424495_0"	334414	197680	203824	998	6144	34	"P"	303	948	829	0.0013	0	"HG01243#1#JAHEOY010000013.1_90081_424495_0"	"AMYP1-201"	"2Ap"	"1-2-5-2-4-3-0"	"1.0-2.0-5.1-2.1-4.0-3.0-0.0"	90179	"HG01243#1#JAHEOY010000013.1_90081_424495_0"	197680	203824
"AMYP1-201"	1023	4	1022	"-"	"HG01358#2#JAGYZA010000086.1_556_316498_0"	315942	84931	91075	1010	6144	2	"P"	305	960	951	0.0015	0	"HG01358#2#JAGYZA010000086.1_556_316498_0"	"AMYP1-201"	"2Ap"	"1-2-5-2-6-4-2-5-2-6-4-2"	"1.0-2.0-5.0-2.1-6.1-4.1-2.0-5.1-2.1-6.1-4.1-2.0"	681	"HG01358#2#JAGYZA010000086.1_556_316498_0"	84931	91075
"AMYP1-201"	1023	4	1022	"+"	"HG01358#2#JAGYZA010000086.1_556_316498_0"	315942	166560	172704	1001	6144	0	"S"	303	951	NA	0.0019	0	"HG01358#2#JAGYZA010000086.1_556_316498_0"	"AMYP1-201"	"2Ap"	"1-2-5-2-6-4-2-5-2-6-4-2"	"1.0-2.0-5.0-2.1-6.1-4.1-2.0-5.1-2.1-6.1-4.1-2.0"	681	"HG01358#2#JAGYZA010000086.1_556_316498_0"	166560	172704
"AMYP1-201"	1023	4	1022	"-"	"HG03492#2#JAHEPH010000288.1_2098270_2432686_1"	334416	197734	203878	998	6144	34	"P"	303	948	829	0.0013	0	"HG03492#2#JAHEPH010000288.1_2098270_2432686_1"	"AMYP1-201"	"2Ap"	"1-2-5-2-4-3-0"	"1.0-2.0-5.1-2.1-4.0-3.0-0.0"	2098424	"HG03492#2#JAHEPH010000288.1_2098270_2432686_1"	197734	203878
"AMYP1-201"	1023	4	1022	"-"	"chr1_chm13_103304997_103901127_0"	596130	270113	276257	1010	6144	0	"S"	305	960	NA	0.0015	0	"chr1_chm13_103304997_103901127_0"	"AMYP1-201"	"2Ap"	"1-2-5-2-6-4-2-5-2-6-4-2-5-2-4-2-5-4-3-0"	"1.0-2.0-5.0-2.1-6.1-4.1-2.0-5.0-2.1-6.1-4.1-2.0-5.1-2.1-4.1-2.0-5.0-4.0-3.0-0.0"	103305096	"chr1_chm13_103304997_103901127_0"	270113	276257
"AMYP1-201"	1023	4	1022	"+"	"chr1_chm13_103304997_103901127_0"	596130	351739	357883	1013	6144	0	"S"	311	963	NA	2e-04	0	"chr1_chm13_103304997_103901127_0"	"AMYP1-201"	"2Ap"	"1-2-5-2-6-4-2-5-2-6-4-2-5-2-4-2-5-4-3-0"	"1.0-2.0-5.0-2.1-6.1-4.1-2.0-5.0-2.1-6.1-4.1-2.0-5.1-2.1-4.1-2.0-5.0-4.0-3.0-0.0"	103305096	"chr1_chm13_103304997_103901127_0"	351739	357883
"AMYP1-201"	1023	4	1022	"+"	"chr1_chm13_103304997_103901127_0"	596130	445869	452013	1013	6144	0	"P"	311	963	963	2e-04	0	"chr1_chm13_103304997_103901127_0"	"AMYP1-201"	"2Ap"	"1-2-5-2-6-4-2-5-2-6-4-2-5-2-4-2-5-4-3-0"	"1.0-2.0-5.0-2.1-6.1-4.1-2.0-5.0-2.1-6.1-4.1-2.0-5.1-2.1-4.1-2.0-5.0-4.0-3.0-0.0"	103305096	"chr1_chm13_103304997_103901127_0"	445869	452013
"AMYP1-201"	1023	4	1022	"+"	"chr1_hg19_103998686_104406594_0"	407908	257662	263806	1010	6144	0	"P"	305	960	959	0.0015	0	"chr1_hg19_103998686_104406594_0"	"AMYP1-201"	"2Ap"	"1-2-5-2-6-4-2-5-4-3-0"	"1.0-2.0-5.0-2.1-6.1-4.1-2.0-5.0-4.0-3.0-0.0"	103998785	"chr1_hg19_103998686_104406594_0"	257662	263806
"AMYP1-201"	1023	4	1022	"+"	"chr1_hg38_103456064_103863972_0"	407908	257662	263806	1010	6144	0	"P"	305	960	959	0.0015	0	"chr1_hg38_103456064_103863972_0"	"AMYP1-201"	"2Ap"	"1-2-5-2-6-4-2-5-4-3-0"	"1.0-2.0-5.0-2.1-6.1-4.1-2.0-5.0-4.0-3.0-0.0"	103456163	"chr1_hg38_103456064_103863972_0"	257662	263806
"AMYP1-201"	1023	4	1022	"-"	"HG002#1#JAHKSE010000012.1_16776806_17183707_1"	406901	270189	276333	998	6144	0	"S"	303	948	NA	0.0013	0	"HG002#1#JAHKSE010000012.1_16776806_17183707_1"	"AMYP1-201"	"2Ap"	"1-2-5-2-4-2-5-4-3-0"	"1.0-2.0-5.1-2.1-4.1-2.0-5.0-4.0-3.0-0.0"	16776960	"HG002#1#JAHKSE010000012.1_16776806_17183707_1"	270189	276333
"AMYP1-201"	1023	4	1022	"+"	"HG002#2#JAHKSD010000021.1_102757493_103165350_0"	407857	257597	263741	1010	6144	0	"P"	305	960	959	0.0017	0	"HG002#2#JAHKSD010000021.1_102757493_103165350_0"	"AMYP1-201"	"2Ap"	"1-2-5-2-6-4-2-5-4-3-0"	"1.0-2.0-5.0-2.1-6.1-4.1-2.0-5.0-4.0-3.0-0.0"	102757591	"HG002#2#JAHKSD010000021.1_102757493_103165350_0"	257597	263741
"AMYP1-201"	1023	4	1022	"-"	"HG00438#1#JAHBCB010000015.1_33474867_33954171_0"	479304	342504	348648	998	6144	0	"S"	303	948	NA	0.0013	0	"HG00438#1#JAHBCB010000015.1_33474867_33954171_0"	"AMYP1-201"	"2Ap"	"1-2-5-2-4-5-2-4-2-5-4-3-0"	"1.0-2.0-5.1-2.1-4.1-5.1-2.1-4.1-2.0-5.0-4.0-3.0-0.0"	33474965	"HG00438#1#JAHBCB010000015.1_33474867_33954171_0"	342504	348648
"AMYP1-201"	1023	4	1022	"-"	"HG005#1#JAHEPO010000002.1_51519219_51926067_0"	406848	270086	276230	996	6144	0	"S"	299	946	NA	0.0022	0	"HG005#1#JAHEPO010000002.1_51519219_51926067_0"	"AMYP1-201"	"2Ap"	"1-2-5-2-4-2-5-4-3-0"	"1.0-2.0-5.1-2.1-4.0-2.0-5.0-4.0-3.0-0.0"	51519317	"HG005#1#JAHEPO010000002.1_51519219_51926067_0"	270086	276230
"AMYP1-201"	1023	4	1022	"+"	"HG005#2#JAHEPN010000023.1_51542210_51950070_0"	407860	257586	263730	1010	6144	0	"P"	305	960	959	0.0015	0	"HG005#2#JAHEPN010000023.1_51542210_51950070_0"	"AMYP1-201"	"2Ap"	"1-2-5-2-6-4-2-5-4-3-0"	"1.0-2.0-5.0-2.1-6.1-4.1-2.0-5.0-4.0-3.0-0.0"	51542309	"HG005#2#JAHEPN010000023.1_51542210_51950070_0"	257586	263730
"AMYP1-201"	1023	4	1022	"-"	"HG00621#1#JAHBCD010000034.1_2122997_2624098_1"	501101	270168	276312	1010	6144	0	"P"	305	960	960	0.0015	0	"HG00621#1#JAHBCD010000034.1_2122997_2624098_1"	"AMYP1-201"	"2Ap"	"1-2-5-2-6-4-2-5-2-6-4-2-5-4-3-0"	"1.0-2.0-5.1-2.1-6.1-4.1-2.0-5.1-2.1-6.1-4.1-2.0-5.0-4.0-3.0-0.0"	2123152	"HG00621#1#JAHBCD010000034.1_2122997_2624098_1"	270168	276312
"AMYP1-201"	1023	4	1022	"-"	"HG00621#1#JAHBCD010000034.1_2122997_2624098_1"	501101	364322	370466	1010	6144	0	"S"	305	960	NA	0.0015	0	"HG00621#1#JAHBCD010000034.1_2122997_2624098_1"	"AMYP1-201"	"2Ap"	"1-2-5-2-6-4-2-5-2-6-4-2-5-4-3-0"	"1.0-2.0-5.1-2.1-6.1-4.1-2.0-5.1-2.1-6.1-4.1-2.0-5.0-4.0-3.0-0.0"	2123152	"HG00621#1#JAHBCD010000034.1_2122997_2624098_1"	364322	370466
"AMYP1-201"	1023	4	1022	"+"	"HG00621#2#JAHBCC010000031.1_16669999_17077865_0"	407866	257610	263754	1013	6144	1	"P"	311	963	959	2e-04	0	"HG00621#2#JAHBCC010000031.1_16669999_17077865_0"	"AMYP1-201"	"2Ap"	"1-2-5-2-6-4-2-5-4-3-0"	"1.0-2.0-5.0-2.1-6.1-4.1-2.0-5.0-4.0-3.0-0.0"	16670098	"HG00621#2#JAHBCC010000031.1_16669999_17077865_0"	257610	263754
"AMYP1-201"	1023	4	1022	"+"	"HG00673#2#JAHBBY010000109.1_16675383_17177395_0"	502012	257599	263743	1010	6144	0	"P"	305	960	960	0.0015	0	"HG00673#2#JAHBBY010000109.1_16675383_17177395_0"	"AMYP1-201"	"2Ap"	"1-2-5-2-6-4-2-5-2-6-4-2-5-4-3-0"	"1.0-2.0-5.0-2.1-6.1-4.1-2.0-5.0-2.1-6.1-4.1-2.0-5.0-4.0-3.0-0.0"	16675482	"HG00673#2#JAHBBY010000109.1_16675383_17177395_0"	257599	263743
"AMYP1-201"	1023	4	1022	"+"	"HG00673#2#JAHBBY010000109.1_16675383_17177395_0"	502012	351743	357887	1010	6144	0	"S"	305	960	NA	0.0015	0	"HG00673#2#JAHBBY010000109.1_16675383_17177395_0"	"AMYP1-201"	"2Ap"	"1-2-5-2-6-4-2-5-2-6-4-2-5-4-3-0"	"1.0-2.0-5.0-2.1-6.1-4.1-2.0-5.0-2.1-6.1-4.1-2.0-5.0-4.0-3.0-0.0"	16675482	"HG00673#2#JAHBBY010000109.1_16675383_17177395_0"	351743	357887
"AMYP1-201"	1023	4	1022	"+"	"HG00735#1#JAHBCH010000004.1_101548252_101956125_0"	407873	257610	263754	1013	6144	1	"P"	311	963	959	2e-04	0	"HG00735#1#JAHBCH010000004.1_101548252_101956125_0"	"AMYP1-201"	"2Ap"	"1-2-5-2-6-4-2-5-4-3-0"	"1.0-2.0-5.0-2.1-6.1-4.1-2.0-5.0-4.0-3.0-0.0"	101548351	"HG00735#1#JAHBCH010000004.1_101548252_101956125_0"	257610	263754
"AMYP1-201"	1023	4	1022	"+"	"HG00741#1#JAHALY010000007.1_18781197_19307680_1"	526483	376325	382469	998	6144	0	"S"	303	948	NA	0.0013	0	"HG00741#1#JAHALY010000007.1_18781197_19307680_1"	"AMYP1-201"	"2Ap"	"1-2-5-2-4-4-2-5-4-6-3-0-4-2-5-4-6-3-0"	"1.0-2.0-5.0-2.1-4.0-4.1-2.0-5.0-4.0-6.0-3.0-0.0-4.1-2.0-5.0-4.0-6.0-3.0-0.0"	18781351	"HG00741#1#JAHALY010000007.1_18781197_19307680_1"	376325	382469
"AMYP1-201"	1023	4	1022	"-"	"HG00741#2#JAHALX010000013.1_51574319_51981226_0"	406907	270137	276281	998	6144	0	"S"	303	948	NA	0.0013	0	"HG00741#2#JAHALX010000013.1_51574319_51981226_0"	"AMYP1-201"	"2Ap"	"1-2-5-2-4-2-5-4-3-0"	"1.0-2.0-5.1-2.1-4.0-2.0-5.0-4.0-3.0-0.0"	51574417	"HG00741#2#JAHALX010000013.1_51574319_51981226_0"	270137	276281
"AMYP1-201"	1023	4	1022	"+"	"HG01071#1#JAHBCF010000053.1_26607100_27108065_1"	500965	257602	263746	1013	6144	1	"P"	311	963	959	2e-04	0	"HG01071#1#JAHBCF010000053.1_26607100_27108065_1"	"AMYP1-201"	"2Ap"	"1-2-5-2-4-2-5-2-6-4-2-5-4-3-0"	"1.0-2.0-5.1-2.1-4.0-2.0-5.0-2.1-6.1-4.1-2.0-5.0-4.0-3.0-0.0"	26607255	"HG01071#1#JAHBCF010000053.1_26607100_27108065_1"	257602	263746
"AMYP1-201"	1023	4	1022	"-"	"HG01071#1#JAHBCF010000053.1_26607100_27108065_1"	500965	364242	370386	998	6144	0	"S"	303	948	NA	0.0019	0	"HG01071#1#JAHBCF010000053.1_26607100_27108065_1"	"AMYP1-201"	"2Ap"	"1-2-5-2-4-2-5-2-6-4-2-5-4-3-0"	"1.0-2.0-5.1-2.1-4.0-2.0-5.0-2.1-6.1-4.1-2.0-5.0-4.0-3.0-0.0"	26607255	"HG01071#1#JAHBCF010000053.1_26607100_27108065_1"	364242	370386
"AMYP1-201"	1023	4	1022	"-"	"HG01106#1#JAHAMC010000004.1_31121050_31623013_0"	501963	270095	276239	1013	6144	0	"S"	311	963	NA	2e-04	0	"HG01106#1#JAHAMC010000004.1_31121050_31623013_0"	"AMYP1-201"	"2Ap"	"1-2-5-2-6-4-2-5-2-4-6-2-5-4-3-0"	"1.0-2.0-5.0-2.1-6.1-4.1-2.0-5.1-2.1-4.0-6.0-2.0-5.0-4.0-3.0-0.0"	31121149	"HG01106#1#JAHAMC010000004.1_31121050_31623013_0"	270095	276239
"AMYP1-201"	1023	4	1022	"+"	"HG01106#1#JAHAMC010000004.1_31121050_31623013_0"	501963	351703	357847	1013	6144	0	"P"	311	963	963	2e-04	0	"HG01106#1#JAHAMC010000004.1_31121050_31623013_0"	"AMYP1-201"	"2Ap"	"1-2-5-2-6-4-2-5-2-4-6-2-5-4-3-0"	"1.0-2.0-5.0-2.1-6.1-4.1-2.0-5.1-2.1-4.0-6.0-2.0-5.0-4.0-3.0-0.0"	31121149	"HG01106#1#JAHAMC010000004.1_31121050_31623013_0"	351703	357847
"AMYP1-201"	1023	4	1022	"-"	"HG01106#2#JAHAMB010000008.1_19904771_20405763_1"	500992	270115	276259	1010	6144	0	"S"	305	960	NA	0.0015	0	"HG01106#2#JAHAMB010000008.1_19904771_20405763_1"	"AMYP1-201"	"2Ap"	"1-2-5-2-6-4-2-5-2-4-2-5-4-3-0"	"1.0-2.0-5.0-2.1-6.1-4.1-2.0-5.1-2.1-4.1-2.0-5.0-4.0-3.0-0.0"	19904926	"HG01106#2#JAHAMB010000008.1_19904771_20405763_1"	270115	276259
"AMYP1-201"	1023	4	1022	"+"	"HG01106#2#JAHAMB010000008.1_19904771_20405763_1"	500992	351736	357880	1013	6144	0	"P"	311	963	960	2e-04	0	"HG01106#2#JAHAMB010000008.1_19904771_20405763_1"	"AMYP1-201"	"2Ap"	"1-2-5-2-6-4-2-5-2-4-2-5-4-3-0"	"1.0-2.0-5.0-2.1-6.1-4.1-2.0-5.1-2.1-4.1-2.0-5.0-4.0-3.0-0.0"	19904926	"HG01106#2#JAHAMB010000008.1_19904771_20405763_1"	351736	357880
"AMYP1-201"	1023	4	1022	"-"	"HG01109#1#JAHEPA010000099.1_2104245_2511104_1"	406859	270140	276284	998	6144	0	"S"	303	948	NA	0.0013	0	"HG01109#1#JAHEPA010000099.1_2104245_2511104_1"	"AMYP1-201"	"2Ap"	"1-2-5-2-4-2-5-4-3-0"	"1.0-2.0-5.1-2.1-4.0-2.0-5.0-4.0-3.0-0.0"	2104400	"HG01109#1#JAHEPA010000099.1_2104245_2511104_1"	270140	276284
"AMYP1-201"	1023	4	1022	"+"	"HG01109#2#JAHEOZ010000047.1_16671232_17151375_0"	480143	329930	336067	998	6137	0	"S"	303	948	NA	0.0013	0	"HG01109#2#JAHEOZ010000047.1_16671232_17151375_0"	"AMYP1-201"	"2Ap"	"1-2-5-2-4-6-2-5-4-6-2-5-4-6-3-0"	"1.0-2.0-5.0-2.1-4.0-6.0-2.0-5.0-4.0-6.0-2.0-5.0-4.0-6.0-3.0-0.0"	16671330	"HG01109#2#JAHEOZ010000047.1_16671232_17151375_0"	329930	336067
"AMYP1-201"	1023	4	1022	"-"	"HG01123#1#JAGYYZ010000015.1_51528240_51935090_0"	406850	270094	276238	998	6144	0	"S"	303	948	NA	0.0013	0	"HG01123#1#JAGYYZ010000015.1_51528240_51935090_0"	"AMYP1-201"	"2Ap"	"1-2-5-2-4-2-5-4-3-0"	"1.0-2.0-5.1-2.1-4.0-2.0-5.0-4.0-3.0-0.0"	51528338	"HG01123#1#JAGYYZ010000015.1_51528240_51935090_0"	270094	276238
"AMYP1-201"	1023	4	1022	"+"	"HG01175#1#JAHAMA010000003.1_33204707_33808232_1"	603525	260554	266698	998	6144	0	"P"	303	948	948	0.0013	0	"HG01175#1#JAHAMA010000003.1_33204707_33808232_1"	"AMYP1-201"	"2Ap"	"1-2-5-2-4-4-2-5-2-4-4-2-5-2-4-4-2-5-4-6-3-0"	"1.0-2.0-5.0-2.1-4.0-4.1-2.0-5.1-2.1-4.0-4.1-2.0-5.0-2.1-4.0-4.1-2.0-5.0-4.0-6.0-3.0-0.0"	33204861	"HG01175#1#JAHAMA010000003.1_33204707_33808232_1"	260554	266698
"AMYP1-201"	1023	4	1022	"-"	"HG01175#1#JAHAMA010000003.1_33204707_33808232_1"	603525	370104	376248	998	6144	0	"S"	303	948	NA	0.0013	0	"HG01175#1#JAHAMA010000003.1_33204707_33808232_1"	"AMYP1-201"	"2Ap"	"1-2-5-2-4-4-2-5-2-4-4-2-5-2-4-4-2-5-4-6-3-0"	"1.0-2.0-5.0-2.1-4.0-4.1-2.0-5.1-2.1-4.0-4.1-2.0-5.0-2.1-4.0-4.1-2.0-5.0-4.0-6.0-3.0-0.0"	33204861	"HG01175#1#JAHAMA010000003.1_33204707_33808232_1"	370104	376248
"AMYP1-201"	1023	4	1022	"+"	"HG01175#1#JAHAMA010000003.1_33204707_33808232_1"	603525	454644	460788	998	6144	0	"S"	303	948	NA	0.0013	0	"HG01175#1#JAHAMA010000003.1_33204707_33808232_1"	"AMYP1-201"	"2Ap"	"1-2-5-2-4-4-2-5-2-4-4-2-5-2-4-4-2-5-4-6-3-0"	"1.0-2.0-5.0-2.1-4.0-4.1-2.0-5.1-2.1-4.0-4.1-2.0-5.0-2.1-4.0-4.1-2.0-5.0-4.0-6.0-3.0-0.0"	33204861	"HG01175#1#JAHAMA010000003.1_33204707_33808232_1"	454644	460788
"AMYP1-201"	1023	4	1022	"+"	"HG01175#2#JAHALZ010000031.1_43072077_43478977_1"	406900	257603	263747	1013	6144	1	"P"	311	963	959	2e-04	0	"HG01175#2#JAHALZ010000031.1_43072077_43478977_1"	"AMYP1-201"	"2Ap"	"1-2-5-2-6-4-2-5-4-3-0"	"1.0-2.0-5.0-2.1-6.1-4.1-2.0-5.0-4.0-3.0-0.0"	43072232	"HG01175#2#JAHALZ010000031.1_43072077_43478977_1"	257603	263747
"AMYP1-201"	1023	4	1022	"+"	"HG01258#1#JAGYYV010000004.1_56955948_57456952_1"	501004	257659	263803	1013	6144	1	"P"	311	963	959	2e-04	0	"HG01258#1#JAGYYV010000004.1_56955948_57456952_1"	"AMYP1-201"	"2Ap"	"1-2-5-2-4-2-5-2-4-2-5-4-3-0"	"1.0-2.0-5.0-2.1-4.0-2.0-5.0-2.1-4.1-2.0-5.0-4.0-3.0-0.0"	56956103	"HG01258#1#JAGYYV010000004.1_56955948_57456952_1"	257659	263803
"AMYP1-201"	1023	4	1022	"+"	"HG01258#1#JAGYYV010000004.1_56955948_57456952_1"	501004	351782	357926	998	6144	0	"S"	303	948	NA	0.0019	0	"HG01258#1#JAGYYV010000004.1_56955948_57456952_1"	"AMYP1-201"	"2Ap"	"1-2-5-2-4-2-5-2-4-2-5-4-3-0"	"1.0-2.0-5.0-2.1-4.0-2.0-5.0-2.1-4.1-2.0-5.0-4.0-3.0-0.0"	56956103	"HG01258#1#JAGYYV010000004.1_56955948_57456952_1"	351782	357926
"AMYP1-201"	1023	4	1022	"-"	"HG01258#2#JAGYYU010000072.1_51562603_51970395_0"	407792	270108	276252	998	6144	0	"S"	303	948	NA	0.0013	0	"HG01258#2#JAGYYU010000072.1_51562603_51970395_0"	"AMYP1-201"	"2Ap"	"1-2-5-2-4-2-5-4-3-0"	"1.0-2.0-5.1-2.1-4.0-2.0-5.0-4.0-3.0-0.0"	51562701	"HG01258#2#JAGYYU010000072.1_51562603_51970395_0"	270108	276252
"AMYP1-201"	1023	4	1022	"-"	"HG01358#1#JAGYZB010000020.1_27445742_27855492_1"	409750	273041	279185	998	6144	0	"P"	303	948	948	0.0013	0	"HG01358#1#JAGYZB010000020.1_27445742_27855492_1"	"AMYP1-201"	"2Ap"	"1-2-5-2-4-4-2-5-4-6-3-0"	"1.0-2.0-5.1-2.1-4.0-4.1-2.0-5.0-4.0-6.0-3.0-0.0"	27445896	"HG01358#1#JAGYZB010000020.1_27445742_27855492_1"	273041	279185
"AMYP1-201"	1023	4	1022	"-"	"HG01928#1#JAGYVQ010000053.1_16676493_17083407_0"	406914	270085	276229	1010	6144	0	"P"	305	960	959	0.0015	0	"HG01928#1#JAGYVQ010000053.1_16676493_17083407_0"	"AMYP1-201"	"2Ap"	"1-2-5-2-6-4-2-5-4-3-0"	"1.0-2.0-5.1-2.1-6.1-4.1-2.0-5.0-4.0-3.0-0.0"	16676592	"HG01928#1#JAGYVQ010000053.1_16676493_17083407_0"	270085	276229
"AMYP1-201"	1023	4	1022	"+"	"HG01928#1#JAGYVQ010000195.1_211_358290_0"	358079	23181	29325	1010	6144	0	"S"	305	960	NA	0.0015	0	"HG01928#1#JAGYVQ010000195.1_211_358290_0"	"AMYP1-201"	"2Ap"	"1-2-5-2-6-4-5-2-4-6-2-5-2-4-6-2-5-2"	"1.0-2.0-5.0-2.1-6.1-4.1-5.1-2.1-4.0-6.0-2.0-5.0-2.1-4.0-6.0-2.0-5.0-2.1"	1263	"HG01928#1#JAGYVQ010000195.1_211_358290_0"	23181	29325
"AMYP1-201"	1023	4	1022	"+"	"HG01928#1#JAGYVQ010000195.1_211_358290_0"	358079	117314	123458	1010	6144	0	"P"	305	960	960	0.0015	0	"HG01928#1#JAGYVQ010000195.1_211_358290_0"	"AMYP1-201"	"2Ap"	"1-2-5-2-6-4-5-2-4-6-2-5-2-4-6-2-5-2"	"1.0-2.0-5.0-2.1-6.1-4.1-5.1-2.1-4.0-6.0-2.0-5.0-2.1-4.0-6.0-2.0-5.0-2.1"	1263	"HG01928#1#JAGYVQ010000195.1_211_358290_0"	117314	123458
"AMYP1-201"	1023	4	1022	"+"	"HG01928#1#JAGYVQ010000195.1_211_358290_0"	358079	283883	290027	1010	6144	0	"S"	305	960	NA	0.0015	0	"HG01928#1#JAGYVQ010000195.1_211_358290_0"	"AMYP1-201"	"2Ap"	"1-2-5-2-6-4-5-2-4-6-2-5-2-4-6-2-5-2"	"1.0-2.0-5.0-2.1-6.1-4.1-5.1-2.1-4.0-6.0-2.0-5.0-2.1-4.0-6.0-2.0-5.0-2.1"	1263	"HG01928#1#JAGYVQ010000195.1_211_358290_0"	283883	290027
"AMYP1-201"	1023	4	1022	"-"	"HG01952#2#JAHAMD010000045.1_4381722_4883708_1"	501986	270143	276287	1010	6144	0	"P"	305	960	960	0.0015	0	"HG01952#2#JAHAMD010000045.1_4381722_4883708_1"	"AMYP1-201"	"2Ap"	"1-2-5-2-4-6-2-5-2-6-4-2-5-4-3-0"	"1.0-2.0-5.0-2.1-4.0-6.0-2.0-5.1-2.1-6.1-4.1-2.0-5.0-4.0-3.0-0.0"	4381877	"HG01952#2#JAHAMD010000045.1_4381722_4883708_1"	270143	276287
"AMYP1-201"	1023	4	1022	"+"	"HG01952#2#JAHAMD010000045.1_4381722_4883708_1"	501986	351780	357924	1010	6144	0	"S"	305	960	NA	0.0015	0	"HG01952#2#JAHAMD010000045.1_4381722_4883708_1"	"AMYP1-201"	"2Ap"	"1-2-5-2-4-6-2-5-2-6-4-2-5-4-3-0"	"1.0-2.0-5.0-2.1-4.0-6.0-2.0-5.1-2.1-6.1-4.1-2.0-5.0-4.0-3.0-0.0"	4381877	"HG01952#2#JAHAMD010000045.1_4381722_4883708_1"	351780	357924
"AMYP1-201"	1023	4	1022	"-"	"HG01978#1#JAGYVS010000002.1_51519970_52021951_0"	501981	270105	276249	1010	6144	0	"S"	305	960	NA	0.0015	0	"HG01978#1#JAGYVS010000002.1_51519970_52021951_0"	"AMYP1-201"	"2Ap"	"1-2-5-2-6-4-2-5-2-4-2-5-4-3-0"	"1.0-2.0-5.0-2.1-6.1-4.1-2.0-5.1-2.1-4.1-2.0-5.0-4.0-3.0-0.0"	51520069	"HG01978#1#JAGYVS010000002.1_51519970_52021951_0"	270105	276249
"AMYP1-201"	1023	4	1022	"+"	"HG01978#1#JAGYVS010000002.1_51519970_52021951_0"	501981	351730	357874	1013	6144	0	"P"	311	963	960	2e-04	0	"HG01978#1#JAGYVS010000002.1_51519970_52021951_0"	"AMYP1-201"	"2Ap"	"1-2-5-2-6-4-2-5-2-4-2-5-4-3-0"	"1.0-2.0-5.0-2.1-6.1-4.1-2.0-5.1-2.1-4.1-2.0-5.0-4.0-3.0-0.0"	51520069	"HG01978#1#JAGYVS010000002.1_51519970_52021951_0"	351730	357874
"AMYP1-201"	1023	4	1022	"-"	"HG01978#2#JAGYVR010000007.1_51532241_51939176_0"	406935	270110	276254	1010	6144	0	"P"	305	960	959	0.0015	0	"HG01978#2#JAGYVR010000007.1_51532241_51939176_0"	"AMYP1-201"	"2Ap"	"1-2-5-2-6-4-2-5-4-3-0"	"1.0-2.0-5.1-2.1-6.1-4.1-2.0-5.0-4.0-3.0-0.0"	51532340	"HG01978#2#JAGYVR010000007.1_51532241_51939176_0"	270110	276254
"AMYP1-201"	1023	9	1022	"-"	"HG02080#1#JAHEOW010000048.1_16689583_17097287_0"	407704	270012	276151	993	6139	0	"S"	301	943	NA	0.0013	0	"HG02080#1#JAHEOW010000048.1_16689583_17097287_0"	"AMYP1-201"	"2Ap"	"1-2-5-2-6-4-2-5-4-6-3-0"	"1.0-2.0-5.1-2.1-6.1-4.1-2.0-5.0-4.0-6.0-3.0-0.0"	16689681	"HG02080#1#JAHEOW010000048.1_16689583_17097287_0"	270012	276151
"AMYP1-201"	1023	4	1022	"+"	"HG02080#2#JAHEOV010000017.1_16662177_17164189_0"	502012	257606	263750	1010	6144	0	"S"	305	960	NA	0.0015	0	"HG02080#2#JAHEOV010000017.1_16662177_17164189_0"	"AMYP1-201"	"2Ap"	"1-2-5-2-6-4-2-5-2-6-4-2-5-4-3-0"	"1.0-2.0-5.0-2.1-6.1-4.1-2.0-5.0-2.1-6.1-4.1-2.0-5.0-4.0-3.0-0.0"	16662276	"HG02080#2#JAHEOV010000017.1_16662177_17164189_0"	257606	263750
"AMYP1-201"	1023	4	1022	"+"	"HG02080#2#JAHEOV010000017.1_16662177_17164189_0"	502012	351734	357878	1010	6144	0	"P"	305	960	960	0.0015	0	"HG02080#2#JAHEOV010000017.1_16662177_17164189_0"	"AMYP1-201"	"2Ap"	"1-2-5-2-6-4-2-5-2-6-4-2-5-4-3-0"	"1.0-2.0-5.0-2.1-6.1-4.1-2.0-5.0-2.1-6.1-4.1-2.0-5.0-4.0-3.0-0.0"	16662276	"HG02080#2#JAHEOV010000017.1_16662177_17164189_0"	351734	357878
"AMYP1-201"	1023	4	1022	"-"	"HG02109#1#JAHEPG010000026.1_16673035_17080816_0"	407781	270082	276226	998	6144	1	"P"	303	948	944	0.0013	0	"HG02109#1#JAHEPG010000026.1_16673035_17080816_0"	"AMYP1-201"	"2Ap"	"1-2-5-2-6-4-2-5-4-6-3-0"	"1.0-2.0-5.1-2.1-6.1-4.1-2.0-5.0-4.0-6.0-3.0-0.0"	16673133	"HG02109#1#JAHEPG010000026.1_16673035_17080816_0"	270082	276226
"AMYP1-201"	1023	4	1022	"+"	"HG02145#2#JAHKSF010000206.1_1005292_1413195_1"	407903	257744	263888	1003	6144	0	"S"	299	953	NA	0.0022	0	"HG02145#2#JAHKSF010000206.1_1005292_1413195_1"	"AMYP1-201"	"2Ap"	"1-2-5-2-6-4-2-5-4-6-3-0"	"1.0-2.0-5.0-2.1-6.1-4.1-2.0-5.0-4.0-6.0-3.0-0.0"	1005446	"HG02145#2#JAHKSF010000206.1_1005292_1413195_1"	257744	263888
"AMYP1-201"	1023	4	1022	"+"	"HG02148#1#JAHAMG010000059.1_19799474_20206456_1"	406982	257678	263822	1013	6144	1	"P"	311	963	959	2e-04	0	"HG02148#1#JAHAMG010000059.1_19799474_20206456_1"	"AMYP1-201"	"2Ap"	"1-2-5-2-6-4-2-5-4-3-0"	"1.0-2.0-5.0-2.1-6.1-4.1-2.0-5.0-4.0-3.0-0.0"	19799629	"HG02148#1#JAHAMG010000059.1_19799474_20206456_1"	257678	263822
"AMYP1-201"	1023	4	1022	"-"	"HG02148#2#JAHAMF010000050.1_19456870_19863761_1"	406891	270173	276317	1009	6144	0	"S"	306	959	NA	7e-04	0	"HG02148#2#JAHAMF010000050.1_19456870_19863761_1"	"AMYP1-201"	"2Ap"	"1-2-5-2-4-2-5-4-3-0"	"1.0-2.0-5.1-2.1-4.0-2.0-5.0-4.0-3.0-0.0"	19457024	"HG02148#2#JAHAMF010000050.1_19456870_19863761_1"	270173	276317
"AMYP1-201"	1023	4	1022	"+"	"HG02257#1#JAGYVI010000005.1_101835875_102242843_0"	406968	257623	263767	1003	6144	0	"S"	299	953	NA	0.0022	0	"HG02257#1#JAGYVI010000005.1_101835875_102242843_0"	"AMYP1-201"	"2Ap"	"1-2-5-2-6-4-2-5-4-6-3-0"	"1.0-2.0-5.0-2.1-6.1-4.1-2.0-5.0-4.0-6.0-3.0-0.0"	101835973	"HG02257#1#JAGYVI010000005.1_101835875_102242843_0"	257623	263767
"AMYP1-201"	1023	4	1022	"-"	"HG02257#2#JAGYVH010000034.1_98190388_98857961_0"	667573	197666	203810	998	6144	0	"S"	303	948	NA	0.0013	0	"HG02257#2#JAGYVH010000034.1_98190388_98857961_0"	"AMYP1-201"	"2Ap"	"1-2-5-2-4-6-2-5-4-6-2-5-2-4-6-2-5-4-6-2-5-2-4-6-3-0"	"1.0-2.0-5.1-2.1-4.0-6.0-2.0-5.0-4.0-6.0-2.0-5.1-2.1-4.0-6.0-2.0-5.0-4.0-6.0-2.0-5.1-2.1-4.0-6.0-3.0-0.0"	98190486	"HG02257#2#JAGYVH010000034.1_98190388_98857961_0"	197666	203810
"AMYP1-201"	1023	4	1022	"-"	"HG02257#2#JAGYVH010000034.1_98190388_98857961_0"	667573	364218	370362	998	6144	0	"S"	303	948	NA	0.0013	0	"HG02257#2#JAGYVH010000034.1_98190388_98857961_0"	"AMYP1-201"	"2Ap"	"1-2-5-2-4-6-2-5-4-6-2-5-2-4-6-2-5-4-6-2-5-2-4-6-3-0"	"1.0-2.0-5.1-2.1-4.0-6.0-2.0-5.0-4.0-6.0-2.0-5.1-2.1-4.0-6.0-2.0-5.0-4.0-6.0-2.0-5.1-2.1-4.0-6.0-3.0-0.0"	98190486	"HG02257#2#JAGYVH010000034.1_98190388_98857961_0"	364218	370362
"AMYP1-201"	1023	4	1022	"-"	"HG02257#2#JAGYVH010000034.1_98190388_98857961_0"	667573	530765	536902	1009	6137	0	"P"	306	959	959	7e-04	0	"HG02257#2#JAGYVH010000034.1_98190388_98857961_0"	"AMYP1-201"	"2Ap"	"1-2-5-2-4-6-2-5-4-6-2-5-2-4-6-2-5-4-6-2-5-2-4-6-3-0"	"1.0-2.0-5.1-2.1-4.0-6.0-2.0-5.0-4.0-6.0-2.0-5.1-2.1-4.0-6.0-2.0-5.0-4.0-6.0-2.0-5.1-2.1-4.0-6.0-3.0-0.0"	98190486	"HG02257#2#JAGYVH010000034.1_98190388_98857961_0"	530765	536902
"AMYP1-201"	1023	4	1022	"-"	"HG02486#1#JAGYVM010000007.1_28868414_29370339_1"	501925	270182	276325	995	6143	0	"S"	298	945	NA	0.0024	0	"HG02486#1#JAGYVM010000007.1_28868414_29370339_1"	"AMYP1-201"	"2Ap"	"1-2-5-2-4-6-2-5-2-6-4-2-5-4-6-3-0"	"1.0-2.0-5.0-2.1-4.0-6.0-2.0-5.1-2.1-6.1-4.1-2.0-5.0-4.0-6.0-3.0-0.0"	28868568	"HG02486#1#JAGYVM010000007.1_28868414_29370339_1"	270182	276325
"AMYP1-201"	1023	4	1022	"+"	"HG02486#1#JAGYVM010000007.1_28868414_29370339_1"	501925	351773	357916	995	6143	0	"S"	298	945	NA	0.0024	0	"HG02486#1#JAGYVM010000007.1_28868414_29370339_1"	"AMYP1-201"	"2Ap"	"1-2-5-2-4-6-2-5-2-6-4-2-5-4-6-3-0"	"1.0-2.0-5.0-2.1-4.0-6.0-2.0-5.1-2.1-6.1-4.1-2.0-5.0-4.0-6.0-3.0-0.0"	28868568	"HG02486#1#JAGYVM010000007.1_28868414_29370339_1"	351773	357916
"AMYP1-201"	1023	4	1022	"-"	"HG02486#2#JAGYVL010000029.1_94163344_94570162_0"	406818	270060	276204	998	6144	0	"P"	303	948	948	0.0013	0	"HG02486#2#JAGYVL010000029.1_94163344_94570162_0"	"AMYP1-201"	"2Ap"	"1-2-5-2-4-6-2-5-4-6-3-0"	"1.0-2.0-5.1-2.1-4.0-6.0-2.0-5.0-4.0-6.0-3.0-0.0"	94163442	"HG02486#2#JAGYVL010000029.1_94163344_94570162_0"	270060	276204
"AMYP1-201"	1023	4	1022	"-"	"HG02559#1#JAGYVK010000012.1_51505852_51913611_0"	407759	270107	276250	998	6143	0	"S"	303	948	NA	0.0013	0	"HG02559#1#JAGYVK010000012.1_51505852_51913611_0"	"AMYP1-201"	"2Ap"	"1-2-5-2-6-4-2-5-4-6-3-0"	"1.0-2.0-5.1-2.1-6.1-4.1-2.0-5.0-4.0-6.0-3.0-0.0"	51505950	"HG02559#1#JAGYVK010000012.1_51505852_51913611_0"	270107	276250
"AMYP1-201"	1023	4	1022	"-"	"HG02559#2#JAGYVJ010000037.1_52167780_52574597_1"	406817	270118	276262	1009	6144	0	"S"	306	959	NA	7e-04	0	"HG02559#2#JAGYVJ010000037.1_52167780_52574597_1"	"AMYP1-201"	"2Ap"	"1-2-5-2-6-4-2-5-4-6-3-0"	"1.0-2.0-5.1-2.1-6.1-4.1-2.0-5.0-4.0-6.0-3.0-0.0"	52167934	"HG02559#2#JAGYVJ010000037.1_52167780_52574597_1"	270118	276262
"AMYP1-201"	1023	4	1022	"+"	"HG02572#1#JAHAOW010000072.1_9428131_9835964_0"	407833	257568	263712	1010	6144	0	"P"	305	960	959	0.0015	0	"HG02572#1#JAHAOW010000072.1_9428131_9835964_0"	"AMYP1-201"	"2Ap"	"1-2-5-2-6-4-2-5-4-3-0"	"1.0-2.0-5.0-2.1-6.1-4.1-2.0-5.0-4.0-3.0-0.0"	9428229	"HG02572#1#JAHAOW010000072.1_9428131_9835964_0"	257568	263712
"AMYP1-201"	1023	4	1022	"+"	"HG02622#1#JAHAOO010000002.1_16673678_17080663_0"	406985	257682	263826	1003	6144	0	"S"	299	953	NA	0.0022	0	"HG02622#1#JAHAOO010000002.1_16673678_17080663_0"	"AMYP1-201"	"2Ap"	"1-2-5-2-6-4-2-5-4-6-3-0"	"1.0-2.0-5.0-2.1-6.1-4.1-2.0-5.0-4.0-6.0-3.0-0.0"	16673776	"HG02622#1#JAHAOO010000002.1_16673678_17080663_0"	257682	263826
"AMYP1-201"	1023	4	1022	"+"	"HG02622#2#JAHAON010000012.1_51551779_52031001_0"	479222	329933	336042	998	6109	0	"S"	303	948	NA	0.0013	0	"HG02622#2#JAHAON010000012.1_51551779_52031001_0"	"AMYP1-201"	"2Ap"	"1-2-5-2-6-4-5-2-4-6-2-5-4-6-3-0"	"1.0-2.0-5.0-2.1-6.1-4.1-5.1-2.1-4.0-6.0-2.0-5.0-4.0-6.0-3.0-0.0"	51551877	"HG02622#2#JAHAON010000012.1_51551779_52031001_0"	329933	336042
"AMYP1-201"	1023	4	1022	"+"	"HG02630#1#JAHAOQ010000102.1_16672145_17079089_0"	406944	257659	263803	1003	6144	0	"S"	299	953	NA	0.0022	0	"HG02630#1#JAHAOQ010000102.1_16672145_17079089_0"	"AMYP1-201"	"2Ap"	"1-2-5-2-6-4-2-5-4-6-3-0"	"1.0-2.0-5.0-2.1-6.1-4.1-2.0-5.0-4.0-6.0-3.0-0.0"	16672243	"HG02630#1#JAHAOQ010000102.1_16672145_17079089_0"	257659	263803
"AMYP1-201"	1023	4	1022	"-"	"HG02630#2#JAHAOP010000089.1_16669255_17076135_0"	406880	270129	276274	1009	6145	3	"P"	306	959	948	7e-04	0	"HG02630#2#JAHAOP010000089.1_16669255_17076135_0"	"AMYP1-201"	"2Ap"	"1-2-5-2-4-6-2-5-4-6-3-0"	"1.0-2.0-5.1-2.1-4.0-6.0-2.0-5.0-4.0-6.0-3.0-0.0"	16669353	"HG02630#2#JAHAOP010000089.1_16669255_17076135_0"	270129	276274
"AMYP1-201"	1023	4	1022	"+"	"HG02717#1#JAHAOS010000015.1_16660311_17067250_0"	406939	257586	263730	1003	6144	0	"P"	299	953	953	0.0022	0	"HG02717#1#JAHAOS010000015.1_16660311_17067250_0"	"AMYP1-201"	"2Ap"	"1-2-5-2-6-4-2-5-4-6-3-0"	"1.0-2.0-5.0-2.1-6.1-4.1-2.0-5.0-4.0-6.0-3.0-0.0"	16660409	"HG02717#1#JAHAOS010000015.1_16660311_17067250_0"	257586	263730
"AMYP1-201"	1023	4	1022	"-"	"HG02717#2#JAHAOR010000006.1_19663827_20070693_1"	406866	270161	276305	998	6144	0	"S"	303	948	NA	0.0013	0	"HG02717#2#JAHAOR010000006.1_19663827_20070693_1"	"AMYP1-201"	"2Ap"	"1-2-5-2-4-2-5-4-3-0"	"1.0-2.0-5.1-2.1-4.0-2.0-5.0-4.0-3.0-0.0"	19663981	"HG02717#2#JAHAOR010000006.1_19663827_20070693_1"	270161	276305
"AMYP1-201"	1023	4	1022	"+"	"HG02818#1#JAHEOS010000101.1_89626_496613_0"	406987	257692	263836	1003	6144	0	"P"	299	953	953	0.0022	0	"HG02818#1#JAHEOS010000101.1_89626_496613_0"	"AMYP1-201"	"2Ap"	"1-2-5-2-6-4-2-5-4-6-3-0"	"1.0-2.0-5.0-2.1-6.1-4.1-2.0-5.0-4.0-6.0-3.0-0.0"	89724	"HG02818#1#JAHEOS010000101.1_89626_496613_0"	257692	263836
"AMYP1-201"	1023	4	1022	"+"	"HG02818#2#JAHEOR010000010.1_31775319_32183091_1"	407772	257664	263809	1009	6145	3	"P"	306	959	948	7e-04	0	"HG02818#2#JAHEOR010000010.1_31775319_32183091_1"	"AMYP1-201"	"2Ap"	"1-2-5-2-6-4-2-5-4-6-3-0"	"1.0-2.0-5.0-2.1-6.1-4.1-2.0-5.0-4.0-6.0-3.0-0.0"	31775473	"HG02818#2#JAHEOR010000010.1_31775319_32183091_1"	257664	263809
"AMYP1-201"	1023	4	1022	"-"	"HG02886#1#JAHAOU010000178.1_62411_469262_0"	406851	270089	276233	998	6144	0	"P"	303	948	948	0.0013	0	"HG02886#1#JAHAOU010000178.1_62411_469262_0"	"AMYP1-201"	"2Ap"	"1-2-5-2-6-4-2-5-4-6-3-0"	"1.0-2.0-5.1-2.1-6.1-4.1-2.0-5.0-4.0-6.0-3.0-0.0"	62509	"HG02886#1#JAHAOU010000178.1_62411_469262_0"	270089	276233
"AMYP1-201"	1023	4	1022	"-"	"HG03453#2#JAGYVV010000088.1_22597550_23005370_1"	407820	270155	276299	1005	6144	1	"P"	306	955	951	0.0013	0	"HG03453#2#JAGYVV010000088.1_22597550_23005370_1"	"AMYP1-201"	"2Ap"	"1-2-5-2-4-6-2-5-4-3-0"	"1.0-2.0-5.1-2.1-4.0-6.0-2.0-5.0-4.0-3.0-0.0"	22597704	"HG03453#2#JAGYVV010000088.1_22597550_23005370_1"	270155	276299
"AMYP1-201"	1023	4	1022	"+"	"HG03486#1#JAHEOQ010000123.1_16677696_17085575_0"	407879	257610	263754	1010	6144	0	"P"	305	960	959	0.0015	0	"HG03486#1#JAHEOQ010000123.1_16677696_17085575_0"	"AMYP1-201"	"2Ap"	"1-2-5-2-6-4-2-5-4-3-0"	"1.0-2.0-5.0-2.1-6.1-4.1-2.0-5.0-4.0-3.0-0.0"	16677795	"HG03486#1#JAHEOQ010000123.1_16677696_17085575_0"	257610	263754
"AMYP1-201"	1023	4	1022	"-"	"HG03486#2#JAHEOP010000248.1_2105565_2584784_1"	479219	342512	348656	998	6144	1	"P"	303	948	944	0.0013	0	"HG03486#2#JAHEOP010000248.1_2105565_2584784_1"	"AMYP1-201"	"2Ap"	"1-2-5-2-4-6-2-5-4-6-2-5-4-6-3-0"	"1.0-2.0-5.1-2.1-4.0-6.0-2.0-5.0-4.0-6.0-2.0-5.0-4.0-6.0-3.0-0.0"	2105719	"HG03486#2#JAHEOP010000248.1_2105565_2584784_1"	342512	348656
"AMYP1-201"	1023	4	1022	"-"	"HG03492#1#JAHEPI010000180.1_2103395_2543326_1"	439931	302305	308449	998	6144	0	"S"	303	948	NA	0.0013	0	"HG03492#1#JAHEPI010000180.1_2103395_2543326_1"	"AMYP1-201"	"2Ap"	"1-2-5-2-2-5-4-2-5-4-3-0"	"1.0-2.0-5.1-2.1-2.0-5.0-4.0-2.0-5.0-4.0-3.0-0.0"	2103549	"HG03492#1#JAHEPI010000180.1_2103395_2543326_1"	302305	308449
"AMYP1-201"	1023	4	1022	"-"	"HG03516#1#JAGYYT010000012.1_24170958_24578778_1"	407820	270158	276302	998	6144	0	"S"	303	948	NA	0.0013	0	"HG03516#1#JAGYYT010000012.1_24170958_24578778_1"	"AMYP1-201"	"2Ap"	"1-2-5-2-4-6-2-5-4-6-3-0"	"1.0-2.0-5.1-2.1-4.0-6.0-2.0-5.0-4.0-6.0-3.0-0.0"	24171112	"HG03516#1#JAGYYT010000012.1_24170958_24578778_1"	270158	276302
"AMYP1-201"	1023	4	1022	"-"	"HG03516#2#JAGYYS010000004.1_24452130_24859892_1"	407762	270159	276302	998	6143	0	"S"	303	948	NA	0.0013	0	"HG03516#2#JAGYYS010000004.1_24452130_24859892_1"	"AMYP1-201"	"2Ap"	"1-2-5-2-6-4-2-5-4-6-3-0"	"1.0-2.0-5.1-2.1-6.1-4.1-2.0-5.0-4.0-6.0-3.0-0.0"	24452284	"HG03516#2#JAGYYS010000004.1_24452130_24859892_1"	270159	276302
"AMYP1-201"	1023	4	1022	"+"	"HG03540#1#JAGYVY010000208.1_95187_596142_0"	500955	257575	263720	1000	6145	0	"P"	304	950	948	0.0011	0	"HG03540#1#JAGYVY010000208.1_95187_596142_0"	"AMYP1-201"	"2Ap"	"1-2-5-2-6-4-2-5-2-6-4-2-5-4-6-3-0"	"1.0-2.0-5.1-2.1-6.1-4.1-2.0-5.0-2.1-6.1-4.1-2.0-5.0-4.0-6.0-3.0-0.0"	95285	"HG03540#1#JAGYVY010000208.1_95187_596142_0"	257575	263720
"AMYP1-201"	1023	4	1022	"-"	"HG03540#1#JAGYVY010000208.1_95187_596142_0"	500955	364218	370361	998	6143	0	"S"	303	948	NA	0.0013	0	"HG03540#1#JAGYVY010000208.1_95187_596142_0"	"AMYP1-201"	"2Ap"	"1-2-5-2-6-4-2-5-2-6-4-2-5-4-6-3-0"	"1.0-2.0-5.1-2.1-6.1-4.1-2.0-5.0-2.1-6.1-4.1-2.0-5.0-4.0-6.0-3.0-0.0"	95285	"HG03540#1#JAGYVY010000208.1_95187_596142_0"	364218	370361
"AMYP1-201"	1023	4	1022	"+"	"HG03540#2#JAGYVX010000148.1_1368955_1877115_0"	508160	260869	267013	998	6144	0	"P"	303	948	948	0.0013	0	"HG03540#2#JAGYVX010000148.1_1368955_1877115_0"	"AMYP1-201"	"2Ap"	"1-2-5-2-4-4-2-5-2-4-4-2-5-4-6-3-0"	"1.0-2.0-5.1-2.1-4.0-4.1-2.0-5.0-2.1-4.0-4.1-2.0-5.0-4.0-6.0-3.0-0.0"	1369053	"HG03540#2#JAGYVX010000148.1_1368955_1877115_0"	260869	267013
"AMYP1-201"	1023	4	1022	"-"	"HG03540#2#JAGYVX010000148.1_1368955_1877115_0"	508160	370400	376544	998	6144	0	"S"	303	948	NA	0.0013	0	"HG03540#2#JAGYVX010000148.1_1368955_1877115_0"	"AMYP1-201"	"2Ap"	"1-2-5-2-4-4-2-5-2-4-4-2-5-4-6-3-0"	"1.0-2.0-5.1-2.1-4.0-4.1-2.0-5.0-2.1-4.0-4.1-2.0-5.0-4.0-6.0-3.0-0.0"	1369053	"HG03540#2#JAGYVX010000148.1_1368955_1877115_0"	370400	376544
"AMYP1-201"	1023	4	1022	"-"	"HG03579#1#JAGYVU010000029.1_91404_499180_0"	407776	270120	276265	998	6145	0	"S"	303	948	NA	0.0013	0	"HG03579#1#JAGYVU010000029.1_91404_499180_0"	"AMYP1-201"	"2Ap"	"1-2-5-2-4-6-2-5-4-6-3-0"	"1.0-2.0-5.1-2.1-4.0-6.0-2.0-5.0-4.0-6.0-3.0-0.0"	91502	"HG03579#1#JAGYVU010000029.1_91404_499180_0"	270120	276265
"AMYP1-201"	1023	4	1022	"+"	"NA18906#1#JAHEOO010000054.1_2103477_2510435_1"	406958	257721	263865	1003	6144	0	"S"	299	953	NA	0.0022	0	"NA18906#1#JAHEOO010000054.1_2103477_2510435_1"	"AMYP1-201"	"2Ap"	"1-2-5-2-6-4-2-5-4-6-3-0"	"1.0-2.0-5.0-2.1-6.1-4.1-2.0-5.0-4.0-6.0-3.0-0.0"	2103631	"NA18906#1#JAHEOO010000054.1_2103477_2510435_1"	257721	263865
"AMYP1-201"	1023	4	1022	"+"	"NA18906#2#JAHEON010000009.1_93748295_94249275_0"	500980	257552	263689	1009	6137	3	"P"	306	959	948	7e-04	0	"NA18906#2#JAHEON010000009.1_93748295_94249275_0"	"AMYP1-201"	"2Ap"	"1-2-5-2-6-4-2-5-2-6-4-2-5-4-6-3-0"	"1.0-2.0-5.1-2.1-6.1-4.1-2.0-5.0-2.1-6.1-4.1-2.0-5.0-4.0-6.0-3.0-0.0"	93748393	"NA18906#2#JAHEON010000009.1_93748295_94249275_0"	257552	263689
"AMYP1-201"	1023	4	1022	"-"	"NA18906#2#JAHEON010000009.1_93748295_94249275_0"	500980	364174	370311	998	6137	0	"S"	303	948	NA	0.0013	0	"NA18906#2#JAHEON010000009.1_93748295_94249275_0"	"AMYP1-201"	"2Ap"	"1-2-5-2-6-4-2-5-2-6-4-2-5-4-6-3-0"	"1.0-2.0-5.1-2.1-6.1-4.1-2.0-5.0-2.1-6.1-4.1-2.0-5.0-4.0-6.0-3.0-0.0"	93748393	"NA18906#2#JAHEON010000009.1_93748295_94249275_0"	364174	370311
"AMYP1-201"	1023	4	1022	"-"	"NA19240#1#JAHEOM010000047.1_30103390_30511199_1"	407809	270203	276346	998	6143	0	"S"	303	948	NA	0.0013	0	"NA19240#1#JAHEOM010000047.1_30103390_30511199_1"	"AMYP1-201"	"2Ap"	"1-2-5-2-6-4-2-5-4-6-3-0"	"1.0-2.0-5.1-2.1-6.1-4.1-2.0-5.0-4.0-6.0-3.0-0.0"	30103544	"NA19240#1#JAHEOM010000047.1_30103390_30511199_1"	270203	276346
"AMYP1-201"	1023	4	1022	"-"	"NA19240#2#JAHEOL010000010.1_37445323_37853017_0"	407694	270019	276128	998	6109	2	"P"	303	948	941	0.0013	0	"NA19240#2#JAHEOL010000010.1_37445323_37853017_0"	"AMYP1-201"	"2Ap"	"1-2-5-2-4-6-2-5-4-6-3-0"	"1.0-2.0-5.1-2.1-4.0-6.0-2.0-5.0-4.0-6.0-3.0-0.0"	37445421	"NA19240#2#JAHEOL010000010.1_37445323_37853017_0"	270019	276128
"AMYP1-201"	1023	4	1022	"+"	"NA20129#2#JAHEPD010000155.1_90039_569275_0"	479236	329950	336059	998	6109	0	"S"	303	948	NA	0.0013	0	"NA20129#2#JAHEPD010000155.1_90039_569275_0"	"AMYP1-201"	"2Ap"	"1-2-5-2-6-4-5-2-4-6-2-5-4-6-3-0"	"1.0-2.0-5.0-2.1-6.1-4.1-5.1-2.1-4.0-6.0-2.0-5.0-4.0-6.0-3.0-0.0"	90137	"NA20129#2#JAHEPD010000155.1_90039_569275_0"	329950	336059
